,id,timestamp,state,resource,next_state,next_time,next_dur,elapsed_time,total_time,remaining_time,history
0,68,1325455200,1,2,1,1325459700,4500,0,262800,262800,1
1,61,1325455200,4,5,4,1325472600,17400,0,6225300,6225300,4
2,111,1325458800,0,11,0,1325480400,21600,0,3974400,3974400,0
3,68,1325459700,1,2,1,1325502000,42300,4500,262800,258300,1_1
4,61,1325472600,4,5,18,1325491200,18600,17400,6225300,6207900,4_4
5,66,1325480400,3,4,3,1325489400,9000,0,4817700,4817700,3
6,129,1325480400,26,16,26,1325520000,39600,0,1188000,1188000,26
7,111,1325480400,0,14,0,1325505600,25200,21600,3974400,3952800,0_0_0
8,111,1325480400,0,11,0,1325480400,0,21600,3974400,3952800,0_0
9,150,1325482200,41,38,41,1325512800,30600,0,626340,626340,41
10,120,1325487600,7,12,7,1325512800,25200,0,576000,576000,7
11,138,1325487600,10,13,10,1325494800,7200,0,1785600,1785600,10
12,66,1325489400,3,4,4,1326194700,705300,9000,4817700,4808700,3_3
13,61,1325491200,18,19,18,1325494800,3600,36000,6225300,6189300,4_4_18
14,128,1325492100,2,3,2,1325499300,7200,0,346200,346200,2
15,138,1325494800,10,13,10,1325584320,89520,7200,1785600,1778400,10_10
16,61,1325494800,18,19,34,1326315060,820260,39600,6225300,6185700,4_4_18_18
17,149,1325494860,10,13,10,1325515380,20520,0,223140,223140,10
18,67,1325499300,2,3,3,1325499600,300,0,3120480,3120480,2
19,128,1325499300,2,3,9,1325505600,6300,7200,346200,339000,2_2
20,67,1325499600,3,4,3,1325501400,1800,300,3120480,3120180,2_3
21,67,1325501400,3,4,3,1325503200,1800,2100,3120480,3118380,2_3_3
22,68,1325502000,1,2,1,1325505600,3600,46800,262800,216000,1_1_1
23,67,1325503200,3,4,2,1325505600,2400,3900,3120480,3116580,2_3_3_3
24,68,1325505600,1,2,1,1325505600,0,50400,262800,212400,1_1_1_1
25,111,1325505600,0,14,0,1325505600,0,46800,3974400,3927600,0_0_0_0
26,67,1325505600,2,3,3,1325512800,7200,6300,3120480,3114180,2_3_3_3_2
27,111,1325505600,0,14,0,1325512800,7200,46800,3974400,3927600,0_0_0_0_0
28,68,1325505600,1,2,1,1325513400,7800,50400,262800,212400,1_1_1_1_1
29,128,1325505600,9,3,9,1325512800,7200,13500,346200,332700,2_2_9
30,120,1325512800,7,12,7,1325512800,0,25200,576000,550800,7_7
31,128,1325512800,9,3,9,1325603040,90240,20700,346200,325500,2_2_9_9
32,67,1325512800,3,3,3,1325516400,3600,13500,3120480,3106980,2_3_3_3_2_3_3
33,111,1325512800,0,14,0,1325527200,14400,54000,3974400,3920400,0_0_0_0_0_0
34,150,1325512800,41,38,1,1325541600,28800,30600,626340,595740,41_41
35,120,1325512800,7,8,7,1325540400,27600,25200,576000,550800,7_7_7
36,67,1325512800,3,4,3,1325512800,0,13500,3120480,3106980,2_3_3_3_2_3
37,68,1325513400,1,2,5,1325566800,53400,58200,262800,204600,1_1_1_1_1_1
38,149,1325515380,10,13,10,1325566740,51360,20520,223140,202620,10_10
39,67,1325516400,3,3,1,1326791880,1275480,17100,3120480,3103380,2_3_3_3_2_3_3_3
40,129,1325520000,26,16,8,1325764680,244680,39600,1188000,1148400,26_26
41,51,1325523600,14,17,14,1325526600,3000,0,280800,280800,14
42,51,1325526600,14,17,14,1325526600,0,3000,280800,277800,14_14
43,51,1325526600,14,17,14,1325529900,3300,3000,280800,277800,14_14_14
44,146,1325527200,16,0,16,1325528340,1140,0,6670800,6670800,16
45,111,1325527200,0,11,0,1325566800,39600,68400,3974400,3906000,0_0_0_0_0_0_0
46,146,1325528340,16,0,16,1325530380,2040,1140,6670800,6669660,16_16
47,109,1325529900,14,17,14,1325532600,2700,0,274500,274500,14
48,51,1325529900,14,17,5,1325689800,159900,6300,280800,274500,14_14_14_14
49,146,1325530380,16,0,16,1325538000,7620,3180,6670800,6667620,16_16_16
50,109,1325532600,14,17,14,1325534400,1800,2700,274500,271800,14_14
51,109,1325534400,14,17,14,1325540700,6300,4500,274500,270000,14_14_14
52,146,1325538000,16,0,16,1325538000,0,10800,6670800,6660000,16_16_16_16
53,146,1325538000,16,0,16,1325566800,28800,10800,6670800,6660000,16_16_16_16_16
54,120,1325540400,7,8,7,1325592840,52440,52800,576000,523200,7_7_7_7
55,109,1325540700,14,17,1,1325566200,25500,10800,274500,263700,14_14_14_14
56,76,1325541600,3,4,3,1325546100,4500,0,7552500,7552500,3
57,110,1325541600,1,9,1,1325546100,4500,0,5579400,5579400,1
58,150,1325541600,1,6,1,1325546100,4500,59400,626340,566940,41_41_1
59,65,1325541600,17,10,17,1325546100,4500,0,7544400,7544400,17
60,150,1325546100,1,6,3,1325772000,225900,63900,626340,562440,41_41_1_1
61,76,1325546100,3,4,3,1325571840,25740,4500,7552500,7548000,3_3
62,65,1325546100,17,10,34,1325689140,143040,4500,7544400,7539900,17_17
63,110,1325546100,1,9,0,1325566800,20700,4500,5579400,5574900,1_1
64,109,1325566200,1,9,14,1325566800,600,36300,274500,238200,14_14_14_14_1
65,149,1325566740,10,13,1,1325567100,360,71880,223140,151260,10_10_10
66,109,1325566800,14,15,1,1325569440,2640,36900,274500,237600,14_14_14_14_1_14
67,146,1325566800,16,0,16,1325567100,300,39600,6670800,6631200,16_16_16_16_16_16
68,110,1325566800,0,1,0,1325588400,21600,25200,5579400,5554200,1_1_0
69,111,1325566800,0,11,0,1325568840,2040,108000,3974400,3866400,0_0_0_0_0_0_0_0
70,68,1325566800,5,2,5,1325588400,21600,111600,262800,151200,1_1_1_1_1_1_5
71,105,1325566860,1,6,16,1325567040,180,0,1314480,1314480,1
72,105,1325567040,16,20,1,1325567160,120,180,1314480,1314300,1_16
73,149,1325567100,1,18,1,1325572800,5700,72240,223140,150900,10_10_10_1
74,146,1325567100,16,20,1,1325568240,1140,39900,6670800,6630900,16_16_16_16_16_16_16
75,105,1325567160,1,6,2,1325567400,240,300,1314480,1314180,1_16_1
76,105,1325567400,2,15,16,1325571540,4140,540,1314480,1313940,1_16_1_2
77,146,1325568240,1,6,16,1325572980,4740,41040,6670800,6629760,16_16_16_16_16_16_16_1
78,124,1325568600,41,38,41,1325599200,30600,0,754200,754200,41
79,111,1325568840,0,1,0,1325568900,60,110040,3974400,3864360,0_0_0_0_0_0_0_0_0
80,111,1325568900,0,1,0,1325569380,480,110100,3974400,3864300,0_0_0_0_0_0_0_0_0_0
81,111,1325569380,0,1,1,1325569440,60,110580,3974400,3863820,0_0_0_0_0_0_0_0_0_0_0
82,109,1325569440,1,9,14,1325584200,14760,39540,274500,234960,14_14_14_14_1_14_1
83,111,1325569440,1,9,0,1325573340,3900,110640,3974400,3863760,0_0_0_0_0_0_0_0_0_0_0_1
84,105,1325571540,16,20,2,1325571900,360,4680,1314480,1309800,1_16_1_2_16
85,76,1325571840,3,3,3,1325586300,14460,30240,7552500,7522260,3_3_3
86,105,1325571900,2,15,3,1326119340,547440,5040,1314480,1309440,1_16_1_2_16_2
87,149,1325572800,1,18,10,1325578320,5520,77940,223140,145200,10_10_10_1_1
88,146,1325572980,16,20,1,1325597760,24780,45780,6670800,6625020,16_16_16_16_16_16_16_1_16
89,111,1325573340,0,1,1,1325574660,1320,114540,3974400,3859860,0_0_0_0_0_0_0_0_0_0_0_1_0
90,111,1325574660,1,9,0,1325578620,3960,115860,3974400,3858540,0_0_0_0_0_0_0_0_0_0_0_1_0_1
91,87,1325577600,19,14,19,1325599200,21600,0,1090800,1090800,19
92,149,1325578320,10,13,10,1325578380,60,83460,223140,139680,10_10_10_1_1_10
93,149,1325578380,10,13,1,1325583000,4620,83520,223140,139620,10_10_10_1_1_10_10
94,111,1325578620,0,1,0,1325599620,21000,119820,3974400,3854580,0_0_0_0_0_0_0_0_0_0_0_1_0_1_0
95,106,1325581200,46,12,46,1325598900,17700,0,1023180,1023180,46
96,149,1325583000,1,18,9,1325584200,1200,88140,223140,135000,10_10_10_1_1_10_10_1
97,149,1325584200,9,15,10,1325584260,60,89340,223140,133800,10_10_10_1_1_10_10_1_9
98,109,1325584200,14,15,14,1325599200,15000,54300,274500,220200,14_14_14_14_1_14_1_14
99,149,1325584260,10,13,1,1325585640,1380,89400,223140,133740,10_10_10_1_1_10_10_1_9_10
100,138,1325584320,10,13,10,1325606280,21960,96720,1785600,1688880,10_10_10
101,149,1325585640,1,18,9,1325586600,960,90780,223140,132360,10_10_10_1_1_10_10_1_9_10_1
102,76,1325586300,3,4,3,1325587800,1500,44700,7552500,7507800,3_3_3_3
103,149,1325586600,9,15,3,1325586600,0,91740,223140,131400,10_10_10_1_1_10_10_1_9_10_1_9
104,149,1325586600,3,15,3,1325590200,3600,91740,223140,131400,10_10_10_1_1_10_10_1_9_10_1_9_3
105,76,1325587800,3,4,3,1325589600,1800,46200,7552500,7506300,3_3_3_3_3
106,110,1325588400,0,1,1,1325628000,39600,46800,5579400,5532600,1_1_0_0
107,68,1325588400,5,2,5,1325664000,75600,133200,262800,129600,1_1_1_1_1_1_5_5
108,76,1325589600,3,4,3,1325597700,8100,48000,7552500,7504500,3_3_3_3_3_3
109,149,1325590200,14,15,14,1325599200,9000,95340,223140,127800,10_10_10_1_1_10_10_1_9_10_1_9_3_3_14
110,149,1325590200,3,15,14,1325590200,0,95340,223140,127800,10_10_10_1_1_10_10_1_9_10_1_9_3_3
111,120,1325592840,7,12,7,1325597340,4500,105240,576000,470760,7_7_7_7_7
112,120,1325597340,7,12,1,1325653200,55860,109740,576000,466260,7_7_7_7_7_7
113,76,1325597700,3,3,3,1325598960,1260,56100,7552500,7496400,3_3_3_3_3_3_3_3
114,76,1325597700,3,3,3,1325597700,0,56100,7552500,7496400,3_3_3_3_3_3_3
115,146,1325597760,1,6,16,1325613660,15900,70560,6670800,6600240,16_16_16_16_16_16_16_1_16_1
116,106,1325598900,46,8,46,1325599200,300,17700,1023180,1005480,46_46
117,93,1325598900,3,3,3,1325603040,4140,0,1242300,1242300,3
118,76,1325598960,3,3,18,1325599020,60,57360,7552500,7495140,3_3_3_3_3_3_3_3_3
119,76,1325599020,18,5,3,1325599200,180,57420,7552500,7495080,3_3_3_3_3_3_3_3_3_18
120,87,1325599200,19,14,19,1325614500,15300,21600,1090800,1069200,19_19
121,124,1325599200,41,38,41,1325678400,79200,30600,754200,723600,41_41
122,76,1325599200,3,4,18,1325599500,300,57600,7552500,7494900,3_3_3_3_3_3_3_3_3_18_3
123,109,1325599200,14,17,14,1325626800,27600,69300,274500,205200,14_14_14_14_1_14_1_14_14
124,149,1325599200,14,15,15,1325664000,64800,104340,223140,118800,10_10_10_1_1_10_10_1_9_10_1_9_3_3_14_14
125,106,1325599200,46,12,46,1325615040,15840,18000,1023180,1005180,46_46_46
126,76,1325599500,18,5,18,1325599620,120,57900,7552500,7494600,3_3_3_3_3_3_3_3_3_18_3_18
127,76,1325599620,18,5,18,1325609880,10260,58020,7552500,7494480,3_3_3_3_3_3_3_3_3_18_3_18_18
128,111,1325599620,0,1,0,1325614440,14820,140820,3974400,3833580,0_0_0_0_0_0_0_0_0_0_0_1_0_1_0_0
129,93,1325603040,3,3,3,1325776020,172980,4140,1242300,1238160,3_3
130,128,1325603040,9,3,9,1325607780,4740,110940,346200,235260,2_2_9_9_9
131,138,1325606280,10,13,10,1325653140,46860,118680,1785600,1666920,10_10_10_10
132,128,1325607780,9,3,9,1325665680,57900,115680,346200,230520,2_2_9_9_9_9
133,76,1325609880,18,5,18,1325609940,60,68280,7552500,7484220,3_3_3_3_3_3_3_3_3_18_3_18_18_18
134,76,1325609940,18,5,18,1325621820,11880,68340,7552500,7484160,3_3_3_3_3_3_3_3_3_18_3_18_18_18_18
135,146,1325613660,16,0,1,1325628000,14340,86460,6670800,6584340,16_16_16_16_16_16_16_1_16_1_16
136,111,1325614440,0,11,0,1325651520,37080,155640,3974400,3818760,0_0_0_0_0_0_0_0_0_0_0_1_0_1_0_0_0
137,87,1325614500,19,11,19,1325617500,3000,36900,1090800,1053900,19_19_19
138,106,1325615040,46,8,46,1325615100,60,33840,1023180,989340,46_46_46_46
139,106,1325615100,46,8,46,1325626860,11760,33900,1023180,989280,46_46_46_46_46
140,87,1325617500,19,11,19,1325617560,60,39900,1090800,1050900,19_19_19_19
141,87,1325617560,19,11,19,1325651580,34020,39960,1090800,1050840,19_19_19_19_19
142,76,1325621820,18,5,3,1325628000,6180,80220,7552500,7472280,3_3_3_3_3_3_3_3_3_18_3_18_18_18_18_18
143,109,1325626800,14,17,14,1325686440,59640,96900,274500,177600,14_14_14_14_1_14_1_14_14_14
144,106,1325626860,46,8,46,1325628240,1380,45660,1023180,977520,46_46_46_46_46_46
145,79,1325628000,15,6,1,1325628000,0,0,4151700,4151700,15
146,76,1325628000,3,4,3,1325632500,4500,86400,7552500,7466100,3_3_3_3_3_3_3_3_3_18_3_18_18_18_18_18_3
147,146,1325628000,1,6,1,1325632500,4500,100800,6670800,6570000,16_16_16_16_16_16_16_1_16_1_16_1
148,79,1325628000,1,6,15,1325632500,4500,0,4151700,4151700,15_1
149,52,1325628000,15,6,15,1325632500,4500,0,608400,608400,15
150,110,1325628000,1,9,1,1325632500,4500,86400,5579400,5493000,1_1_0_0_1
151,95,1325628000,6,7,6,1325631600,3600,0,3600,3600,6
152,106,1325628240,46,0,46,1325644440,16200,47040,1023180,976140,46_46_46_46_46_46_46
153,95,1325631600,6,7,99,1325631600,0,3600,3600,0,6_6
154,76,1325632500,3,4,3,1325655540,23040,90900,7552500,7461600,3_3_3_3_3_3_3_3_3_18_3_18_18_18_18_18_3_3
155,146,1325632500,1,6,16,1325652900,20400,105300,6670800,6565500,16_16_16_16_16_16_16_1_16_1_16_1_1
156,52,1325632500,15,6,33,1325826000,193500,4500,608400,603900,15_15
157,110,1325632500,1,9,1,1325656740,24240,90900,5579400,5488500,1_1_0_0_1_1
158,79,1325632500,15,6,1,1325632500,0,4500,4151700,4147200,15_1_15
159,79,1325632500,1,6,26,1325751000,118500,4500,4151700,4147200,15_1_15_1
160,106,1325644440,46,0,1,1325680200,35760,63240,1023180,959940,46_46_46_46_46_46_46_46
161,111,1325651520,0,11,1,1325652600,1080,192720,3974400,3781680,0_0_0_0_0_0_0_0_0_0_0_1_0_1_0_0_0_0
162,87,1325651580,19,11,19,1325656800,5220,73980,1090800,1016820,19_19_19_19_19_19
163,111,1325652600,1,9,0,1325653980,1380,193800,3974400,3780600,0_0_0_0_0_0_0_0_0_0_0_1_0_1_0_0_0_0_1
164,146,1325652900,16,0,1,1325653200,300,125700,6670800,6545100,16_16_16_16_16_16_16_1_16_1_16_1_1_16
165,138,1325653140,10,13,1,1325660400,7260,165540,1785600,1620060,10_10_10_10_10
166,141,1325653200,1,2,1,1325659200,6000,0,7406100,7406100,1
167,146,1325653200,1,6,16,1325654100,900,126000,6670800,6544800,16_16_16_16_16_16_16_1_16_1_16_1_1_16_1
168,120,1325653200,1,18,1,1325659200,6000,165600,576000,410400,7_7_7_7_7_7_1
169,111,1325653980,0,1,1,1325654940,960,195180,3974400,3779220,0_0_0_0_0_0_0_0_0_0_0_1_0_1_0_0_0_0_1_0
170,146,1325654100,16,20,16,1325679240,25140,126900,6670800,6543900,16_16_16_16_16_16_16_1_16_1_16_1_1_16_1_16
171,111,1325654940,1,9,0,1325692980,38040,196140,3974400,3778260,0_0_0_0_0_0_0_0_0_0_0_1_0_1_0_0_0_0_1_0_1
172,76,1325655540,3,19,1,1325660400,4860,113940,7552500,7438560,3_3_3_3_3_3_3_3_3_18_3_18_18_18_18_18_3_3_3
173,110,1325656740,1,9,1,1325665440,8700,115140,5579400,5464260,1_1_0_0_1_1_1
174,87,1325656800,19,14,19,1325683800,27000,79200,1090800,1011600,19_19_19_19_19_19_19
175,60,1325658000,3,3,3,1325665500,7500,0,7401300,7401300,3
176,84,1325658900,17,12,17,1325685420,26520,0,3714840,3714840,17
177,141,1325659200,1,2,16,1325679300,20100,6000,7406100,7400100,1_1
178,120,1325659200,1,18,2,1325662740,3540,171600,576000,404400,7_7_7_7_7_7_1_1
179,138,1325660400,1,18,10,1325661480,1080,172800,1785600,1612800,10_10_10_10_10_1
180,76,1325660400,1,2,1,1325664000,3600,118800,7552500,7433700,3_3_3_3_3_3_3_3_3_18_3_18_18_18_18_18_3_3_3_1
181,138,1325661480,10,13,10,1325661660,180,173880,1785600,1611720,10_10_10_10_10_1_10
182,138,1325661660,10,13,1,1325664000,2340,174060,1785600,1611540,10_10_10_10_10_1_10_10
183,100,1325662500,10,16,10,1325667060,4560,0,919500,919500,10
184,120,1325662740,2,4,2,1325665260,2520,175140,576000,400860,7_7_7_7_7_7_1_1_2
185,149,1325664000,15,18,15,1325667720,3720,169140,223140,54000,10_10_10_1_1_10_10_1_9_10_1_9_3_3_14_14_15
186,76,1325664000,1,2,3,1325665500,1500,122400,7552500,7430100,3_3_3_3_3_3_3_3_3_18_3_18_18_18_18_18_3_3_3_1_1
187,138,1325664000,1,18,10,1325667600,3600,176400,1785600,1609200,10_10_10_10_10_1_10_10_1
188,68,1325664000,5,2,5,1325674200,10200,208800,262800,54000,1_1_1_1_1_1_5_5_5
189,120,1325665260,2,4,9,1325667540,2280,177660,576000,398340,7_7_7_7_7_7_1_1_2_2
190,110,1325665440,1,9,2,1326269280,603840,123840,5579400,5455560,1_1_0_0_1_1_1_1
191,60,1325665500,3,3,18,1326021660,356160,7500,7401300,7393800,3_3
192,76,1325665500,3,19,17,1325709420,43920,123900,7552500,7428600,3_3_3_3_3_3_3_3_3_18_3_18_18_18_18_18_3_3_3_1_1_3
193,128,1325665680,9,4,9,1325670840,5160,173580,346200,172620,2_2_9_9_9_9_9
194,100,1325667060,10,16,10,1326097800,430740,4560,919500,914940,10_10
195,140,1325667120,26,16,26,1325685540,18420,0,1300140,1300140,26
196,120,1325667540,9,3,9,1325692440,24900,179940,576000,396060,7_7_7_7_7_7_1_1_2_2_9
197,138,1325667600,10,13,10,1325686860,19260,180000,1785600,1605600,10_10_10_10_10_1_10_10_1_10_10
198,138,1325667600,10,13,10,1325667600,0,180000,1785600,1605600,10_10_10_10_10_1_10_10_1_10
199,149,1325667720,15,18,2,1325667900,180,172860,223140,50280,10_10_10_1_1_10_10_1_9_10_1_9_3_3_14_14_15_15
200,149,1325667900,2,3,5,1325668320,420,173040,223140,50100,10_10_10_1_1_10_10_1_9_10_1_9_3_3_14_14_15_15_2
201,149,1325668320,5,18,2,1325672400,4080,173460,223140,49680,10_10_10_1_1_10_10_1_9_10_1_9_3_3_14_14_15_15_2_5
202,128,1325670840,9,4,5,1325683560,12720,178740,346200,167460,2_2_9_9_9_9_9_9
203,149,1325672400,2,3,5,1325674140,1740,177540,223140,45600,10_10_10_1_1_10_10_1_9_10_1_9_3_3_14_14_15_15_2_5_2
204,149,1325674140,5,18,5,1325676000,1860,179280,223140,43860,10_10_10_1_1_10_10_1_9_10_1_9_3_3_14_14_15_15_2_5_2_5
205,68,1325674200,5,2,6,1325714400,40200,219000,262800,43800,1_1_1_1_1_1_5_5_5_5
206,149,1325676000,5,18,5,1325676600,600,181140,223140,42000,10_10_10_1_1_10_10_1_9_10_1_9_3_3_14_14_15_15_2_5_2_5_5
207,149,1325676600,5,18,6,1325714400,37800,181740,223140,41400,10_10_10_1_1_10_10_1_9_10_1_9_3_3_14_14_15_15_2_5_2_5_5_5
208,124,1325678400,41,38,41,1325692800,14400,109800,754200,644400,41_41_41
209,146,1325679240,16,20,2,1325683620,4380,152040,6670800,6518760,16_16_16_16_16_16_16_1_16_1_16_1_1_16_1_16_16
210,141,1325679300,16,20,16,1325686140,6840,26100,7406100,7380000,1_1_16
211,106,1325680200,1,18,1,1325689440,9240,99000,1023180,924180,46_46_46_46_46_46_46_46_1
212,128,1325683560,5,9,5,1325685420,1860,191460,346200,154740,2_2_9_9_9_9_9_9_5
213,146,1325683620,2,4,1,1325684460,840,156420,6670800,6514380,16_16_16_16_16_16_16_1_16_1_16_1_1_16_1_16_16_2
214,87,1325683800,19,14,19,1325700480,16680,106200,1090800,984600,19_19_19_19_19_19_19_19
215,146,1325684460,1,6,1,1325684460,0,157260,6670800,6513540,16_16_16_16_16_16_16_1_16_1_16_1_1_16_1_16_16_2_1
216,146,1325684460,1,6,16,1325684640,180,157260,6670800,6513540,16_16_16_16_16_16_16_1_16_1_16_1_1_16_1_16_16_2_1_1
217,146,1325684640,16,20,1,1325684880,240,157440,6670800,6513360,16_16_16_16_16_16_16_1_16_1_16_1_1_16_1_16_16_2_1_1_16
218,146,1325684880,1,6,2,1325685420,540,157680,6670800,6513120,16_16_16_16_16_16_16_1_16_1_16_1_1_16_1_16_16_2_1_1_16_1
219,146,1325685420,2,4,16,1325689140,3720,158220,6670800,6512580,16_16_16_16_16_16_16_1_16_1_16_1_1_16_1_16_16_2_1_1_16_1_2
220,128,1325685420,5,9,6,1325800800,115380,193320,346200,152880,2_2_9_9_9_9_9_9_5_5
221,84,1325685420,17,12,17,1325685480,60,26520,3714840,3688320,17_17
222,84,1325685480,17,8,17,1325709240,23760,26580,3714840,3688260,17_17_17
223,140,1325685540,26,16,26,1325741640,56100,18420,1300140,1281720,26_26
224,141,1325686140,16,20,16,1325699640,13500,32940,7406100,7373160,1_1_16_16
225,109,1325686440,14,17,14,1325689080,2640,156540,274500,117960,14_14_14_14_1_14_1_14_14_14_14
226,138,1325686860,10,13,10,1325738880,52020,199260,1785600,1586340,10_10_10_10_10_1_10_10_1_10_10_10
227,109,1325689080,14,17,5,1325749980,60900,159180,274500,115320,14_14_14_14_1_14_1_14_14_14_14_14
228,65,1325689140,34,17,34,1325694660,5520,147540,7544400,7396860,17_17_34
229,146,1325689140,16,20,2,1325705100,15960,161940,6670800,6508860,16_16_16_16_16_16_16_1_16_1_16_1_1_16_1_16_16_2_1_1_16_1_2_16
230,106,1325689440,1,18,2,1325755380,65940,108240,1023180,914940,46_46_46_46_46_46_46_46_1_1
231,51,1325689800,5,18,5,1325692020,2220,166200,280800,114600,14_14_14_14_5
232,51,1325692020,5,18,5,1325743500,51480,168420,280800,112380,14_14_14_14_5_5
233,120,1325692440,9,3,9,1325714400,21960,204840,576000,371160,7_7_7_7_7_7_1_1_2_2_9_9
234,124,1325692800,41,38,5,1325739600,46800,124200,754200,630000,41_41_41_41
235,111,1325692980,0,1,0,1325700420,7440,234180,3974400,3740220,0_0_0_0_0_0_0_0_0_0_0_1_0_1_0_0_0_0_1_0_1_0
236,65,1325694660,34,17,6,1325714400,19740,153060,7544400,7391340,17_17_34_34
237,141,1325699640,16,0,16,1325738700,39060,46440,7406100,7359660,1_1_16_16_16
238,111,1325700420,0,11,0,1325701080,660,241620,3974400,3732780,0_0_0_0_0_0_0_0_0_0_0_1_0_1_0_0_0_0_1_0_1_0_0
239,87,1325700480,19,11,19,1325737620,37140,122880,1090800,967920,19_19_19_19_19_19_19_19_19
240,111,1325701080,0,11,0,1325701140,60,242280,3974400,3732120,0_0_0_0_0_0_0_0_0_0_0_1_0_1_0_0_0_0_1_0_1_0_0_0
241,111,1325701140,0,0,0,1325717340,16200,242340,3974400,3732060,0_0_0_0_0_0_0_0_0_0_0_1_0_1_0_0_0_0_1_0_1_0_0_0_0
242,146,1325705100,2,23,2,1325717880,12780,177900,6670800,6492900,16_16_16_16_16_16_16_1_16_1_16_1_1_16_1_16_16_2_1_1_16_1_2_16_2
243,84,1325709240,17,8,17,1326054060,344820,50340,3714840,3664500,17_17_17_17
244,76,1325709420,17,8,17,1325713560,4140,167820,7552500,7384680,3_3_3_3_3_3_3_3_3_18_3_18_18_18_18_18_3_3_3_1_1_3_17
245,76,1325713560,17,8,17,1325739120,25560,171960,7552500,7380540,3_3_3_3_3_3_3_3_3_18_3_18_18_18_18_18_3_3_3_1_1_3_17_17
246,120,1325714400,9,4,9,1325718900,4500,226800,576000,349200,7_7_7_7_7_7_1_1_2_2_9_9_9
247,65,1325714400,6,7,6,1325714400,0,172800,7544400,7371600,17_17_34_34_6
248,65,1325714400,6,7,6,1325718000,3600,172800,7544400,7371600,17_17_34_34_6_6
249,149,1325714400,6,7,6,1325718000,3600,219540,223140,3600,10_10_10_1_1_10_10_1_9_10_1_9_3_3_14_14_15_15_2_5_2_5_5_5_6
250,68,1325714400,6,7,6,1325718000,3600,259200,262800,3600,1_1_1_1_1_1_5_5_5_5_6
251,99,1325714400,6,7,6,1325718000,3600,0,28560,28560,6
252,111,1325717340,0,1,0,1325738760,21420,258540,3974400,3715860,0_0_0_0_0_0_0_0_0_0_0_1_0_1_0_0_0_0_1_0_1_0_0_0_0_0
253,146,1325717880,2,23,3,1326664800,946920,190680,6670800,6480120,16_16_16_16_16_16_16_1_16_1_16_1_1_16_1_16_16_2_1_1_16_1_2_16_2_2
254,65,1325718000,6,7,5,1325748600,30600,176400,7544400,7368000,17_17_34_34_6_6_6_6
255,99,1325718000,6,7,5,1325739600,21600,3600,28560,24960,6_6
256,149,1325718000,6,7,99,1325718000,0,223140,223140,0,10_10_10_1_1_10_10_1_9_10_1_9_3_3_14_14_15_15_2_5_2_5_5_5_6_6
257,65,1325718000,6,7,6,1325718000,0,176400,7544400,7368000,17_17_34_34_6_6_6
258,68,1325718000,6,7,99,1325718000,0,262800,262800,0,1_1_1_1_1_1_5_5_5_5_6_6
259,120,1325718900,9,4,9,1325744160,25260,231300,576000,344700,7_7_7_7_7_7_1_1_2_2_9_9_9_9
260,87,1325737620,19,11,1,1325739240,1620,160020,1090800,930780,19_19_19_19_19_19_19_19_19_19
261,141,1325738700,16,0,16,1325739960,1260,85500,7406100,7320600,1_1_16_16_16_16
262,111,1325738760,0,0,1,1325743200,4440,279960,3974400,3694440,0_0_0_0_0_0_0_0_0_0_0_1_0_1_0_0_0_0_1_0_1_0_0_0_0_0_0
263,138,1325738880,10,13,10,1325739960,1080,251280,1785600,1534320,10_10_10_10_10_1_10_10_1_10_10_10_10
264,76,1325739120,17,12,18,1325768940,29820,197520,7552500,7354980,3_3_3_3_3_3_3_3_3_18_3_18_18_18_18_18_3_3_3_1_1_3_17_17_17
265,87,1325739240,1,9,1,1325741700,2460,161640,1090800,929160,19_19_19_19_19_19_19_19_19_19_1
266,98,1325739420,34,15,34,1325771520,32100,0,7319880,7319880,34
267,99,1325739600,5,18,5,1325742960,3360,25200,28560,3360,6_6_5
268,124,1325739600,5,2,41,1325739600,0,171000,754200,583200,41_41_41_41_5
269,124,1325739600,41,38,5,1325760600,21000,171000,754200,583200,41_41_41_41_5_41
270,138,1325739960,10,13,10,1325745000,5040,252360,1785600,1533240,10_10_10_10_10_1_10_10_1_10_10_10_10_10
271,141,1325739960,16,20,1,1325764800,24840,86760,7406100,7319340,1_1_16_16_16_16_16
272,140,1325741640,26,16,26,1325744760,3120,74520,1300140,1225620,26_26_26
273,87,1325741700,1,9,19,1325743200,1500,164100,1090800,926700,19_19_19_19_19_19_19_19_19_19_1_1
274,99,1325742960,5,18,99,1325742960,0,28560,28560,0,6_6_5_5
275,111,1325743200,1,9,1,1325748180,4980,284400,3974400,3690000,0_0_0_0_0_0_0_0_0_0_0_1_0_1_0_0_0_0_1_0_1_0_0_0_0_0_0_1
276,87,1325743200,19,14,19,1325775600,32400,165600,1090800,925200,19_19_19_19_19_19_19_19_19_19_1_1_19
277,51,1325743500,5,18,5,1325745600,2100,219900,280800,60900,14_14_14_14_5_5_5
278,120,1325744160,9,3,9,1325752500,8340,256560,576000,319440,7_7_7_7_7_7_1_1_2_2_9_9_9_9_9
279,140,1325744760,26,16,10,1326085440,340680,77640,1300140,1222500,26_26_26_26
280,138,1325745000,10,16,1,1325752200,7200,257400,1785600,1528200,10_10_10_10_10_1_10_10_1_10_10_10_10_10_10
281,51,1325745600,5,18,6,1325800800,55200,222000,280800,58800,14_14_14_14_5_5_5_5
282,111,1325748180,1,9,0,1325755920,7740,289380,3974400,3685020,0_0_0_0_0_0_0_0_0_0_0_1_0_1_0_0_0_0_1_0_1_0_0_0_0_0_0_1_1
283,65,1325748600,5,18,5,1325751180,2580,207000,7544400,7337400,17_17_34_34_6_6_6_6_5
284,109,1325749980,5,9,5,1325770140,20160,220080,274500,54420,14_14_14_14_1_14_1_14_14_14_14_14_5
285,79,1325751000,26,13,26,1325751060,60,123000,4151700,4028700,15_1_15_1_26
286,79,1325751060,26,13,26,1325751120,60,123060,4151700,4028640,15_1_15_1_26_26
287,79,1325751120,26,13,26,1325764320,13200,123120,4151700,4028580,15_1_15_1_26_26_26
288,65,1325751180,5,18,1,1325755800,4620,209580,7544400,7334820,17_17_34_34_6_6_6_6_5_5
289,138,1325752200,1,18,10,1325753100,900,264600,1785600,1521000,10_10_10_10_10_1_10_10_1_10_10_10_10_10_10_1
290,120,1325752500,9,3,5,1326024240,271740,264900,576000,311100,7_7_7_7_7_7_1_1_2_2_9_9_9_9_9_9
291,138,1325753100,10,16,1,1325755800,2700,265500,1785600,1520100,10_10_10_10_10_1_10_10_1_10_10_10_10_10_10_1_10
292,91,1325755200,10,16,10,1325769660,14460,0,1030200,1030200,10
293,106,1325755380,2,3,2,1325756700,1320,174180,1023180,849000,46_46_46_46_46_46_46_46_1_1_2
294,138,1325755800,1,18,9,1325756760,960,268200,1785600,1517400,10_10_10_10_10_1_10_10_1_10_10_10_10_10_10_1_10_1
295,65,1325755800,1,18,1,1325767200,11400,214200,7544400,7330200,17_17_34_34_6_6_6_6_5_5_1
296,111,1325755920,0,1,1,1326032400,276480,297120,3974400,3677280,0_0_0_0_0_0_0_0_0_0_0_1_0_1_0_0_0_0_1_0_1_0_0_0_0_0_0_1_1_0
297,106,1325756700,2,3,9,1325759280,2580,175500,1023180,847680,46_46_46_46_46_46_46_46_1_1_2_2
298,138,1325756760,9,3,9,1325759220,2460,269160,1785600,1516440,10_10_10_10_10_1_10_10_1_10_10_10_10_10_10_1_10_1_9
299,142,1325758440,0,1,0,1325779080,20640,0,7299960,7299960,0
300,138,1325759220,9,3,47,1326712800,953580,271620,1785600,1513980,10_10_10_10_10_1_10_10_1_10_10_10_10_10_10_1_10_1_9_9
301,106,1325759280,9,3,9,1325767860,8580,178080,1023180,845100,46_46_46_46_46_46_46_46_1_1_2_2_9
302,124,1325760600,5,2,41,1325772000,11400,192000,754200,562200,41_41_41_41_5_41_5
303,79,1325764320,26,13,26,1325764380,60,136320,4151700,4015380,15_1_15_1_26_26_26_26
304,79,1325764380,26,13,26,1325777820,13440,136380,4151700,4015320,15_1_15_1_26_26_26_26_26
305,129,1325764680,8,9,8,1325769180,4500,284280,1188000,903720,26_26_8
306,141,1325764800,1,2,16,1325765820,1020,111600,7406100,7294500,1_1_16_16_16_16_16_1
307,141,1325765820,16,20,16,1325766120,300,112620,7406100,7293480,1_1_16_16_16_16_16_1_16
308,141,1325766120,16,20,1,1325772600,6480,112920,7406100,7293180,1_1_16_16_16_16_16_1_16_16
309,65,1325767200,1,18,1,1326006000,238800,225600,7544400,7318800,17_17_34_34_6_6_6_6_5_5_1_1
310,106,1325767860,9,3,46,1325985180,217320,186660,1023180,836520,46_46_46_46_46_46_46_46_1_1_2_2_9_9
311,76,1325768940,18,19,17,1325770320,1380,227340,7552500,7325160,3_3_3_3_3_3_3_3_3_18_3_18_18_18_18_18_3_3_3_1_1_3_17_17_17_18
312,129,1325769180,8,9,2,1326180120,410940,288780,1188000,899220,26_26_8_8
313,91,1325769660,10,16,10,1325769720,60,14460,1030200,1015740,10_10
314,91,1325769720,10,16,10,1325778420,8700,14520,1030200,1015680,10_10_10
315,109,1325770140,5,9,6,1325800800,30660,240240,274500,34260,14_14_14_14_1_14_1_14_14_14_14_14_5_5
316,76,1325770320,17,12,17,1325772180,1860,228720,7552500,7323780,3_3_3_3_3_3_3_3_3_18_3_18_18_18_18_18_3_3_3_1_1_3_17_17_17_18_17
317,98,1325771520,34,15,2,1325973600,202080,32100,7319880,7287780,34_34
318,150,1325772000,3,17,3,1325775240,3240,289800,626340,336540,41_41_1_1_3
319,124,1325772000,41,38,41,1325826000,54000,203400,754200,550800,41_41_41_41_5_41_5_41
320,76,1325772180,17,8,18,1325773680,1500,230580,7552500,7321920,3_3_3_3_3_3_3_3_3_18_3_18_18_18_18_18_3_3_3_1_1_3_17_17_17_18_17_17
321,141,1325772600,1,2,1,1325775600,3000,119400,7406100,7286700,1_1_16_16_16_16_16_1_16_16_1
322,76,1325773680,18,5,18,1325785980,12300,232080,7552500,7320420,3_3_3_3_3_3_3_3_3_18_3_18_18_18_18_18_3_3_3_1_1_3_17_17_17_18_17_17_18
323,150,1325775240,3,17,14,1325775600,360,293040,626340,333300,41_41_1_1_3_3
324,141,1325775600,1,18,1,1325777700,2100,122400,7406100,7283700,1_1_16_16_16_16_16_1_16_16_1_1
325,87,1325775600,19,14,19,1325787720,12120,198000,1090800,892800,19_19_19_19_19_19_19_19_19_19_1_1_19_19
326,150,1325775600,14,17,14,1325781000,5400,293400,626340,332940,41_41_1_1_3_3_14
327,93,1325776020,3,3,3,1325777700,1680,177120,1242300,1065180,3_3_3
328,141,1325777700,1,18,16,1325777820,120,124500,7406100,7281600,1_1_16_16_16_16_16_1_16_16_1_1_1
329,93,1325777700,3,3,18,1326039060,261360,178800,1242300,1063500,3_3_3_3
330,141,1325777820,16,20,16,1325785860,8040,124620,7406100,7281480,1_1_16_16_16_16_16_1_16_16_1_1_1_16
331,79,1325777820,26,13,26,1325777940,120,149820,4151700,4001880,15_1_15_1_26_26_26_26_26_26
332,79,1325777940,26,13,26,1325778120,180,149940,4151700,4001760,15_1_15_1_26_26_26_26_26_26_26
333,79,1325778120,26,13,26,1325825460,47340,150120,4151700,4001580,15_1_15_1_26_26_26_26_26_26_26_26
334,91,1325778420,10,16,10,1325789580,11160,23220,1030200,1006980,10_10_10_10
335,142,1325779080,0,1,0,1325787660,8580,20640,7299960,7279320,0_0
336,150,1325781000,14,17,14,1325799900,18900,298800,626340,327540,41_41_1_1_3_3_14_14_14
337,150,1325781000,14,17,14,1325781000,0,298800,626340,327540,41_41_1_1_3_3_14_14
338,141,1325785860,16,0,16,1325789400,3540,132660,7406100,7273440,1_1_16_16_16_16_16_1_16_16_1_1_1_16_16
339,76,1325785980,18,5,18,1325789520,3540,244380,7552500,7308120,3_3_3_3_3_3_3_3_3_18_3_18_18_18_18_18_3_3_3_1_1_3_17_17_17_18_17_17_18_18
340,142,1325787660,0,11,0,1325805240,17580,29220,7299960,7270740,0_0_0
341,87,1325787720,19,11,19,1325800800,13080,210120,1090800,880680,19_19_19_19_19_19_19_19_19_19_1_1_19_19_19
342,141,1325789400,16,0,16,1325789460,60,136200,7406100,7269900,1_1_16_16_16_16_16_1_16_16_1_1_1_16_16_16
343,141,1325789460,16,0,16,1325824860,35400,136260,7406100,7269840,1_1_16_16_16_16_16_1_16_16_1_1_1_16_16_16_16
344,76,1325789520,18,23,18,1325825280,35760,247920,7552500,7304580,3_3_3_3_3_3_3_3_3_18_3_18_18_18_18_18_3_3_3_1_1_3_17_17_17_18_17_17_18_18_18
345,91,1325789580,10,5,10,1325793780,4200,34380,1030200,995820,10_10_10_10_10
346,91,1325793780,10,5,1,1325835900,42120,38580,1030200,991620,10_10_10_10_10_10
347,150,1325799900,14,17,14,1325998200,198300,317700,626340,308640,41_41_1_1_3_3_14_14_14_14
348,87,1325800800,19,11,1,1325825400,24600,223200,1090800,867600,19_19_19_19_19_19_19_19_19_19_1_1_19_19_19_19
349,51,1325800800,6,7,6,1325804400,3600,277200,280800,3600,14_14_14_14_5_5_5_5_6
350,109,1325800800,6,24,6,1325804400,3600,270900,274500,3600,14_14_14_14_1_14_1_14_14_14_14_14_5_5_6
351,128,1325800800,6,7,6,1325804400,3600,308700,346200,37500,2_2_9_9_9_9_9_9_5_5_6
352,103,1325800980,19,11,19,1325805180,4200,0,4719960,4719960,19
353,128,1325804400,6,7,5,1325838240,33840,312300,346200,33900,2_2_9_9_9_9_9_9_5_5_6_6
354,51,1325804400,6,7,99,1325804400,0,280800,280800,0,14_14_14_14_5_5_5_5_6_6
355,109,1325804400,6,24,99,1325804400,0,274500,274500,0,14_14_14_14_1_14_1_14_14_14_14_14_5_5_6_6
356,103,1325805180,19,11,19,1325805240,60,4200,4719960,4715760,19_19
357,103,1325805240,19,11,19,1325824740,19500,4260,4719960,4715700,19_19_19
358,142,1325805240,0,11,0,1325805300,60,46800,7299960,7253160,0_0_0_0
359,142,1325805300,0,11,0,1325824740,19440,46860,7299960,7253100,0_0_0_0_0
360,103,1325824740,19,11,19,1326006780,182040,23760,4719960,4696200,19_19_19_19
361,142,1325824740,0,11,0,1325828040,3300,66300,7299960,7233660,0_0_0_0_0_0
362,141,1325824860,16,0,16,1325827260,2400,171660,7406100,7234440,1_1_16_16_16_16_16_1_16_16_1_1_1_16_16_16_16_16
363,76,1325825280,18,23,18,1325826000,720,283680,7552500,7268820,3_3_3_3_3_3_3_3_3_18_3_18_18_18_18_18_3_3_3_1_1_3_17_17_17_18_17_17_18_18_18_18
364,87,1325825400,1,9,1,1325831220,5820,247800,1090800,843000,19_19_19_19_19_19_19_19_19_19_1_1_19_19_19_19_1
365,79,1325825460,26,13,26,1325829600,4140,197460,4151700,3954240,15_1_15_1_26_26_26_26_26_26_26_26_26
366,52,1325826000,33,31,33,1325842200,16200,198000,608400,410400,15_15_33
367,76,1325826000,17,8,17,1325826000,0,284400,7552500,7268100,3_3_3_3_3_3_3_3_3_18_3_18_18_18_18_18_3_3_3_1_1_3_17_17_17_18_17_17_18_18_18_18_18_17
368,124,1325826000,41,38,41,1325847600,21600,257400,754200,496800,41_41_41_41_5_41_5_41_41
369,76,1325826000,17,10,18,1325826060,60,284400,7552500,7268100,3_3_3_3_3_3_3_3_3_18_3_18_18_18_18_18_3_3_3_1_1_3_17_17_17_18_17_17_18_18_18_18_18_17_17
370,76,1325826000,18,19,17,1325826000,0,284400,7552500,7268100,3_3_3_3_3_3_3_3_3_18_3_18_18_18_18_18_3_3_3_1_1_3_17_17_17_18_17_17_18_18_18_18_18
371,76,1325826060,18,19,3,1325830140,4080,284460,7552500,7268040,3_3_3_3_3_3_3_3_3_18_3_18_18_18_18_18_3_3_3_1_1_3_17_17_17_18_17_17_18_18_18_18_18_17_17_18
372,53,1325826660,26,16,26,1325843760,17100,0,582540,582540,26
373,141,1325827260,16,20,16,1325846340,19080,174060,7406100,7232040,1_1_16_16_16_16_16_1_16_16_1_1_1_16_16_16_16_16_16
374,142,1325828040,0,1,1,1325828340,300,69600,7299960,7230360,0_0_0_0_0_0_0
375,142,1325828340,1,9,1,1325835840,7500,69900,7299960,7230060,0_0_0_0_0_0_0_1
376,79,1325829600,26,13,26,1325829660,60,201600,4151700,3950100,15_1_15_1_26_26_26_26_26_26_26_26_26_26
377,79,1325829660,26,13,26,1325846400,16740,201660,4151700,3950040,15_1_15_1_26_26_26_26_26_26_26_26_26_26_26
378,76,1325830140,3,3,3,1325836980,6840,288540,7552500,7263960,3_3_3_3_3_3_3_3_3_18_3_18_18_18_18_18_3_3_3_1_1_3_17_17_17_18_17_17_18_18_18_18_18_17_17_18_3
379,87,1325831220,1,9,1,1325837040,5820,253620,1090800,837180,19_19_19_19_19_19_19_19_19_19_1_1_19_19_19_19_1_1
380,142,1325835840,1,9,0,1325847120,11280,77400,7299960,7222560,0_0_0_0_0_0_0_1_1
381,91,1325835900,1,9,1,1325835960,60,80700,1030200,949500,10_10_10_10_10_10_1
382,91,1325835960,1,9,1,1325836020,60,80760,1030200,949440,10_10_10_10_10_10_1_1
383,91,1325836020,1,9,1,1325840520,4500,80820,1030200,949380,10_10_10_10_10_10_1_1_1
384,76,1325836980,3,3,18,1325847180,10200,295380,7552500,7257120,3_3_3_3_3_3_3_3_3_18_3_18_18_18_18_18_3_3_3_1_1_3_17_17_17_18_17_17_18_18_18_18_18_17_17_18_3_3
385,87,1325837040,1,9,1,1325837340,300,259440,1090800,831360,19_19_19_19_19_19_19_19_19_19_1_1_19_19_19_19_1_1_1
386,87,1325837340,1,9,2,1325845560,8220,259740,1090800,831060,19_19_19_19_19_19_19_19_19_19_1_1_19_19_19_19_1_1_1_1
387,128,1325838240,5,9,5,1325838300,60,346140,346200,60,2_2_9_9_9_9_9_9_5_5_6_6_5
388,128,1325838300,5,9,99,1325838300,0,346200,346200,0,2_2_9_9_9_9_9_9_5_5_6_6_5_5
389,91,1325840520,1,9,2,1326022620,182100,85320,1030200,944880,10_10_10_10_10_10_1_1_1_1
390,52,1325842200,33,31,5,1325998800,156600,214200,608400,394200,15_15_33_33
391,53,1325843760,26,16,10,1325843760,0,17100,582540,565440,26_26
392,53,1325843760,10,16,10,1325846280,2520,17100,582540,565440,26_26_10
393,87,1325845560,2,4,2,1325846940,1380,267960,1090800,822840,19_19_19_19_19_19_19_19_19_19_1_1_19_19_19_19_1_1_1_1_2
394,53,1325846280,10,16,10,1325846280,0,19620,582540,562920,26_26_10_10
395,53,1325846280,10,16,10,1325850780,4500,19620,582540,562920,26_26_10_10_10
396,141,1325846340,16,20,16,1325847600,1260,193140,7406100,7212960,1_1_16_16_16_16_16_1_16_16_1_1_1_16_16_16_16_16_16_16
397,79,1325846400,26,13,26,1325848080,1680,218400,4151700,3933300,15_1_15_1_26_26_26_26_26_26_26_26_26_26_26_26_26
398,79,1325846400,26,13,26,1325846400,0,218400,4151700,3933300,15_1_15_1_26_26_26_26_26_26_26_26_26_26_26_26
399,87,1325846940,2,4,2,1326000600,153660,269340,1090800,821460,19_19_19_19_19_19_19_19_19_19_1_1_19_19_19_19_1_1_1_1_2_2
400,142,1325847120,0,1,0,1325847600,480,88680,7299960,7211280,0_0_0_0_0_0_0_1_1_0
401,76,1325847180,18,19,17,1325908800,61620,305580,7552500,7246920,3_3_3_3_3_3_3_3_3_18_3_18_18_18_18_18_3_3_3_1_1_3_17_17_17_18_17_17_18_18_18_18_18_17_17_18_3_3_18
402,124,1325847600,41,38,41,1325998140,150540,279000,754200,475200,41_41_41_41_5_41_5_41_41_41
403,142,1325847600,0,14,0,1325912400,64800,89160,7299960,7210800,0_0_0_0_0_0_0_1_1_0_0
404,141,1325847600,16,14,16,1325912400,64800,194400,7406100,7211700,1_1_16_16_16_16_16_1_16_16_1_1_1_16_16_16_16_16_16_16_16
405,79,1325848080,26,13,26,1325997780,149700,220080,4151700,3931620,15_1_15_1_26_26_26_26_26_26_26_26_26_26_26_26_26_26
406,53,1325850780,10,16,10,1326006480,155700,24120,582540,558420,26_26_10_10_10_10
407,76,1325908800,17,10,18,1325966220,57420,367200,7552500,7185300,3_3_3_3_3_3_3_3_3_18_3_18_18_18_18_18_3_3_3_1_1_3_17_17_17_18_17_17_18_18_18_18_18_17_17_18_3_3_18_17
408,141,1325912400,16,14,16,1325971800,59400,259200,7406100,7146900,1_1_16_16_16_16_16_1_16_16_1_1_1_16_16_16_16_16_16_16_16_16_16
409,142,1325912400,0,14,0,1325912400,0,153960,7299960,7146000,0_0_0_0_0_0_0_1_1_0_0_0
410,141,1325912400,16,14,16,1325912400,0,259200,7406100,7146900,1_1_16_16_16_16_16_1_16_16_1_1_1_16_16_16_16_16_16_16_16_16
411,142,1325912400,0,14,0,1325971800,59400,153960,7299960,7146000,0_0_0_0_0_0_0_1_1_0_0_0_0
412,76,1325966220,18,5,18,1325998620,32400,424620,7552500,7127880,3_3_3_3_3_3_3_3_3_18_3_18_18_18_18_18_3_3_3_1_1_3_17_17_17_18_17_17_18_18_18_18_18_17_17_18_3_3_18_17_18
413,141,1325971800,16,14,16,1325972160,360,318600,7406100,7087500,1_1_16_16_16_16_16_1_16_16_1_1_1_16_16_16_16_16_16_16_16_16_16_16
414,142,1325971800,0,14,0,1325972220,420,213360,7299960,7086600,0_0_0_0_0_0_0_1_1_0_0_0_0_0
415,141,1325972160,16,12,16,1325997300,25140,318960,7406100,7087140,1_1_16_16_16_16_16_1_16_16_1_1_1_16_16_16_16_16_16_16_16_16_16_16_16
416,142,1325972220,0,12,0,1325997780,25560,213780,7299960,7086180,0_0_0_0_0_0_0_1_1_0_0_0_0_0_0
417,98,1325973600,2,15,2,1325978100,4500,234180,7319880,7085700,34_34_2
418,98,1325978100,2,15,35,1326037920,59820,238680,7319880,7081200,34_34_2_2
419,106,1325985180,46,12,46,1325995080,9900,403980,1023180,619200,46_46_46_46_46_46_46_46_1_1_2_2_9_9_46
420,106,1325995080,46,12,46,1325995140,60,413880,1023180,609300,46_46_46_46_46_46_46_46_1_1_2_2_9_9_46_46
421,106,1325995140,46,12,46,1325997360,2220,413940,1023180,609240,46_46_46_46_46_46_46_46_1_1_2_2_9_9_46_46_46
422,141,1325997300,16,12,16,1325999160,1860,344100,7406100,7062000,1_1_16_16_16_16_16_1_16_16_1_1_1_16_16_16_16_16_16_16_16_16_16_16_16_16
423,106,1325997360,46,12,1,1325998800,1440,416160,1023180,607020,46_46_46_46_46_46_46_46_1_1_2_2_9_9_46_46_46_46
424,79,1325997780,26,13,26,1326002040,4260,369780,4151700,3781920,15_1_15_1_26_26_26_26_26_26_26_26_26_26_26_26_26_26_26
425,142,1325997780,0,12,0,1325998800,1020,239340,7299960,7060620,0_0_0_0_0_0_0_1_1_0_0_0_0_0_0_0
426,124,1325998140,41,38,41,1326038340,40200,429540,754200,324660,41_41_41_41_5_41_5_41_41_41_41
427,150,1325998200,14,17,14,1326004200,6000,516000,626340,110340,41_41_1_1_3_3_14_14_14_14_14
428,76,1325998620,18,5,17,1326006720,8100,457020,7552500,7095480,3_3_3_3_3_3_3_3_3_18_3_18_18_18_18_18_3_3_3_1_1_3_17_17_17_18_17_17_18_18_18_18_18_17_17_18_3_3_18_17_18_18
429,142,1325998800,0,0,1,1326001800,3000,240360,7299960,7059600,0_0_0_0_0_0_0_1_1_0_0_0_0_0_0_0_0
430,106,1325998800,1,18,1,1326002400,3600,417600,1023180,605580,46_46_46_46_46_46_46_46_1_1_2_2_9_9_46_46_46_46_1
431,52,1325998800,5,6,5,1326010260,11460,370800,608400,237600,15_15_33_33_5
432,141,1325999160,16,0,16,1326004740,5580,345960,7406100,7060140,1_1_16_16_16_16_16_1_16_16_1_1_1_16_16_16_16_16_16_16_16_16_16_16_16_16_16
433,87,1326000600,2,4,2,1326001800,1200,423000,1090800,667800,19_19_19_19_19_19_19_19_19_19_1_1_19_19_19_19_1_1_1_1_2_2_2
434,87,1326001800,2,4,21,1326026340,24540,424200,1090800,666600,19_19_19_19_19_19_19_19_19_19_1_1_19_19_19_19_1_1_1_1_2_2_2_2
435,142,1326001800,1,9,1,1326009600,7800,243360,7299960,7056600,0_0_0_0_0_0_0_1_1_0_0_0_0_0_0_0_0_1
436,79,1326002040,26,13,8,1326010320,8280,374040,4151700,3777660,15_1_15_1_26_26_26_26_26_26_26_26_26_26_26_26_26_26_26_26
437,106,1326002400,1,18,46,1326006180,3780,421200,1023180,601980,46_46_46_46_46_46_46_46_1_1_2_2_9_9_46_46_46_46_1_1
438,150,1326004200,14,17,3,1326004200,0,522000,626340,104340,41_41_1_1_3_3_14_14_14_14_14_14
439,150,1326004200,3,17,3,1326004800,600,522000,626340,104340,41_41_1_1_3_3_14_14_14_14_14_14_3
440,141,1326004740,16,0,1,1326006000,1260,351540,7406100,7054560,1_1_16_16_16_16_16_1_16_16_1_1_1_16_16_16_16_16_16_16_16_16_16_16_16_16_16_16
441,150,1326004800,3,17,14,1326006180,1380,522600,626340,103740,41_41_1_1_3_3_14_14_14_14_14_14_3_3
442,65,1326006000,1,18,1,1326014040,8040,464400,7544400,7080000,17_17_34_34_6_6_6_6_5_5_1_1_1
443,80,1326006000,1,9,1,1326012180,6180,0,338580,338580,1
444,141,1326006000,1,2,1,1326019800,13800,352800,7406100,7053300,1_1_16_16_16_16_16_1_16_16_1_1_1_16_16_16_16_16_16_16_16_16_16_16_16_16_16_16_1
445,106,1326006180,46,8,46,1326011640,5460,424980,1023180,598200,46_46_46_46_46_46_46_46_1_1_2_2_9_9_46_46_46_46_1_1_46
446,150,1326006180,14,17,14,1326009600,3420,523980,626340,102360,41_41_1_1_3_3_14_14_14_14_14_14_3_3_14
447,53,1326006480,10,16,1,1326015360,8880,179820,582540,402720,26_26_10_10_10_10_10
448,76,1326006720,17,10,18,1326009720,3000,465120,7552500,7087380,3_3_3_3_3_3_3_3_3_18_3_18_18_18_18_18_3_3_3_1_1_3_17_17_17_18_17_17_18_18_18_18_18_17_17_18_3_3_18_17_18_18_17
449,103,1326006780,19,11,19,1326017340,10560,205800,4719960,4514160,19_19_19_19_19
450,150,1326009600,14,17,14,1326009600,0,527400,626340,98940,41_41_1_1_3_3_14_14_14_14_14_14_3_3_14_14
451,150,1326009600,14,17,14,1326037380,27780,527400,626340,98940,41_41_1_1_3_3_14_14_14_14_14_14_3_3_14_14_14
452,142,1326009600,1,9,0,1326031200,21600,251160,7299960,7048800,0_0_0_0_0_0_0_1_1_0_0_0_0_0_0_0_0_1_1
453,76,1326009720,18,23,18,1326021600,11880,468120,7552500,7084380,3_3_3_3_3_3_3_3_3_18_3_18_18_18_18_18_3_3_3_1_1_3_17_17_17_18_17_17_18_18_18_18_18_17_17_18_3_3_18_17_18_18_17_18
454,52,1326010260,5,6,6,1326232800,222540,382260,608400,226140,15_15_33_33_5_5
455,79,1326010320,8,6,8,1326013980,3660,382320,4151700,3769380,15_1_15_1_26_26_26_26_26_26_26_26_26_26_26_26_26_26_26_26_8
456,106,1326011640,46,8,1,1326018000,6360,430440,1023180,592740,46_46_46_46_46_46_46_46_1_1_2_2_9_9_46_46_46_46_1_1_46_46
457,121,1326011700,7,8,7,1326030780,19080,0,856140,856140,7
458,80,1326012180,1,9,2,1326019620,7440,6180,338580,332400,1_1
459,79,1326013980,8,6,1,1326021600,7620,385980,4151700,3765720,15_1_15_1_26_26_26_26_26_26_26_26_26_26_26_26_26_26_26_26_8_8
460,65,1326014040,1,18,2,1326019200,5160,472440,7544400,7071960,17_17_34_34_6_6_6_6_5_5_1_1_1_1
461,53,1326015360,1,9,1,1326016740,1380,188700,582540,393840,26_26_10_10_10_10_10_1
462,53,1326016740,1,9,10,1326029940,13200,190080,582540,392460,26_26_10_10_10_10_10_1_1
463,103,1326017340,19,11,19,1326017400,60,216360,4719960,4503600,19_19_19_19_19_19
464,103,1326017400,19,11,1,1326017820,420,216420,4719960,4503540,19_19_19_19_19_19_19
465,103,1326017820,1,9,1,1326018480,660,216840,4719960,4503120,19_19_19_19_19_19_19_1
466,106,1326018000,1,18,1,1326024060,6060,436800,1023180,586380,46_46_46_46_46_46_46_46_1_1_2_2_9_9_46_46_46_46_1_1_46_46_1
467,103,1326018480,1,9,19,1326037740,19260,217500,4719960,4502460,19_19_19_19_19_19_19_1_1
468,65,1326019200,2,3,2,1326022620,3420,477600,7544400,7066800,17_17_34_34_6_6_6_6_5_5_1_1_1_1_2
469,80,1326019620,2,3,2,1326022620,3000,13620,338580,324960,1_1_2
470,141,1326019800,1,2,1,1326021600,1800,366600,7406100,7039500,1_1_16_16_16_16_16_1_16_16_1_1_1_16_16_16_16_16_16_16_16_16_16_16_16_16_16_16_1_1
471,79,1326021600,1,6,1,1326029400,7800,393600,4151700,3758100,15_1_15_1_26_26_26_26_26_26_26_26_26_26_26_26_26_26_26_26_8_8_1
472,76,1326021600,18,23,17,1326029940,8340,480000,7552500,7072500,3_3_3_3_3_3_3_3_3_18_3_18_18_18_18_18_3_3_3_1_1_3_17_17_17_18_17_17_18_18_18_18_18_17_17_18_3_3_18_17_18_18_17_18_18
473,141,1326021600,1,2,1,1326022800,1200,368400,7406100,7037700,1_1_16_16_16_16_16_1_16_16_1_1_1_16_16_16_16_16_16_16_16_16_16_16_16_16_16_16_1_1_1
474,60,1326021660,18,23,18,1326028080,6420,363660,7401300,7037640,3_3_18
475,65,1326022620,2,3,3,1327557600,1534980,481020,7544400,7063380,17_17_34_34_6_6_6_6_5_5_1_1_1_1_2_2
476,80,1326022620,2,3,3,1326146400,123780,16620,338580,321960,1_1_2_2
477,91,1326022620,2,3,2,1326025200,2580,267420,1030200,762780,10_10_10_10_10_10_1_1_1_1_2
478,141,1326022800,1,2,1,1326024000,1200,369600,7406100,7036500,1_1_16_16_16_16_16_1_16_16_1_1_1_16_16_16_16_16_16_16_16_16_16_16_16_16_16_16_1_1_1_1_1
479,141,1326022800,1,2,1,1326022800,0,369600,7406100,7036500,1_1_16_16_16_16_16_1_16_16_1_1_1_16_16_16_16_16_16_16_16_16_16_16_16_16_16_16_1_1_1_1
480,141,1326024000,1,2,1,1326025200,1200,370800,7406100,7035300,1_1_16_16_16_16_16_1_16_16_1_1_1_16_16_16_16_16_16_16_16_16_16_16_16_16_16_16_1_1_1_1_1_1_1
481,141,1326024000,1,2,1,1326024000,0,370800,7406100,7035300,1_1_16_16_16_16_16_1_16_16_1_1_1_16_16_16_16_16_16_16_16_16_16_16_16_16_16_16_1_1_1_1_1_1
482,106,1326024060,1,18,1,1326085200,61140,442860,1023180,580320,46_46_46_46_46_46_46_46_1_1_2_2_9_9_46_46_46_46_1_1_46_46_1_1
483,120,1326024240,5,18,5,1326029220,4980,536640,576000,39360,7_7_7_7_7_7_1_1_2_2_9_9_9_9_9_9_5
484,141,1326025200,1,2,1,1326025200,0,372000,7406100,7034100,1_1_16_16_16_16_16_1_16_16_1_1_1_16_16_16_16_16_16_16_16_16_16_16_16_16_16_16_1_1_1_1_1_1_1_1
485,91,1326025200,2,3,3,1326025260,60,270000,1030200,760200,10_10_10_10_10_10_1_1_1_1_2_2
486,141,1326025200,1,2,1,1326026400,1200,372000,7406100,7034100,1_1_16_16_16_16_16_1_16_16_1_1_1_16_16_16_16_16_16_16_16_16_16_16_16_16_16_16_1_1_1_1_1_1_1_1_1
487,91,1326025260,3,3,3,1326034080,8820,270060,1030200,760140,10_10_10_10_10_10_1_1_1_1_2_2_3
488,87,1326026340,21,4,3,1326032580,6240,448740,1090800,642060,19_19_19_19_19_19_19_19_19_19_1_1_19_19_19_19_1_1_1_1_2_2_2_2_21
489,141,1326026400,1,2,1,1326026400,0,373200,7406100,7032900,1_1_16_16_16_16_16_1_16_16_1_1_1_16_16_16_16_16_16_16_16_16_16_16_16_16_16_16_1_1_1_1_1_1_1_1_1_1
490,141,1326026400,1,2,1,1326027600,1200,373200,7406100,7032900,1_1_16_16_16_16_16_1_16_16_1_1_1_16_16_16_16_16_16_16_16_16_16_16_16_16_16_16_1_1_1_1_1_1_1_1_1_1_1
491,88,1326026640,1,9,1,1326027720,1080,0,555360,555360,1
492,141,1326027600,1,2,16,1326044520,16920,374400,7406100,7031700,1_1_16_16_16_16_16_1_16_16_1_1_1_16_16_16_16_16_16_16_16_16_16_16_16_16_16_16_1_1_1_1_1_1_1_1_1_1_1_1
493,82,1326027720,1,9,1,1326028020,300,0,2195880,2195880,1
494,88,1326027720,1,9,2,1326042840,15120,1080,555360,554280,1_1
495,125,1326027840,16,20,16,1326032100,4260,0,3969060,3969060,16
496,82,1326028020,1,9,2,1326095040,67020,300,2195880,2195580,1_1
497,60,1326028080,18,23,18,1326028140,60,370080,7401300,7031220,3_3_18_18
498,60,1326028140,18,23,18,1326031020,2880,370140,7401300,7031160,3_3_18_18_18
499,120,1326029220,5,18,6,1326060000,30780,541620,576000,34380,7_7_7_7_7_7_1_1_2_2_9_9_9_9_9_9_5_5
500,79,1326029400,1,6,10,1326693600,664200,401400,4151700,3750300,15_1_15_1_26_26_26_26_26_26_26_26_26_26_26_26_26_26_26_26_8_8_1_1
501,53,1326029940,10,16,1,1326030300,360,203280,582540,379260,26_26_10_10_10_10_10_1_1_10
502,76,1326029940,17,10,17,1326046680,16740,488340,7552500,7064160,3_3_3_3_3_3_3_3_3_18_3_18_18_18_18_18_3_3_3_1_1_3_17_17_17_18_17_17_18_18_18_18_18_17_17_18_3_3_18_17_18_18_17_18_18_17
503,53,1326030300,1,9,1,1326034800,4500,203640,582540,378900,26_26_10_10_10_10_10_1_1_10_1
504,121,1326030780,7,8,7,1326030900,120,19080,856140,837060,7_7
505,121,1326030900,7,8,7,1326037560,6660,19200,856140,836940,7_7_7
506,60,1326031020,18,23,18,1326031140,120,373020,7401300,7028280,3_3_18_18_18_18
507,60,1326031140,18,19,18,1326053580,22440,373140,7401300,7028160,3_3_18_18_18_18_18
508,142,1326031200,0,11,0,1326031500,300,272760,7299960,7027200,0_0_0_0_0_0_0_1_1_0_0_0_0_0_0_0_0_1_1_0
509,142,1326031500,0,0,0,1326037800,6300,273060,7299960,7026900,0_0_0_0_0_0_0_1_1_0_0_0_0_0_0_0_0_1_1_0_0
510,125,1326032100,16,20,16,1326084600,52500,4260,3969060,3964800,16_16
511,111,1326032400,1,9,1,1326034320,1920,573600,3974400,3400800,0_0_0_0_0_0_0_0_0_0_0_1_0_1_0_0_0_0_1_0_1_0_0_0_0_0_0_1_1_0_1
512,87,1326032580,3,15,3,1326034200,1620,454980,1090800,635820,19_19_19_19_19_19_19_19_19_19_1_1_19_19_19_19_1_1_1_1_2_2_2_2_21_3
513,91,1326034080,3,3,3,1326034140,60,278880,1030200,751320,10_10_10_10_10_10_1_1_1_1_2_2_3_3
514,91,1326034140,2,3,3,1326038640,4500,278940,1030200,751260,10_10_10_10_10_10_1_1_1_1_2_2_3_3_3_2
515,91,1326034140,3,3,2,1326034140,0,278940,1030200,751260,10_10_10_10_10_10_1_1_1_1_2_2_3_3_3
516,87,1326034200,3,3,21,1326035280,1080,456600,1090800,634200,19_19_19_19_19_19_19_19_19_19_1_1_19_19_19_19_1_1_1_1_2_2_2_2_21_3_3
517,111,1326034320,1,9,2,1326867480,833160,575520,3974400,3398880,0_0_0_0_0_0_0_0_0_0_0_1_0_1_0_0_0_0_1_0_1_0_0_0_0_0_0_1_1_0_1_1
518,53,1326034800,1,9,2,1326174660,139860,208140,582540,374400,26_26_10_10_10_10_10_1_1_10_1_1
519,87,1326035280,21,4,3,1326037080,1800,457680,1090800,633120,19_19_19_19_19_19_19_19_19_19_1_1_19_19_19_19_1_1_1_1_2_2_2_2_21_3_3_21
520,87,1326037080,3,3,3,1326037860,780,459480,1090800,631320,19_19_19_19_19_19_19_19_19_19_1_1_19_19_19_19_1_1_1_1_2_2_2_2_21_3_3_21_3
521,150,1326037380,14,17,6,1326060000,22620,555180,626340,71160,41_41_1_1_3_3_14_14_14_14_14_14_3_3_14_14_14_14
522,121,1326037560,7,8,7,1326046500,8940,25860,856140,830280,7_7_7_7
523,103,1326037740,19,11,19,1326045600,7860,236760,4719960,4483200,19_19_19_19_19_19_19_1_1_19
524,142,1326037800,0,11,0,1326045600,7800,279360,7299960,7020600,0_0_0_0_0_0_0_1_1_0_0_0_0_0_0_0_0_1_1_0_0_0
525,87,1326037860,3,15,3,1326060000,22140,460260,1090800,630540,19_19_19_19_19_19_19_19_19_19_1_1_19_19_19_19_1_1_1_1_2_2_2_2_21_3_3_21_3_3
526,98,1326037920,35,15,35,1326058440,20520,298500,7319880,7021380,34_34_2_2_35
527,124,1326038340,41,38,2,1326112320,73980,469740,754200,284460,41_41_41_41_5_41_5_41_41_41_41_41
528,91,1326038640,2,3,5,1326604740,566100,283440,1030200,746760,10_10_10_10_10_10_1_1_1_1_2_2_3_3_3_2_3_2
529,91,1326038640,3,3,2,1326038640,0,283440,1030200,746760,10_10_10_10_10_10_1_1_1_1_2_2_3_3_3_2_3
530,93,1326039060,18,19,18,1326042180,3120,440160,1242300,802140,3_3_3_3_18
531,93,1326042180,18,19,18,1326114780,72600,443280,1242300,799020,3_3_3_3_18_18
532,88,1326042840,2,19,2,1326045900,3060,16200,555360,539160,1_1_2
533,141,1326044520,16,20,2,1326050040,5520,391320,7406100,7014780,1_1_16_16_16_16_16_1_16_16_1_1_1_16_16_16_16_16_16_16_16_16_16_16_16_16_16_16_1_1_1_1_1_1_1_1_1_1_1_1_16
534,142,1326045600,0,14,0,1326084540,38940,287160,7299960,7012800,0_0_0_0_0_0_0_1_1_0_0_0_0_0_0_0_0_1_1_0_0_0_0
535,103,1326045600,19,14,19,1326083400,37800,244620,4719960,4475340,19_19_19_19_19_19_19_1_1_19_19
536,88,1326045900,2,19,2,1326045960,60,19260,555360,536100,1_1_2_2
537,88,1326045960,2,5,2,1326048600,2640,19320,555360,536040,1_1_2_2_2
538,121,1326046500,7,12,7,1326067140,20640,34800,856140,821340,7_7_7_7_7
539,76,1326046680,17,12,17,1326054000,7320,505080,7552500,7047420,3_3_3_3_3_3_3_3_3_18_3_18_18_18_18_18_3_3_3_1_1_3_17_17_17_18_17_17_18_18_18_18_18_17_17_18_3_3_18_17_18_18_17_18_18_17_17
540,88,1326048600,2,5,3,1326060000,11400,21960,555360,533400,1_1_2_2_2_2
541,141,1326050040,2,5,2,1326057420,7380,396840,7406100,7009260,1_1_16_16_16_16_16_1_16_16_1_1_1_16_16_16_16_16_16_16_16_16_16_16_16_16_16_16_1_1_1_1_1_1_1_1_1_1_1_1_16_2
542,60,1326053580,18,19,5,1326776400,722820,395580,7401300,7005720,3_3_18_18_18_18_18_18
543,76,1326054000,17,12,5,1326178800,124800,512400,7552500,7040100,3_3_3_3_3_3_3_3_3_18_3_18_18_18_18_18_3_3_3_1_1_3_17_17_17_18_17_17_18_18_18_18_18_17_17_18_3_3_18_17_18_18_17_18_18_17_17_17
544,84,1326054060,17,12,17,1326068340,14280,395160,3714840,3319680,17_17_17_17_17
545,141,1326057420,2,5,16,1326101700,44280,404220,7406100,7001880,1_1_16_16_16_16_16_1_16_16_1_1_1_16_16_16_16_16_16_16_16_16_16_16_16_16_16_16_1_1_1_1_1_1_1_1_1_1_1_1_16_2_2
546,98,1326058440,35,15,34,1326131160,72720,319020,7319880,7000860,34_34_2_2_35_35
547,87,1326060000,3,4,3,1326064500,4500,482400,1090800,608400,19_19_19_19_19_19_19_19_19_19_1_1_19_19_19_19_1_1_1_1_2_2_2_2_21_3_3_21_3_3_3
548,78,1326060000,40,25,40,1326064500,4500,0,1818900,1818900,40
549,83,1326060000,19,20,19,1326061800,1800,0,1818000,1818000,19
550,120,1326060000,6,24,6,1326063600,3600,572400,576000,3600,7_7_7_7_7_7_1_1_2_2_9_9_9_9_9_9_5_5_6
551,150,1326060000,6,24,6,1326063600,3600,577800,626340,48540,41_41_1_1_3_3_14_14_14_14_14_14_3_3_14_14_14_14_6
552,88,1326060000,3,4,3,1326064500,4500,33360,555360,522000,1_1_2_2_2_2_3
553,56,1326060000,6,24,6,1326063600,3600,0,6361440,6361440,6
554,83,1326061800,19,14,19,1326064500,2700,1800,1818000,1816200,19_19
555,120,1326063600,6,24,99,1326063600,0,576000,576000,0,7_7_7_7_7_7_1_1_2_2_9_9_9_9_9_9_5_5_6_6
556,56,1326063600,6,24,5,1326088800,25200,3600,6361440,6357840,6_6
557,150,1326063600,6,24,14,1326084840,21240,581400,626340,44940,41_41_1_1_3_3_14_14_14_14_14_14_3_3_14_14_14_14_6_6
558,88,1326064500,3,4,3,1326100440,35940,37860,555360,517500,1_1_2_2_2_2_3_3
559,83,1326064500,19,20,19,1326085200,20700,4500,1818000,1813500,19_19_19
560,87,1326064500,3,4,3,1326089520,25020,486900,1090800,603900,19_19_19_19_19_19_19_19_19_19_1_1_19_19_19_19_1_1_1_1_2_2_2_2_21_3_3_21_3_3_3_3
561,78,1326064500,40,25,34,1326296700,232200,4500,1818900,1814400,40_40
562,121,1326067140,7,12,3,1326146400,79260,55440,856140,800700,7_7_7_7_7_7
563,84,1326068340,17,12,17,1326068400,60,409440,3714840,3305400,17_17_17_17_17_17
564,84,1326068400,17,12,17,1326084900,16500,409500,3714840,3305340,17_17_17_17_17_17_17
565,127,1326068460,7,12,7,1326080940,12480,0,599940,599940,7
566,135,1326074400,19,14,19,1326083400,9000,0,5649480,5649480,19
567,127,1326080940,7,12,7,1326080940,0,12480,599940,587460,7_7
568,127,1326080940,7,12,7,1326084900,3960,12480,599940,587460,7_7_7
569,135,1326083400,19,14,19,1326949620,866220,9000,5649480,5640480,19_19
570,103,1326083400,19,14,19,1326085140,1740,282420,4719960,4437540,19_19_19_19_19_19_19_1_1_19_19_19
571,142,1326084540,0,0,0,1326085200,660,326100,7299960,6973860,0_0_0_0_0_0_0_1_1_0_0_0_0_0_0_0_0_1_1_0_0_0_0_0
572,125,1326084600,16,0,16,1326101280,16680,56760,3969060,3912300,16_16_16
573,150,1326084840,14,17,5,1326085200,360,602640,626340,23700,41_41_1_1_3_3_14_14_14_14_14_14_3_3_14_14_14_14_6_6_14
574,127,1326084900,7,12,1,1326085440,540,16440,599940,583500,7_7_7_7
575,84,1326084900,17,12,17,1326085740,840,426000,3714840,3288840,17_17_17_17_17_17_17_17
576,103,1326085140,19,11,1,1326085200,60,284160,4719960,4435800,19_19_19_19_19_19_19_1_1_19_19_19_19
577,106,1326085200,1,18,39,1326085200,0,504000,1023180,519180,46_46_46_46_46_46_46_46_1_1_2_2_9_9_46_46_46_46_1_1_46_46_1_1_1
578,150,1326085200,5,6,14,1326092760,7560,603000,626340,23340,41_41_1_1_3_3_14_14_14_14_14_14_3_3_14_14_14_14_6_6_14_5
579,106,1326085200,39,37,1,1326087420,2220,504000,1023180,519180,46_46_46_46_46_46_46_46_1_1_2_2_9_9_46_46_46_46_1_1_46_46_1_1_1_39
580,83,1326085200,19,14,19,1326146400,61200,25200,1818000,1792800,19_19_19_19
581,142,1326085200,0,14,1,1326089040,3840,326760,7299960,6973200,0_0_0_0_0_0_0_1_1_0_0_0_0_0_0_0_0_1_1_0_0_0_0_0_0
582,103,1326085200,1,9,1,1326086100,900,284220,4719960,4435740,19_19_19_19_19_19_19_1_1_19_19_19_19_1
583,127,1326085440,1,9,7,1326085800,360,16980,599940,582960,7_7_7_7_1
584,140,1326085440,10,16,10,1326095340,9900,418320,1300140,881820,26_26_26_26_10
585,84,1326085740,17,10,17,1326116340,30600,426840,3714840,3288000,17_17_17_17_17_17_17_17_17
586,127,1326085800,7,8,1,1326088980,3180,17340,599940,582600,7_7_7_7_1_7
587,103,1326086100,1,9,19,1326117360,31260,285120,4719960,4434840,19_19_19_19_19_19_19_1_1_19_19_19_19_1_1
588,106,1326087420,1,18,39,1326088800,1380,506220,1023180,516960,46_46_46_46_46_46_46_46_1_1_2_2_9_9_46_46_46_46_1_1_46_46_1_1_1_39_1
589,106,1326088800,39,37,2,1326098760,9960,507600,1023180,515580,46_46_46_46_46_46_46_46_1_1_2_2_9_9_46_46_46_46_1_1_46_46_1_1_1_39_1_39
590,56,1326088800,5,18,5,1326095160,6360,28800,6361440,6332640,6_6_5
591,127,1326088980,1,9,1,1326092700,3720,20520,599940,579420,7_7_7_7_1_7_1
592,142,1326089040,1,9,1,1326090600,1560,330600,7299960,6969360,0_0_0_0_0_0_0_1_1_0_0_0_0_0_0_0_0_1_1_0_0_0_0_0_0_1
593,87,1326089520,3,3,3,1326092700,3180,511920,1090800,578880,19_19_19_19_19_19_19_19_19_19_1_1_19_19_19_19_1_1_1_1_2_2_2_2_21_3_3_21_3_3_3_3_3
594,142,1326090600,1,9,0,1326124320,33720,332160,7299960,6967800,0_0_0_0_0_0_0_1_1_0_0_0_0_0_0_0_0_1_1_0_0_0_0_0_0_1_1
595,87,1326092700,3,4,3,1326094980,2280,515100,1090800,575700,19_19_19_19_19_19_19_19_19_19_1_1_19_19_19_19_1_1_1_1_2_2_2_2_21_3_3_21_3_3_3_3_3_3
596,127,1326092700,1,9,7,1326095160,2460,24240,599940,575700,7_7_7_7_1_7_1_1
597,150,1326092760,14,17,14,1326092760,0,610560,626340,15780,41_41_1_1_3_3_14_14_14_14_14_14_3_3_14_14_14_14_6_6_14_5_14
598,150,1326092760,14,17,14,1326099060,6300,610560,626340,15780,41_41_1_1_3_3_14_14_14_14_14_14_3_3_14_14_14_14_6_6_14_5_14_14
599,87,1326094980,3,3,3,1326095100,120,517380,1090800,573420,19_19_19_19_19_19_19_19_19_19_1_1_19_19_19_19_1_1_1_1_2_2_2_2_21_3_3_21_3_3_3_3_3_3_3
600,82,1326095040,2,3,2,1326095700,660,67320,2195880,2128560,1_1_2
601,87,1326095100,3,4,13,1326099420,4320,517500,1090800,573300,19_19_19_19_19_19_19_19_19_19_1_1_19_19_19_19_1_1_1_1_2_2_2_2_21_3_3_21_3_3_3_3_3_3_3_3
602,56,1326095160,5,18,8,1326096060,900,35160,6361440,6326280,6_6_5_5
603,127,1326095160,7,8,1,1326096300,1140,26700,599940,573240,7_7_7_7_1_7_1_1_7
604,140,1326095340,10,16,10,1326097620,2280,428220,1300140,871920,26_26_26_26_10_10
605,82,1326095700,2,3,3,1326095760,60,67980,2195880,2127900,1_1_2_2
606,82,1326095760,3,3,3,1326098700,2940,68040,2195880,2127840,1_1_2_2_3
607,56,1326096060,8,18,8,1326101880,5820,36060,6361440,6325380,6_6_5_5_8
608,127,1326096300,1,9,2,1326184620,88320,27840,599940,572100,7_7_7_7_1_7_1_1_7_1
609,140,1326097620,10,16,10,1326097740,120,430500,1300140,869640,26_26_26_26_10_10_10
610,140,1326097740,10,16,10,1326098940,1200,430620,1300140,869520,26_26_26_26_10_10_10_10
611,100,1326097800,10,16,10,1326101400,3600,435300,919500,484200,10_10_10
612,82,1326098700,3,3,14,1326949080,850380,70980,2195880,2124900,1_1_2_2_3_3
613,106,1326098760,2,3,2,1326099000,240,517560,1023180,505620,46_46_46_46_46_46_46_46_1_1_2_2_9_9_46_46_46_46_1_1_46_46_1_1_1_39_1_39_2
614,140,1326098940,10,16,10,1326100860,1920,431820,1300140,868320,26_26_26_26_10_10_10_10_10
615,106,1326099000,2,3,9,1326099060,60,517800,1023180,505380,46_46_46_46_46_46_46_46_1_1_2_2_9_9_46_46_46_46_1_1_46_46_1_1_1_39_1_39_2_2
616,106,1326099060,9,3,9,1326100380,1320,517860,1023180,505320,46_46_46_46_46_46_46_46_1_1_2_2_9_9_46_46_46_46_1_1_46_46_1_1_1_39_1_39_2_2_9
617,150,1326099060,14,17,14,1326103380,4320,616860,626340,9480,41_41_1_1_3_3_14_14_14_14_14_14_3_3_14_14_14_14_6_6_14_5_14_14_14
618,87,1326099420,13,17,13,1326103320,3900,521820,1090800,568980,19_19_19_19_19_19_19_19_19_19_1_1_19_19_19_19_1_1_1_1_2_2_2_2_21_3_3_21_3_3_3_3_3_3_3_3_13
619,64,1326100080,1,9,1,1326100260,180,0,6845160,6845160,1
620,64,1326100260,1,9,11,1331042700,4942440,180,6845160,6844980,1_1
621,106,1326100380,9,3,1,1326175740,75360,519180,1023180,504000,46_46_46_46_46_46_46_46_1_1_2_2_9_9_46_46_46_46_1_1_46_46_1_1_1_39_1_39_2_2_9_9
622,88,1326100440,3,3,3,1326123060,22620,73800,555360,481560,1_1_2_2_2_2_3_3_3
623,140,1326100860,10,16,1,1326101700,840,433740,1300140,866400,26_26_26_26_10_10_10_10_10_10
624,125,1326101280,16,0,16,1326101280,0,73440,3969060,3895620,16_16_16_16
625,125,1326101280,16,0,16,1326106560,5280,73440,3969060,3895620,16_16_16_16_16
626,100,1326101400,10,16,10,1326101400,0,438900,919500,480600,10_10_10_10
627,100,1326101400,10,16,10,1326105000,3600,438900,919500,480600,10_10_10_10_10
628,141,1326101700,16,20,3,1328004480,1902780,448500,7406100,6957600,1_1_16_16_16_16_16_1_16_16_1_1_1_16_16_16_16_16_16_16_16_16_16_16_16_16_16_16_1_1_1_1_1_1_1_1_1_1_1_1_16_2_2_16
629,140,1326101700,1,9,1,1326106200,4500,434580,1300140,865560,26_26_26_26_10_10_10_10_10_10_1
630,56,1326101880,8,18,8,1326183060,81180,41880,6361440,6319560,6_6_5_5_8_8
631,87,1326103320,13,17,13,1326105300,1980,525720,1090800,565080,19_19_19_19_19_19_19_19_19_19_1_1_19_19_19_19_1_1_1_1_2_2_2_2_21_3_3_21_3_3_3_3_3_3_3_3_13_13
632,150,1326103380,14,17,14,1326105240,1860,621180,626340,5160,41_41_1_1_3_3_14_14_14_14_14_14_3_3_14_14_14_14_6_6_14_5_14_14_14_14
633,100,1326105000,10,16,1,1326112140,7140,442500,919500,477000,10_10_10_10_10_10
634,144,1326105000,10,16,10,1326123000,18000,0,1807260,1807260,10
635,150,1326105240,14,17,5,1326108540,3300,623040,626340,3300,41_41_1_1_3_3_14_14_14_14_14_14_3_3_14_14_14_14_6_6_14_5_14_14_14_14_14
636,87,1326105300,13,17,13,1326119340,14040,527700,1090800,563100,19_19_19_19_19_19_19_19_19_19_1_1_19_19_19_19_1_1_1_1_2_2_2_2_21_3_3_21_3_3_3_3_3_3_3_3_13_13_13
637,140,1326106200,1,9,2,1326694320,588120,439080,1300140,861060,26_26_26_26_10_10_10_10_10_10_1_1
638,125,1326106560,16,0,1,1326171600,65040,78720,3969060,3890340,16_16_16_16_16_16
639,150,1326108540,5,6,99,1326108540,0,626340,626340,0,41_41_1_1_3_3_14_14_14_14_14_14_3_3_14_14_14_14_6_6_14_5_14_14_14_14_14_5
640,75,1326108540,16,20,16,1326122640,14100,0,6135000,6135000,16
641,100,1326112140,1,9,1,1326116640,4500,449640,919500,469860,10_10_10_10_10_10_1
642,124,1326112320,2,3,2,1326116820,4500,543720,754200,210480,41_41_41_41_5_41_5_41_41_41_41_41_2
643,93,1326114780,18,23,18,1326117780,3000,515880,1242300,726420,3_3_3_3_18_18_18
644,84,1326116340,17,10,17,1326118680,2340,457440,3714840,3257400,17_17_17_17_17_17_17_17_17_17
645,100,1326116640,1,9,1,1326201300,84660,454140,919500,465360,10_10_10_10_10_10_1_1
646,124,1326116820,2,3,5,1326171600,54780,548220,754200,205980,41_41_41_41_5_41_5_41_41_41_41_41_2_2
647,103,1326117360,19,11,19,1326118260,900,316380,4719960,4403580,19_19_19_19_19_19_19_1_1_19_19_19_19_1_1_19
648,93,1326117780,18,23,18,1326118080,300,518880,1242300,723420,3_3_3_3_18_18_18_18
649,93,1326118080,18,19,18,1326126420,8340,519180,1242300,723120,3_3_3_3_18_18_18_18_18
650,103,1326118260,19,0,19,1326123360,5100,317280,4719960,4402680,19_19_19_19_19_19_19_1_1_19_19_19_19_1_1_19_19
651,84,1326118680,17,8,17,1326123840,5160,459780,3714840,3255060,17_17_17_17_17_17_17_17_17_17_17
652,105,1326119340,3,17,3,1326122040,2700,552480,1314480,762000,1_16_1_2_16_2_3
653,87,1326119340,13,17,13,1326143220,23880,541740,1090800,549060,19_19_19_19_19_19_19_19_19_19_1_1_19_19_19_19_1_1_1_1_2_2_2_2_21_3_3_21_3_3_3_3_3_3_3_3_13_13_13_13
654,105,1326122040,3,17,13,1326283500,161460,555180,1314480,759300,1_16_1_2_16_2_3_3
655,118,1326122100,3,17,3,1326124140,2040,0,459900,459900,3
656,75,1326122640,16,20,16,1326132000,9360,14100,6135000,6120900,16_16
657,144,1326123000,10,16,10,1326176340,53340,18000,1807260,1789260,10_10
658,88,1326123060,3,3,5,1326263220,140160,96420,555360,458940,1_1_2_2_2_2_3_3_3_3
659,103,1326123360,19,0,19,1326132060,8700,322380,4719960,4397580,19_19_19_19_19_19_19_1_1_19_19_19_19_1_1_19_19_19
660,84,1326123840,17,8,17,1326134520,10680,464940,3714840,3249900,17_17_17_17_17_17_17_17_17_17_17_17
661,118,1326124140,3,17,3,1326171420,47280,2040,459900,457860,3_3
662,142,1326124320,0,0,0,1326133800,9480,365880,7299960,6934080,0_0_0_0_0_0_0_1_1_0_0_0_0_0_0_0_0_1_1_0_0_0_0_0_0_1_1_0
663,93,1326126420,18,19,18,1326145440,19020,527520,1242300,714780,3_3_3_3_18_18_18_18_18_18_18
664,93,1326126420,18,19,18,1326126420,0,527520,1242300,714780,3_3_3_3_18_18_18_18_18_18
665,98,1326131160,34,15,34,1326143160,12000,391740,7319880,6928140,34_34_2_2_35_35_34
666,75,1326132000,16,14,16,1326142800,10800,23460,6135000,6111540,16_16_16
667,103,1326132060,19,21,19,1326145860,13800,331080,4719960,4388880,19_19_19_19_19_19_19_1_1_19_19_19_19_1_1_19_19_19_19
668,142,1326133800,0,21,0,1326150000,16200,375360,7299960,6924600,0_0_0_0_0_0_0_1_1_0_0_0_0_0_0_0_0_1_1_0_0_0_0_0_0_1_1_0_0
669,84,1326134520,17,12,17,1326170280,35760,475620,3714840,3239220,17_17_17_17_17_17_17_17_17_17_17_17_17
670,75,1326142800,16,14,16,1326150000,7200,34260,6135000,6100740,16_16_16_16
671,98,1326143160,34,15,2,1326146400,3240,403740,7319880,6916140,34_34_2_2_35_35_34_34
672,87,1326143220,13,15,13,1326145260,2040,565620,1090800,525180,19_19_19_19_19_19_19_19_19_19_1_1_19_19_19_19_1_1_1_1_2_2_2_2_21_3_3_21_3_3_3_3_3_3_3_3_13_13_13_13_13
673,87,1326145260,13,15,5,1326176460,31200,567660,1090800,523140,19_19_19_19_19_19_19_19_19_19_1_1_19_19_19_19_1_1_1_1_2_2_2_2_21_3_3_21_3_3_3_3_3_3_3_3_13_13_13_13_13_13
674,93,1326145440,18,19,18,1326145500,60,546540,1242300,695760,3_3_3_3_18_18_18_18_18_18_18_18
675,93,1326145500,18,5,18,1326165540,20040,546600,1242300,695700,3_3_3_3_18_18_18_18_18_18_18_18_18
676,103,1326145860,19,21,1,1326260520,114660,344880,4719960,4375080,19_19_19_19_19_19_19_1_1_19_19_19_19_1_1_19_19_19_19_19
677,80,1326146400,3,4,3,1326150900,4500,140400,338580,198180,1_1_2_2_3
678,70,1326146400,6,7,6,1326150000,3600,0,3064200,3064200,6
679,83,1326146400,19,20,19,1326150000,3600,86400,1818000,1731600,19_19_19_19_19
680,98,1326146400,2,15,2,1326150900,4500,406980,7319880,6912900,34_34_2_2_35_35_34_34_2
681,121,1326146400,3,4,3,1326150900,4500,134700,856140,721440,7_7_7_7_7_7_3
682,75,1326150000,16,14,16,1326169800,19800,41460,6135000,6093540,16_16_16_16_16
683,70,1326150000,6,7,5,1326198600,48600,3600,3064200,3060600,6_6
684,142,1326150000,0,14,0,1326169800,19800,391560,7299960,6908400,0_0_0_0_0_0_0_1_1_0_0_0_0_0_0_0_0_1_1_0_0_0_0_0_0_1_1_0_0_0
685,83,1326150000,19,14,19,1326150900,900,90000,1818000,1728000,19_19_19_19_19_19
686,80,1326150900,3,4,9,1326187920,37020,144900,338580,193680,1_1_2_2_3_3
687,98,1326150900,2,15,3,1327010400,859500,411480,7319880,6908400,34_34_2_2_35_35_34_34_2_2
688,121,1326150900,3,4,1,1326172200,21300,139200,856140,716940,7_7_7_7_7_7_3_3
689,83,1326150900,19,20,19,1326157200,6300,90900,1818000,1727100,19_19_19_19_19_19_19
690,83,1326157200,19,14,19,1326169800,12600,97200,1818000,1720800,19_19_19_19_19_19_19_19_19
691,83,1326157200,19,14,19,1326157200,0,97200,1818000,1720800,19_19_19_19_19_19_19_19
692,93,1326165540,18,5,5,1326258000,92460,566640,1242300,675660,3_3_3_3_18_18_18_18_18_18_18_18_18_18
693,142,1326169800,0,14,0,1326171300,1500,411360,7299960,6888600,0_0_0_0_0_0_0_1_1_0_0_0_0_0_0_0_0_1_1_0_0_0_0_0_0_1_1_0_0_0_0
694,83,1326169800,19,14,19,1326171600,1800,109800,1818000,1708200,19_19_19_19_19_19_19_19_19_19
695,75,1326169800,16,14,1,1326171600,1800,61260,6135000,6073740,16_16_16_16_16_16
696,84,1326170280,17,12,17,1326172680,2400,511380,3714840,3203460,17_17_17_17_17_17_17_17_17_17_17_17_17_17
697,142,1326171300,0,21,0,1326171720,420,412860,7299960,6887100,0_0_0_0_0_0_0_1_1_0_0_0_0_0_0_0_0_1_1_0_0_0_0_0_0_1_1_0_0_0_0_0
698,118,1326171420,3,17,3,1326175920,4500,49320,459900,410580,3_3_3
699,125,1326171600,1,2,1,1326176460,4860,143760,3969060,3825300,16_16_16_16_16_16_1
700,83,1326171600,19,11,19,1326203940,32340,111600,1818000,1706400,19_19_19_19_19_19_19_19_19_19_19
701,124,1326171600,5,2,5,1326171600,0,603000,754200,151200,41_41_41_41_5_41_5_41_41_41_41_41_2_2_5
702,124,1326171600,5,2,5,1326176460,4860,603000,754200,151200,41_41_41_41_5_41_5_41_41_41_41_41_2_2_5_5
703,75,1326171600,1,18,16,1326172080,480,63060,6135000,6071940,16_16_16_16_16_16_1
704,142,1326171720,0,0,1,1326172140,420,413280,7299960,6886680,0_0_0_0_0_0_0_1_1_0_0_0_0_0_0_0_0_1_1_0_0_0_0_0_0_1_1_0_0_0_0_0_0
705,75,1326172080,16,20,16,1326172140,60,63540,6135000,6071460,16_16_16_16_16_16_1_16
706,75,1326172140,16,20,1,1326175680,3540,63600,6135000,6071400,16_16_16_16_16_16_1_16_16
707,142,1326172140,1,9,1,1326176640,4500,413700,7299960,6886260,0_0_0_0_0_0_0_1_1_0_0_0_0_0_0_0_0_1_1_0_0_0_0_0_0_1_1_0_0_0_0_0_0_1
708,121,1326172200,1,6,1,1326175800,3600,160500,856140,695640,7_7_7_7_7_7_3_3_1
709,84,1326172680,17,10,17,1326180600,7920,513780,3714840,3201060,17_17_17_17_17_17_17_17_17_17_17_17_17_17_17
710,53,1326174660,2,4,2,1326175920,1260,348000,582540,234540,26_26_10_10_10_10_10_1_1_10_1_1_2
711,75,1326175680,1,18,16,1326197100,21420,67140,6135000,6067860,16_16_16_16_16_16_1_16_16_1
712,106,1326175740,1,18,1,1326177600,1860,594540,1023180,428640,46_46_46_46_46_46_46_46_1_1_2_2_9_9_46_46_46_46_1_1_46_46_1_1_1_39_1_39_2_2_9_9_1
713,121,1326175800,1,6,2,1326194640,18840,164100,856140,692040,7_7_7_7_7_7_3_3_1_1
714,118,1326175920,13,17,13,1326181800,5880,53820,459900,406080,3_3_3_3_13
715,118,1326175920,3,17,13,1326175920,0,53820,459900,406080,3_3_3_3
716,53,1326175920,2,4,2,1326176700,780,349260,582540,233280,26_26_10_10_10_10_10_1_1_10_1_1_2_2
717,144,1326176340,10,16,1,1326194400,18060,71340,1807260,1735920,10_10_10
718,87,1326176460,5,9,5,1326195360,18900,598860,1090800,491940,19_19_19_19_19_19_19_19_19_19_1_1_19_19_19_19_1_1_1_1_2_2_2_2_21_3_3_21_3_3_3_3_3_3_3_3_13_13_13_13_13_13_5
719,125,1326176460,1,2,2,1326179400,2940,148620,3969060,3820440,16_16_16_16_16_16_1_1
720,124,1326176460,5,2,5,1326177600,1140,607860,754200,146340,41_41_41_41_5_41_5_41_41_41_41_41_2_2_5_5_5
721,142,1326176640,1,9,0,1326190020,13380,418200,7299960,6881760,0_0_0_0_0_0_0_1_1_0_0_0_0_0_0_0_0_1_1_0_0_0_0_0_0_1_1_0_0_0_0_0_0_1_1
722,53,1326176700,2,3,2,1326179400,2700,350040,582540,232500,26_26_10_10_10_10_10_1_1_10_1_1_2_2_2
723,106,1326177600,1,18,3,1326183120,5520,596400,1023180,426780,46_46_46_46_46_46_46_46_1_1_2_2_9_9_46_46_46_46_1_1_46_46_1_1_1_39_1_39_2_2_9_9_1_1
724,124,1326177600,5,2,5,1326177600,0,609000,754200,145200,41_41_41_41_5_41_5_41_41_41_41_41_2_2_5_5_5_5
725,124,1326177600,5,2,5,1326178800,1200,609000,754200,145200,41_41_41_41_5_41_5_41_41_41_41_41_2_2_5_5_5_5_5_5
726,124,1326177600,5,2,5,1326177600,0,609000,754200,145200,41_41_41_41_5_41_5_41_41_41_41_41_2_2_5_5_5_5_5
727,124,1326178800,5,2,5,1326192600,13800,610200,754200,144000,41_41_41_41_5_41_5_41_41_41_41_41_2_2_5_5_5_5_5_5_5
728,76,1326178800,5,2,5,1326192600,13800,637200,7552500,6915300,3_3_3_3_3_3_3_3_3_18_3_18_18_18_18_18_3_3_3_1_1_3_17_17_17_18_17_17_18_18_18_18_18_17_17_18_3_3_18_17_18_18_17_18_18_17_17_17_5
729,53,1326179400,2,3,3,1326179700,300,352740,582540,229800,26_26_10_10_10_10_10_1_1_10_1_1_2_2_2_2
730,125,1326179400,2,3,2,1326180120,720,151560,3969060,3817500,16_16_16_16_16_16_1_1_2
731,53,1326179700,3,4,3,1326184380,4680,353040,582540,229500,26_26_10_10_10_10_10_1_1_10_1_1_2_2_2_2_3
732,125,1326180120,2,3,1,1326199800,19680,152280,3969060,3816780,16_16_16_16_16_16_1_1_2_2
733,129,1326180120,2,3,2,1326182820,2700,699720,1188000,488280,26_26_8_8_2
734,84,1326180600,17,10,1,1326182400,1800,521700,3714840,3193140,17_17_17_17_17_17_17_17_17_17_17_17_17_17_17_17
735,118,1326181800,13,17,13,1326181860,60,59700,459900,400200,3_3_3_3_13_13
736,118,1326181860,13,17,13,1326203700,21840,59760,459900,400140,3_3_3_3_13_13_13
737,84,1326182400,1,6,1,1326204000,21600,523500,3714840,3191340,17_17_17_17_17_17_17_17_17_17_17_17_17_17_17_17_1
738,129,1326182820,2,3,5,1326270120,87300,702420,1188000,485580,26_26_8_8_2_2
739,56,1326183060,8,18,8,1326190260,7200,123060,6361440,6238380,6_6_5_5_8_8_8
740,106,1326183120,3,3,3,1326184620,1500,601920,1023180,421260,46_46_46_46_46_46_46_46_1_1_2_2_9_9_46_46_46_46_1_1_46_46_1_1_1_39_1_39_2_2_9_9_1_1_3
741,72,1326183240,17,10,17,1326185640,2400,0,2385960,2385960,17
742,53,1326184380,3,4,5,1326195360,10980,357720,582540,224820,26_26_10_10_10_10_10_1_1_10_1_1_2_2_2_2_3_3
743,127,1326184620,2,3,2,1326185640,1020,116160,599940,483780,7_7_7_7_1_7_1_1_7_1_2
744,106,1326184620,3,3,18,1326204240,19620,603420,1023180,419760,46_46_46_46_46_46_46_46_1_1_2_2_9_9_46_46_46_46_1_1_46_46_1_1_1_39_1_39_2_2_9_9_1_1_3_3
745,127,1326185640,2,3,3,1326185640,0,117180,599940,482760,7_7_7_7_1_7_1_1_7_1_2_2
746,72,1326185640,17,10,17,1326258960,73320,2400,2385960,2383560,17_17
747,127,1326185640,3,3,3,1326189540,3900,117180,599940,482760,7_7_7_7_1_7_1_1_7_1_2_2_3
748,80,1326187920,9,3,9,1326189480,1560,181920,338580,156660,1_1_2_2_3_3_9
749,80,1326189480,9,3,3,1326262140,72660,183480,338580,155100,1_1_2_2_3_3_9_9
750,127,1326189540,9,3,9,1326189540,0,121080,599940,478860,7_7_7_7_1_7_1_1_7_1_2_2_3_3_9
751,127,1326189540,3,3,9,1326189540,0,121080,599940,478860,7_7_7_7_1_7_1_1_7_1_2_2_3_3
752,127,1326189540,9,3,3,1326194040,4500,121080,599940,478860,7_7_7_7_1_7_1_1_7_1_2_2_3_3_9_9
753,142,1326190020,0,0,0,1326190080,60,431580,7299960,6868380,0_0_0_0_0_0_0_1_1_0_0_0_0_0_0_0_0_1_1_0_0_0_0_0_0_1_1_0_0_0_0_0_0_1_1_0
754,142,1326190080,0,0,0,1326192300,2220,431640,7299960,6868320,0_0_0_0_0_0_0_1_1_0_0_0_0_0_0_0_0_1_1_0_0_0_0_0_0_1_1_0_0_0_0_0_0_1_1_0_0
755,56,1326190260,8,18,26,1327209240,1018980,130260,6361440,6231180,6_6_5_5_8_8_8_8
756,142,1326192300,0,0,0,1326194580,2280,433860,7299960,6866100,0_0_0_0_0_0_0_1_1_0_0_0_0_0_0_0_0_1_1_0_0_0_0_0_0_1_1_0_0_0_0_0_0_1_1_0_0_0
757,124,1326192600,5,2,5,1326194400,1800,624000,754200,130200,41_41_41_41_5_41_5_41_41_41_41_41_2_2_5_5_5_5_5_5_5_5
758,76,1326192600,5,2,5,1326194400,1800,651000,7552500,6901500,3_3_3_3_3_3_3_3_3_18_3_18_18_18_18_18_3_3_3_1_1_3_17_17_17_18_17_17_18_18_18_18_18_17_17_18_3_3_18_17_18_18_17_18_18_17_17_17_5_5
759,127,1326194040,3,3,3,1326194700,660,125580,599940,474360,7_7_7_7_1_7_1_1_7_1_2_2_3_3_9_9_3
760,124,1326194400,5,2,5,1326199800,5400,625800,754200,128400,41_41_41_41_5_41_5_41_41_41_41_41_2_2_5_5_5_5_5_5_5_5_5
761,144,1326194400,1,18,10,1326195120,720,89400,1807260,1717860,10_10_10_1
762,76,1326194400,5,2,5,1326198360,3960,652800,7552500,6899700,3_3_3_3_3_3_3_3_3_18_3_18_18_18_18_18_3_3_3_1_1_3_17_17_17_18_17_17_18_18_18_18_18_17_17_18_3_3_18_17_18_18_17_18_18_17_17_17_5_5_5
763,142,1326194580,0,0,0,1326203880,9300,436140,7299960,6863820,0_0_0_0_0_0_0_1_1_0_0_0_0_0_0_0_0_1_1_0_0_0_0_0_0_1_1_0_0_0_0_0_0_1_1_0_0_0_0
764,121,1326194640,2,3,2,1326198780,4140,182940,856140,673200,7_7_7_7_7_7_3_3_1_1_2
765,66,1326194700,4,23,4,1326203340,8640,714300,4817700,4103400,3_3_4
766,127,1326194700,3,3,3,1326232800,38100,126240,599940,473700,7_7_7_7_1_7_1_1_7_1_2_2_3_3_9_9_3_3
767,144,1326195120,10,16,10,1326199620,4500,90120,1807260,1717140,10_10_10_1_10
768,87,1326195360,5,9,14,1326204840,9480,617760,1090800,473040,19_19_19_19_19_19_19_19_19_19_1_1_19_19_19_19_1_1_1_1_2_2_2_2_21_3_3_21_3_3_3_3_3_3_3_3_13_13_13_13_13_13_5_5
769,53,1326195360,5,9,5,1326201240,5880,368700,582540,213840,26_26_10_10_10_10_10_1_1_10_1_1_2_2_2_2_3_3_5
770,75,1326197100,16,0,16,1326203820,6720,88560,6135000,6046440,16_16_16_16_16_16_1_16_16_1_16
771,76,1326198360,5,2,1,1326198360,0,656760,7552500,6895740,3_3_3_3_3_3_3_3_3_18_3_18_18_18_18_18_3_3_3_1_1_3_17_17_17_18_17_17_18_18_18_18_18_17_17_18_3_3_18_17_18_18_17_18_18_17_17_17_5_5_5_5
772,76,1326198360,1,2,1,1326203580,5220,656760,7552500,6895740,3_3_3_3_3_3_3_3_3_18_3_18_18_18_18_18_3_3_3_1_1_3_17_17_17_18_17_17_18_18_18_18_18_17_17_18_3_3_18_17_18_18_17_18_18_17_17_17_5_5_5_5_1
773,70,1326198600,5,6,5,1326203100,4500,52200,3064200,3012000,6_6_5
774,121,1326198780,2,3,9,1326198780,0,187080,856140,669060,7_7_7_7_7_7_3_3_1_1_2_2
775,121,1326198780,9,3,9,1326198840,60,187080,856140,669060,7_7_7_7_7_7_3_3_1_1_2_2_9
776,121,1326198840,9,3,3,1326203220,4380,187140,856140,669000,7_7_7_7_7_7_3_3_1_1_2_2_9_9
777,144,1326199620,10,16,1,1326203760,4140,94620,1807260,1712640,10_10_10_1_10_10
778,124,1326199800,5,2,5,1326200400,600,631200,754200,123000,41_41_41_41_5_41_5_41_41_41_41_41_2_2_5_5_5_5_5_5_5_5_5_5
779,125,1326199800,1,2,1,1326204600,4800,171960,3969060,3797100,16_16_16_16_16_16_1_1_2_2_1
780,124,1326200400,5,2,5,1326211200,10800,631800,754200,122400,41_41_41_41_5_41_5_41_41_41_41_41_2_2_5_5_5_5_5_5_5_5_5_5_5
781,53,1326201240,5,9,5,1326276240,75000,374580,582540,207960,26_26_10_10_10_10_10_1_1_10_1_1_2_2_2_2_3_3_5_5
782,100,1326201300,1,9,1,1326204240,2940,538800,919500,380700,10_10_10_10_10_10_1_1_1
783,70,1326203100,5,6,1,1327828740,1625640,56700,3064200,3007500,6_6_5_5
784,121,1326203220,3,4,9,1326203280,60,191520,856140,664620,7_7_7_7_7_7_3_3_1_1_2_2_9_9_3
785,121,1326203280,9,3,9,1326209580,6300,191580,856140,664560,7_7_7_7_7_7_3_3_1_1_2_2_9_9_3_9
786,66,1326203340,4,23,4,1326210240,6900,722940,4817700,4094760,3_3_4_4
787,76,1326203580,1,2,17,1326220860,17280,661980,7552500,6890520,3_3_3_3_3_3_3_3_3_18_3_18_18_18_18_18_3_3_3_1_1_3_17_17_17_18_17_17_18_18_18_18_18_17_17_18_3_3_18_17_18_18_17_18_18_17_17_17_5_5_5_5_1_1
788,118,1326203700,13,17,13,1326257820,54120,81600,459900,378300,3_3_3_3_13_13_13_13
789,144,1326203760,1,18,10,1326204240,480,98760,1807260,1708500,10_10_10_1_10_10_1
790,75,1326203820,16,0,16,1326204300,480,95280,6135000,6039720,16_16_16_16_16_16_1_16_16_1_16_16
791,142,1326203880,0,0,0,1326210900,7020,445440,7299960,6854520,0_0_0_0_0_0_0_1_1_0_0_0_0_0_0_0_0_1_1_0_0_0_0_0_0_1_1_0_0_0_0_0_0_1_1_0_0_0_0_0
792,83,1326203940,19,11,19,1326218400,14460,143940,1818000,1674060,19_19_19_19_19_19_19_19_19_19_19_19
793,84,1326204000,1,6,2,1326262140,58140,545100,3714840,3169740,17_17_17_17_17_17_17_17_17_17_17_17_17_17_17_17_1_1
794,106,1326204240,18,19,18,1326210300,6060,623040,1023180,400140,46_46_46_46_46_46_46_46_1_1_2_2_9_9_46_46_46_46_1_1_46_46_1_1_1_39_1_39_2_2_9_9_1_1_3_3_18
795,100,1326204240,1,9,1,1326265620,61380,541740,919500,377760,10_10_10_10_10_10_1_1_1_1
796,144,1326204240,10,16,10,1326260880,56640,99240,1807260,1708020,10_10_10_1_10_10_1_10
797,75,1326204300,16,20,16,1326207840,3540,95760,6135000,6039240,16_16_16_16_16_16_1_16_16_1_16_16_16
798,125,1326204600,1,2,3,1329224820,3020220,176760,3969060,3792300,16_16_16_16_16_16_1_1_2_2_1_1
799,87,1326204840,14,15,14,1326231300,26460,627240,1090800,463560,19_19_19_19_19_19_19_19_19_19_1_1_19_19_19_19_1_1_1_1_2_2_2_2_21_3_3_21_3_3_3_3_3_3_3_3_13_13_13_13_13_13_5_5_14
800,75,1326207840,16,20,16,1326211620,3780,99300,6135000,6035700,16_16_16_16_16_16_1_16_16_1_16_16_16_16
801,121,1326209580,9,3,3,1326209640,60,197880,856140,658260,7_7_7_7_7_7_3_3_1_1_2_2_9_9_3_9_9
802,121,1326209640,3,4,18,1326247500,37860,197940,856140,658200,7_7_7_7_7_7_3_3_1_1_2_2_9_9_3_9_9_3
803,66,1326210240,4,19,4,1326218640,8400,729840,4817700,4087860,3_3_4_4_4
804,106,1326210300,18,19,18,1326218760,8460,629100,1023180,394080,46_46_46_46_46_46_46_46_1_1_2_2_9_9_46_46_46_46_1_1_46_46_1_1_1_39_1_39_2_2_9_9_1_1_3_3_18_18
805,142,1326210900,0,21,0,1326231480,20580,452460,7299960,6847500,0_0_0_0_0_0_0_1_1_0_0_0_0_0_0_0_0_1_1_0_0_0_0_0_0_1_1_0_0_0_0_0_0_1_1_0_0_0_0_0_0
806,124,1326211200,5,2,6,1326319200,108000,642600,754200,111600,41_41_41_41_5_41_5_41_41_41_41_41_2_2_5_5_5_5_5_5_5_5_5_5_5_5
807,75,1326211620,16,21,16,1326231300,19680,103080,6135000,6031920,16_16_16_16_16_16_1_16_16_1_16_16_16_16_16
808,83,1326218400,19,14,19,1326232800,14400,158400,1818000,1659600,19_19_19_19_19_19_19_19_19_19_19_19_19
809,66,1326218640,4,19,4,1326218700,60,738240,4817700,4079460,3_3_4_4_4_4
810,66,1326218700,4,5,4,1326257520,38820,738300,4817700,4079400,3_3_4_4_4_4_4
811,106,1326218760,18,19,18,1326221460,2700,637560,1023180,385620,46_46_46_46_46_46_46_46_1_1_2_2_9_9_46_46_46_46_1_1_46_46_1_1_1_39_1_39_2_2_9_9_1_1_3_3_18_18_18
812,76,1326220860,17,12,17,1326257580,36720,679260,7552500,6873240,3_3_3_3_3_3_3_3_3_18_3_18_18_18_18_18_3_3_3_1_1_3_17_17_17_18_17_17_18_18_18_18_18_17_17_18_3_3_18_17_18_18_17_18_18_17_17_17_5_5_5_5_1_1_17
813,106,1326221460,18,19,18,1326221520,60,640260,1023180,382920,46_46_46_46_46_46_46_46_1_1_2_2_9_9_46_46_46_46_1_1_46_46_1_1_1_39_1_39_2_2_9_9_1_1_3_3_18_18_18_18
814,106,1326221520,18,19,18,1326231540,10020,640320,1023180,382860,46_46_46_46_46_46_46_46_1_1_2_2_9_9_46_46_46_46_1_1_46_46_1_1_1_39_1_39_2_2_9_9_1_1_3_3_18_18_18_18_18
815,87,1326231300,14,15,6,1326232800,1500,653700,1090800,437100,19_19_19_19_19_19_19_19_19_19_1_1_19_19_19_19_1_1_1_1_2_2_2_2_21_3_3_21_3_3_3_3_3_3_3_3_13_13_13_13_13_13_5_5_14_14
816,75,1326231300,16,21,16,1326257760,26460,122760,6135000,6012240,16_16_16_16_16_16_1_16_16_1_16_16_16_16_16_16
817,142,1326231480,0,21,1,1326257400,25920,473040,7299960,6826920,0_0_0_0_0_0_0_1_1_0_0_0_0_0_0_0_0_1_1_0_0_0_0_0_0_1_1_0_0_0_0_0_0_1_1_0_0_0_0_0_0_0
818,106,1326231540,18,19,18,1326233520,1980,650340,1023180,372840,46_46_46_46_46_46_46_46_1_1_2_2_9_9_46_46_46_46_1_1_46_46_1_1_1_39_1_39_2_2_9_9_1_1_3_3_18_18_18_18_18_18
819,52,1326232800,6,7,6,1326236400,3600,604800,608400,3600,15_15_33_33_5_5_6
820,87,1326232800,6,7,6,1326236400,3600,655200,1090800,435600,19_19_19_19_19_19_19_19_19_19_1_1_19_19_19_19_1_1_1_1_2_2_2_2_21_3_3_21_3_3_3_3_3_3_3_3_13_13_13_13_13_13_5_5_14_14_6
821,127,1326232800,3,4,3,1326237300,4500,164340,599940,435600,7_7_7_7_1_7_1_1_7_1_2_2_3_3_9_9_3_3_3
822,83,1326232800,19,20,19,1326232800,0,172800,1818000,1645200,19_19_19_19_19_19_19_19_19_19_19_19_19_19
823,83,1326232800,19,20,19,1326236400,3600,172800,1818000,1645200,19_19_19_19_19_19_19_19_19_19_19_19_19_19_19
824,106,1326233520,18,5,18,1326247440,13920,652320,1023180,370860,46_46_46_46_46_46_46_46_1_1_2_2_9_9_46_46_46_46_1_1_46_46_1_1_1_39_1_39_2_2_9_9_1_1_3_3_18_18_18_18_18_18_18
825,83,1326236400,19,14,19,1326237300,900,176400,1818000,1641600,19_19_19_19_19_19_19_19_19_19_19_19_19_19_19_19
826,87,1326236400,6,7,14,1326291480,55080,658800,1090800,432000,19_19_19_19_19_19_19_19_19_19_1_1_19_19_19_19_1_1_1_1_2_2_2_2_21_3_3_21_3_3_3_3_3_3_3_3_13_13_13_13_13_13_5_5_14_14_6_6
827,52,1326236400,6,7,99,1326236400,0,608400,608400,0,15_15_33_33_5_5_6_6
828,127,1326237300,3,4,2,1326284580,47280,168840,599940,431100,7_7_7_7_1_7_1_1_7_1_2_2_3_3_9_9_3_3_3_3
829,83,1326237300,19,20,19,1326258780,21480,177300,1818000,1640700,19_19_19_19_19_19_19_19_19_19_19_19_19_19_19_19_19_19
830,83,1326237300,19,20,19,1326237300,0,177300,1818000,1640700,19_19_19_19_19_19_19_19_19_19_19_19_19_19_19_19_19
831,106,1326247440,18,5,5,1326258000,10560,666240,1023180,356940,46_46_46_46_46_46_46_46_1_1_2_2_9_9_46_46_46_46_1_1_46_46_1_1_1_39_1_39_2_2_9_9_1_1_3_3_18_18_18_18_18_18_18_18
832,121,1326247500,18,5,18,1326256140,8640,235800,856140,620340,7_7_7_7_7_7_3_3_1_1_2_2_9_9_3_9_9_3_18
833,121,1326256140,18,5,18,1326257520,1380,244440,856140,611700,7_7_7_7_7_7_3_3_1_1_2_2_9_9_3_9_9_3_18_18_18
834,121,1326256140,18,5,18,1326256140,0,244440,856140,611700,7_7_7_7_7_7_3_3_1_1_2_2_9_9_3_9_9_3_18_18
835,142,1326257400,1,9,0,1326260520,3120,498960,7299960,6801000,0_0_0_0_0_0_0_1_1_0_0_0_0_0_0_0_0_1_1_0_0_0_0_0_0_1_1_0_0_0_0_0_0_1_1_0_0_0_0_0_0_0_1
836,66,1326257520,4,5,4,1326257820,300,777120,4817700,4040580,3_3_4_4_4_4_4_4
837,121,1326257520,18,5,18,1326257760,240,245820,856140,610320,7_7_7_7_7_7_3_3_1_1_2_2_9_9_3_9_9_3_18_18_18_18
838,76,1326257580,17,12,17,1326258900,1320,715980,7552500,6836520,3_3_3_3_3_3_3_3_3_18_3_18_18_18_18_18_3_3_3_1_1_3_17_17_17_18_17_17_18_18_18_18_18_17_17_18_3_3_18_17_18_18_17_18_18_17_17_17_5_5_5_5_1_1_17_17
839,121,1326257760,18,23,18,1326274500,16740,246060,856140,610080,7_7_7_7_7_7_3_3_1_1_2_2_9_9_3_9_9_3_18_18_18_18_18
840,75,1326257760,16,0,16,1326278700,20940,149220,6135000,5985780,16_16_16_16_16_16_1_16_16_1_16_16_16_16_16_16_16
841,66,1326257820,4,23,4,1326290040,32220,777420,4817700,4040280,3_3_4_4_4_4_4_4_4
842,118,1326257820,13,17,5,1326272400,14580,135720,459900,324180,3_3_3_3_13_13_13_13_13
843,106,1326258000,5,18,5,1326268800,10800,676800,1023180,346380,46_46_46_46_46_46_46_46_1_1_2_2_9_9_46_46_46_46_1_1_46_46_1_1_1_39_1_39_2_2_9_9_1_1_3_3_18_18_18_18_18_18_18_18_5
844,93,1326258000,5,6,5,1326278940,20940,659100,1242300,583200,3_3_3_3_18_18_18_18_18_18_18_18_18_18_5
845,83,1326258780,19,20,19,1326265560,6780,198780,1818000,1619220,19_19_19_19_19_19_19_19_19_19_19_19_19_19_19_19_19_19_19
846,76,1326258900,17,10,2,1326266460,7560,717300,7552500,6835200,3_3_3_3_3_3_3_3_3_18_3_18_18_18_18_18_3_3_3_1_1_3_17_17_17_18_17_17_18_18_18_18_18_17_17_18_3_3_18_17_18_18_17_18_18_17_17_17_5_5_5_5_1_1_17_17_17
847,72,1326258960,17,10,1,1326291600,32640,75720,2385960,2310240,17_17_17
848,131,1326260100,16,11,16,1326267720,7620,0,6825900,6825900,16
849,142,1326260520,0,1,1,1326262140,1620,502080,7299960,6797880,0_0_0_0_0_0_0_1_1_0_0_0_0_0_0_0_0_1_1_0_0_0_0_0_0_1_1_0_0_0_0_0_0_1_1_0_0_0_0_0_0_0_1_0
850,103,1326260520,1,9,1,1326265020,4500,459540,4719960,4260420,19_19_19_19_19_19_19_1_1_19_19_19_19_1_1_19_19_19_19_19_1
851,144,1326260880,10,16,10,1326274980,14100,155880,1807260,1651380,10_10_10_1_10_10_1_10_10
852,71,1326261600,29,29,29,1326268800,7200,0,3996240,3996240,29
853,142,1326262140,1,9,0,1326290820,28680,503700,7299960,6796260,0_0_0_0_0_0_0_1_1_0_0_0_0_0_0_0_0_1_1_0_0_0_0_0_0_1_1_0_0_0_0_0_0_1_1_0_0_0_0_0_0_0_1_0_1
854,84,1326262140,2,3,2,1326265320,3180,603240,3714840,3111600,17_17_17_17_17_17_17_17_17_17_17_17_17_17_17_17_1_1_2
855,80,1326262140,3,4,3,1326263880,1740,256140,338580,82440,1_1_2_2_3_3_9_9_3
856,88,1326263220,5,9,5,1326290640,27420,236580,555360,318780,1_1_2_2_2_2_3_3_3_3_5
857,80,1326263880,3,4,6,1326319200,55320,257880,338580,80700,1_1_2_2_3_3_9_9_3_3
858,103,1326265020,1,9,2,1326799620,534600,464040,4719960,4255920,19_19_19_19_19_19_19_1_1_19_19_19_19_1_1_19_19_19_19_19_1_1
859,84,1326265320,2,3,3,1327495800,1230480,606420,3714840,3108420,17_17_17_17_17_17_17_17_17_17_17_17_17_17_17_17_1_1_2_2
860,83,1326265560,19,20,19,1326267780,2220,205560,1818000,1612440,19_19_19_19_19_19_19_19_19_19_19_19_19_19_19_19_19_19_19_19
861,100,1326265620,1,9,1,1326270120,4500,603120,919500,316380,10_10_10_10_10_10_1_1_1_1_1
862,76,1326266460,2,3,2,1326268980,2520,724860,7552500,6827640,3_3_3_3_3_3_3_3_3_18_3_18_18_18_18_18_3_3_3_1_1_3_17_17_17_18_17_17_18_18_18_18_18_17_17_18_3_3_18_17_18_18_17_18_18_17_17_17_5_5_5_5_1_1_17_17_17_2
863,131,1326267720,16,11,16,1326278700,10980,7620,6825900,6818280,16_16
864,83,1326267780,19,11,19,1326289920,22140,207780,1818000,1610220,19_19_19_19_19_19_19_19_19_19_19_19_19_19_19_19_19_19_19_19_19
865,106,1326268800,5,18,5,1326281040,12240,687600,1023180,335580,46_46_46_46_46_46_46_46_1_1_2_2_9_9_46_46_46_46_1_1_46_46_1_1_1_39_1_39_2_2_9_9_1_1_3_3_18_18_18_18_18_18_18_18_5_5
866,71,1326268800,29,29,1,1326269280,480,7200,3996240,3989040,29_29
867,49,1326268800,29,29,29,1326274200,5400,0,3991980,3991980,29
868,76,1326268980,2,3,17,1326296520,27540,727380,7552500,6825120,3_3_3_3_3_3_3_3_3_18_3_18_18_18_18_18_3_3_3_1_1_3_17_17_17_18_17_17_18_18_18_18_18_17_17_18_3_3_18_17_18_18_17_18_18_17_17_17_5_5_5_5_1_1_17_17_17_2_2
869,110,1326269280,2,3,2,1326271980,2700,727680,5579400,4851720,1_1_0_0_1_1_1_1_2
870,71,1326269280,1,18,1,1326272940,3660,7680,3996240,3988560,29_29_1
871,129,1326270120,5,9,5,1326273720,3600,789720,1188000,398280,26_26_8_8_2_2_5
872,100,1326270120,1,9,2,1326285060,14940,607620,919500,311880,10_10_10_10_10_10_1_1_1_1_1_1
873,110,1326271980,2,4,2,1326272280,300,730380,5579400,4849020,1_1_0_0_1_1_1_1_2_2
874,110,1326272280,2,3,2,1326280920,8640,730680,5579400,4848720,1_1_0_0_1_1_1_1_2_2_2
875,118,1326272400,5,18,13,1326273540,1140,150300,459900,309600,3_3_3_3_13_13_13_13_13_5
876,71,1326272940,1,18,7,1328601240,2328300,11340,3996240,3984900,29_29_1_1
877,118,1326273540,13,17,13,1326273600,60,151440,459900,308460,3_3_3_3_13_13_13_13_13_5_13
878,118,1326273600,13,17,13,1326278280,4680,151500,459900,308400,3_3_3_3_13_13_13_13_13_5_13_13
879,129,1326273720,5,9,6,1326664800,391080,793320,1188000,394680,26_26_8_8_2_2_5_5
880,49,1326274200,29,29,30,1326780000,505800,5400,3991980,3986580,29_29
881,121,1326274500,18,23,5,1326623400,348900,262800,856140,593340,7_7_7_7_7_7_3_3_1_1_2_2_9_9_3_9_9_3_18_18_18_18_18_18
882,144,1326274980,10,16,1,1326278400,3420,169980,1807260,1637280,10_10_10_1_10_10_1_10_10_10
883,53,1326276240,5,9,5,1326280740,4500,449580,582540,132960,26_26_10_10_10_10_10_1_1_10_1_1_2_2_2_2_3_3_5_5_5
884,118,1326278280,13,17,5,1326278400,120,156180,459900,303720,3_3_3_3_13_13_13_13_13_5_13_13_13_13
885,118,1326278280,13,17,13,1326278280,0,156180,459900,303720,3_3_3_3_13_13_13_13_13_5_13_13_13
886,144,1326278400,1,18,10,1326279840,1440,173400,1807260,1633860,10_10_10_1_10_10_1_10_10_10_1
887,118,1326278400,5,18,13,1326283500,5100,156300,459900,303600,3_3_3_3_13_13_13_13_13_5_13_13_13_13_5
888,131,1326278700,16,0,16,1326289680,10980,18600,6825900,6807300,16_16_16
889,75,1326278700,16,0,1,1326344400,65700,170160,6135000,5964840,16_16_16_16_16_16_1_16_16_1_16_16_16_16_16_16_16_16
890,93,1326278940,5,6,5,1326622440,343500,680040,1242300,562260,3_3_3_3_18_18_18_18_18_18_18_18_18_18_5_5
891,144,1326279840,10,16,10,1326279900,60,174840,1807260,1632420,10_10_10_1_10_10_1_10_10_10_1_10
892,144,1326279900,10,16,1,1326282780,2880,174900,1807260,1632360,10_10_10_1_10_10_1_10_10_10_1_10_10
893,53,1326280740,5,9,6,1326405600,124860,454080,582540,128460,26_26_10_10_10_10_10_1_1_10_1_1_2_2_2_2_3_3_5_5_5_5
894,110,1326280920,2,4,4,1326776400,495480,739320,5579400,4840080,1_1_0_0_1_1_1_1_2_2_2_2
895,106,1326281040,5,18,5,1326286800,5760,699840,1023180,323340,46_46_46_46_46_46_46_46_1_1_2_2_9_9_46_46_46_46_1_1_46_46_1_1_1_39_1_39_2_2_9_9_1_1_3_3_18_18_18_18_18_18_18_18_5_5_5
896,144,1326282780,1,18,10,1326287040,4260,177780,1807260,1629480,10_10_10_1_10_10_1_10_10_10_1_10_10_1
897,105,1326283500,13,17,13,1326287100,3600,716640,1314480,597840,1_16_1_2_16_2_3_3_13
898,118,1326283500,13,17,5,1326351600,68100,161400,459900,298500,3_3_3_3_13_13_13_13_13_5_13_13_13_13_5_13
899,127,1326284580,2,4,2,1326289080,4500,216120,599940,383820,7_7_7_7_1_7_1_1_7_1_2_2_3_3_9_9_3_3_3_3_2
900,100,1326285060,2,4,9,1326289500,4440,622560,919500,296940,10_10_10_10_10_10_1_1_1_1_1_1_2
901,106,1326286800,5,18,6,1326578400,291600,705600,1023180,317580,46_46_46_46_46_46_46_46_1_1_2_2_9_9_46_46_46_46_1_1_46_46_1_1_1_39_1_39_2_2_9_9_1_1_3_3_18_18_18_18_18_18_18_18_5_5_5_5
902,144,1326287040,10,16,1,1326287400,360,182040,1807260,1625220,10_10_10_1_10_10_1_10_10_10_1_10_10_1_10
903,105,1326287100,13,17,13,1326287160,60,720240,1314480,594240,1_16_1_2_16_2_3_3_13_13
904,105,1326287160,13,17,13,1326296580,9420,720300,1314480,594180,1_16_1_2_16_2_3_3_13_13_13
905,144,1326287400,1,18,1,1326291600,4200,182400,1807260,1624860,10_10_10_1_10_10_1_10_10_10_1_10_10_1_10_1
906,127,1326289080,2,4,5,1326603000,313920,220620,599940,379320,7_7_7_7_1_7_1_1_7_1_2_2_3_3_9_9_3_3_3_3_2_2
907,100,1326289500,9,3,2,1326289560,60,627000,919500,292500,10_10_10_10_10_10_1_1_1_1_1_1_2_9
908,100,1326289560,2,4,9,1326296640,7080,627060,919500,292440,10_10_10_10_10_10_1_1_1_1_1_1_2_9_2
909,131,1326289680,16,0,16,1326289740,60,29580,6825900,6796320,16_16_16_16
910,131,1326289740,16,20,16,1326295440,5700,29640,6825900,6796260,16_16_16_16_16
911,83,1326289920,19,11,19,1326290640,720,229920,1818000,1588080,19_19_19_19_19_19_19_19_19_19_19_19_19_19_19_19_19_19_19_19_19_19
912,66,1326290040,4,23,4,1326290040,0,809640,4817700,4008060,3_3_4_4_4_4_4_4_4_4
913,66,1326290040,4,19,4,1326304740,14700,809640,4817700,4008060,3_3_4_4_4_4_4_4_4_4_4
914,83,1326290640,19,21,19,1326315600,24960,230640,1818000,1587360,19_19_19_19_19_19_19_19_19_19_19_19_19_19_19_19_19_19_19_19_19_19_19
915,88,1326290640,5,9,5,1326448980,158340,264000,555360,291360,1_1_2_2_2_2_3_3_3_3_5_5
916,142,1326290820,0,1,0,1326291000,180,532380,7299960,6767580,0_0_0_0_0_0_0_1_1_0_0_0_0_0_0_0_0_1_1_0_0_0_0_0_0_1_1_0_0_0_0_0_0_1_1_0_0_0_0_0_0_0_1_0_1_0
917,142,1326291000,0,21,0,1326318120,27120,532560,7299960,6767400,0_0_0_0_0_0_0_1_1_0_0_0_0_0_0_0_0_1_1_0_0_0_0_0_0_1_1_0_0_0_0_0_0_1_1_0_0_0_0_0_0_0_1_0_1_0_0
918,87,1326291480,14,15,14,1326296700,5220,713880,1090800,376920,19_19_19_19_19_19_19_19_19_19_1_1_19_19_19_19_1_1_1_1_2_2_2_2_21_3_3_21_3_3_3_3_3_3_3_3_13_13_13_13_13_13_5_5_14_14_6_6_14
919,144,1326291600,1,18,10,1326297240,5640,186600,1807260,1620660,10_10_10_1_10_10_1_10_10_10_1_10_10_1_10_1_1
920,72,1326291600,1,18,17,1326292080,480,108360,2385960,2277600,17_17_17_1
921,72,1326292080,17,10,1,1326297120,5040,108840,2385960,2277120,17_17_17_1_17
922,131,1326295440,16,20,16,1326298140,2700,35340,6825900,6790560,16_16_16_16_16_16
923,76,1326296520,17,10,17,1326310320,13800,754920,7552500,6797580,3_3_3_3_3_3_3_3_3_18_3_18_18_18_18_18_3_3_3_1_1_3_17_17_17_18_17_17_18_18_18_18_18_17_17_18_3_3_18_17_18_18_17_18_18_17_17_17_5_5_5_5_1_1_17_17_17_2_2_17
924,105,1326296580,13,17,13,1326343980,47400,729720,1314480,584760,1_16_1_2_16_2_3_3_13_13_13_13
925,100,1326296640,9,3,5,1326360600,63960,634140,919500,285360,10_10_10_10_10_10_1_1_1_1_1_1_2_9_2_9
926,78,1326296700,34,15,34,1326301140,4440,236700,1818900,1582200,40_40_34
927,87,1326296700,14,15,5,1326373500,76800,719100,1090800,371700,19_19_19_19_19_19_19_19_19_19_1_1_19_19_19_19_1_1_1_1_2_2_2_2_21_3_3_21_3_3_3_3_3_3_3_3_13_13_13_13_13_13_5_5_14_14_6_6_14_14
928,72,1326297120,1,18,17,1326344700,47580,113880,2385960,2272080,17_17_17_1_17_1
929,144,1326297240,10,16,1,1326344400,47160,192240,1807260,1615020,10_10_10_1_10_10_1_10_10_10_1_10_10_1_10_1_1_10
930,131,1326298140,16,21,16,1326308640,10500,38040,6825900,6787860,16_16_16_16_16_16_16
931,78,1326301140,34,15,5,1326347100,45960,241140,1818900,1577760,40_40_34_34
932,62,1326301140,34,15,34,1326315060,13920,0,3674460,3674460,34
933,66,1326304740,4,19,4,1326304800,60,824340,4817700,3993360,3_3_4_4_4_4_4_4_4_4_4_4
934,66,1326304800,4,5,4,1326343440,38640,824400,4817700,3993300,3_3_4_4_4_4_4_4_4_4_4_4_4
935,131,1326308640,16,14,16,1326344400,35760,48540,6825900,6777360,16_16_16_16_16_16_16_16_16
936,131,1326308640,16,21,16,1326308640,0,48540,6825900,6777360,16_16_16_16_16_16_16_16
937,76,1326310320,17,12,17,1326336060,25740,768720,7552500,6783780,3_3_3_3_3_3_3_3_3_18_3_18_18_18_18_18_3_3_3_1_1_3_17_17_17_18_17_17_18_18_18_18_18_17_17_18_3_3_18_17_18_18_17_18_18_17_17_17_5_5_5_5_1_1_17_17_17_2_2_17_17
938,62,1326315060,34,15,5,1326438000,122940,13920,3674460,3660540,34_34
939,61,1326315060,34,15,34,1326318420,3360,859860,6225300,5365440,4_4_18_18_34
940,83,1326315600,19,14,19,1326318120,2520,255600,1818000,1562400,19_19_19_19_19_19_19_19_19_19_19_19_19_19_19_19_19_19_19_19_19_19_19_19
941,142,1326318120,0,21,1,1326787020,468900,559680,7299960,6740280,0_0_0_0_0_0_0_1_1_0_0_0_0_0_0_0_0_1_1_0_0_0_0_0_0_1_1_0_0_0_0_0_0_1_1_0_0_0_0_0_0_0_1_0_1_0_0_0
942,83,1326318120,19,21,19,1326342600,24480,258120,1818000,1559880,19_19_19_19_19_19_19_19_19_19_19_19_19_19_19_19_19_19_19_19_19_19_19_19_19
943,61,1326318420,34,15,34,1326607680,289260,863220,6225300,5362080,4_4_18_18_34_34
944,80,1326319200,6,7,6,1326322800,3600,313200,338580,25380,1_1_2_2_3_3_9_9_3_3_6
945,124,1326319200,6,7,6,1326322800,3600,750600,754200,3600,41_41_41_41_5_41_5_41_41_41_41_41_2_2_5_5_5_5_5_5_5_5_5_5_5_5_6
946,80,1326322800,6,7,5,1326343800,21000,316800,338580,21780,1_1_2_2_3_3_9_9_3_3_6_6
947,124,1326322800,6,7,99,1326322800,0,754200,754200,0,41_41_41_41_5_41_5_41_41_41_41_41_2_2_5_5_5_5_5_5_5_5_5_5_5_5_6_6
948,76,1326336060,17,12,5,1326363300,27240,794460,7552500,6758040,3_3_3_3_3_3_3_3_3_18_3_18_18_18_18_18_3_3_3_1_1_3_17_17_17_18_17_17_18_18_18_18_18_17_17_18_3_3_18_17_18_18_17_18_18_17_17_17_5_5_5_5_1_1_17_17_17_2_2_17_17_17
949,83,1326342600,19,14,19,1326344760,2160,282600,1818000,1535400,19_19_19_19_19_19_19_19_19_19_19_19_19_19_19_19_19_19_19_19_19_19_19_19_19_19
950,66,1326343440,4,5,4,1326344340,900,863040,4817700,3954660,3_3_4_4_4_4_4_4_4_4_4_4_4_4
951,80,1326343800,5,9,5,1326344580,780,337800,338580,780,1_1_2_2_3_3_9_9_3_3_6_6_5
952,105,1326343980,13,17,13,1326364440,20460,777120,1314480,537360,1_16_1_2_16_2_3_3_13_13_13_13_13
953,66,1326344340,4,23,4,1326376260,31920,863940,4817700,3953760,3_3_4_4_4_4_4_4_4_4_4_4_4_4_4
954,144,1326344400,1,18,1,1326350400,6000,239400,1807260,1567860,10_10_10_1_10_10_1_10_10_10_1_10_10_1_10_1_1_10_1
955,131,1326344400,16,14,16,1326344880,480,84300,6825900,6741600,16_16_16_16_16_16_16_16_16_16
956,75,1326344400,1,6,1,1326347040,2640,235860,6135000,5899140,16_16_16_16_16_16_1_16_16_1_16_16_16_16_16_16_16_16_1
957,80,1326344580,5,9,99,1326344580,0,338580,338580,0,1_1_2_2_3_3_9_9_3_3_6_6_5_5
958,72,1326344700,17,10,1,1326364920,20220,161460,2385960,2224500,17_17_17_1_17_1_17
959,83,1326344760,19,11,19,1326384420,39660,284760,1818000,1533240,19_19_19_19_19_19_19_19_19_19_19_19_19_19_19_19_19_19_19_19_19_19_19_19_19_19_19
960,131,1326344880,16,20,16,1326359220,14340,84780,6825900,6741120,16_16_16_16_16_16_16_16_16_16_16
961,86,1326346020,0,1,0,1326383700,37680,0,3519180,3519180,0
962,75,1326347040,1,6,2,1326368100,21060,238500,6135000,5896500,16_16_16_16_16_16_1_16_16_1_16_16_16_16_16_16_16_16_1_1
963,78,1326347100,5,6,5,1326348780,1680,287100,1818900,1531800,40_40_34_34_5
964,122,1326348180,10,16,10,1326373500,25320,0,861720,861720,10
965,78,1326348780,5,6,5,1326349200,420,288780,1818900,1530120,40_40_34_34_5_5
966,78,1326349200,5,6,5,1326353700,4500,289200,1818900,1529700,40_40_34_34_5_5_5
967,144,1326350400,1,18,2,1327397040,1046640,245400,1807260,1561860,10_10_10_1_10_10_1_10_10_10_1_10_10_1_10_1_1_10_1_1
968,118,1326351600,5,18,5,1326364200,12600,229500,459900,230400,3_3_3_3_13_13_13_13_13_5_13_13_13_13_5_13_5
969,78,1326353700,5,6,6,1326578400,224700,293700,1818900,1525200,40_40_34_34_5_5_5_5
970,131,1326359220,16,20,16,1326404280,45060,99120,6825900,6726780,16_16_16_16_16_16_16_16_16_16_16_16
971,100,1326360600,5,9,5,1326365400,4800,698100,919500,221400,10_10_10_10_10_10_1_1_1_1_1_1_2_9_2_9_5
972,76,1326363300,5,2,5,1326365400,2100,821700,7552500,6730800,3_3_3_3_3_3_3_3_3_18_3_18_18_18_18_18_3_3_3_1_1_3_17_17_17_18_17_17_18_18_18_18_18_17_17_18_3_3_18_17_18_18_17_18_18_17_17_17_5_5_5_5_1_1_17_17_17_2_2_17_17_17_5
973,104,1326363900,3,3,3,1326374820,10920,0,935100,935100,3
974,118,1326364200,5,18,5,1326450300,86100,242100,459900,217800,3_3_3_3_13_13_13_13_13_5_13_13_13_13_5_13_5_5
975,105,1326364440,13,17,3,1326364440,0,797580,1314480,516900,1_16_1_2_16_2_3_3_13_13_13_13_13_13
976,105,1326364440,3,17,3,1326365580,1140,797580,1314480,516900,1_16_1_2_16_2_3_3_13_13_13_13_13_13_3
977,72,1326364920,1,18,1,1326376260,11340,181680,2385960,2204280,17_17_17_1_17_1_17_1
978,76,1326365400,5,2,5,1326367200,1800,823800,7552500,6728700,3_3_3_3_3_3_3_3_3_18_3_18_18_18_18_18_3_3_3_1_1_3_17_17_17_18_17_17_18_18_18_18_18_17_17_18_3_3_18_17_18_18_17_18_18_17_17_17_5_5_5_5_1_1_17_17_17_2_2_17_17_17_5_5
979,100,1326365400,5,9,5,1326440340,74940,702900,919500,216600,10_10_10_10_10_10_1_1_1_1_1_1_2_9_2_9_5_5
980,105,1326365580,14,17,14,1326369540,3960,798720,1314480,515760,1_16_1_2_16_2_3_3_13_13_13_13_13_13_3_3_14
981,105,1326365580,3,17,14,1326365580,0,798720,1314480,515760,1_16_1_2_16_2_3_3_13_13_13_13_13_13_3_3
982,76,1326367200,5,2,5,1326377220,10020,825600,7552500,6726900,3_3_3_3_3_3_3_3_3_18_3_18_18_18_18_18_3_3_3_1_1_3_17_17_17_18_17_17_18_18_18_18_18_17_17_18_3_3_18_17_18_18_17_18_18_17_17_17_5_5_5_5_1_1_17_17_17_2_2_17_17_17_5_5_5
983,75,1326368100,2,4,2,1326371700,3600,259560,6135000,5875440,16_16_16_16_16_16_1_16_16_1_16_16_16_16_16_16_16_16_1_1_2
984,105,1326369540,14,17,14,1326375780,6240,802680,1314480,511800,1_16_1_2_16_2_3_3_13_13_13_13_13_13_3_3_14_14_14
985,105,1326369540,14,17,14,1326369540,0,802680,1314480,511800,1_16_1_2_16_2_3_3_13_13_13_13_13_13_3_3_14_14
986,75,1326371700,2,4,39,1327561200,1189500,263160,6135000,5871840,16_16_16_16_16_16_1_16_16_1_16_16_16_16_16_16_16_16_1_1_2_2
987,122,1326373500,10,16,10,1326373560,60,25320,861720,836400,10_10
988,87,1326373500,5,9,5,1326376740,3240,795900,1090800,294900,19_19_19_19_19_19_19_19_19_19_1_1_19_19_19_19_1_1_1_1_2_2_2_2_21_3_3_21_3_3_3_3_3_3_3_3_13_13_13_13_13_13_5_5_14_14_6_6_14_14_5
989,122,1326373560,10,16,10,1326376800,3240,25380,861720,836340,10_10_10
990,104,1326374820,3,3,18,1326617520,242700,10920,935100,924180,3_3
991,105,1326375780,14,17,14,1326570360,194580,808920,1314480,505560,1_16_1_2_16_2_3_3_13_13_13_13_13_13_3_3_14_14_14_14
992,72,1326376260,1,18,17,1326382920,6660,193020,2385960,2192940,17_17_17_1_17_1_17_1_1
993,66,1326376260,4,23,4,1326377040,780,895860,4817700,3921840,3_3_4_4_4_4_4_4_4_4_4_4_4_4_4_4
994,87,1326376740,5,9,5,1326612000,235260,799140,1090800,291660,19_19_19_19_19_19_19_19_19_19_1_1_19_19_19_19_1_1_1_1_2_2_2_2_21_3_3_21_3_3_3_3_3_3_3_3_13_13_13_13_13_13_5_5_14_14_6_6_14_14_5_5
995,122,1326376800,10,16,1,1326430380,53580,28620,861720,833100,10_10_10_10
996,66,1326377040,4,15,4,1326404520,27480,896640,4817700,3921060,3_3_4_4_4_4_4_4_4_4_4_4_4_4_4_4_4
997,76,1326377220,5,2,5,1326448800,71580,835620,7552500,6716880,3_3_3_3_3_3_3_3_3_18_3_18_18_18_18_18_3_3_3_1_1_3_17_17_17_18_17_17_18_18_18_18_18_17_17_18_3_3_18_17_18_18_17_18_18_17_17_17_5_5_5_5_1_1_17_17_17_2_2_17_17_17_5_5_5_5
998,72,1326382920,17,10,17,1326394140,11220,199680,2385960,2186280,17_17_17_1_17_1_17_1_1_17
999,86,1326383700,0,1,0,1326404400,20700,37680,3519180,3481500,0_0
1000,83,1326384420,19,11,7,1326404460,20040,324420,1818000,1493580,19_19_19_19_19_19_19_19_19_19_19_19_19_19_19_19_19_19_19_19_19_19_19_19_19_19_19_19
1001,72,1326394140,17,12,17,1326428880,34740,210900,2385960,2175060,17_17_17_1_17_1_17_1_1_17_17
1002,131,1326404280,16,14,16,1326428820,24540,144180,6825900,6681720,16_16_16_16_16_16_16_16_16_16_16_16_16
1003,86,1326404400,0,14,0,1326428760,24360,58380,3519180,3460800,0_0_0
1004,83,1326404460,7,14,19,1326404520,60,344460,1818000,1473540,19_19_19_19_19_19_19_19_19_19_19_19_19_19_19_19_19_19_19_19_19_19_19_19_19_19_19_19_7
1005,83,1326404520,19,14,7,1326408960,4440,344520,1818000,1473480,19_19_19_19_19_19_19_19_19_19_19_19_19_19_19_19_19_19_19_19_19_19_19_19_19_19_19_19_7_19
1006,66,1326404520,4,15,4,1326406860,2340,924120,4817700,3893580,3_3_4_4_4_4_4_4_4_4_4_4_4_4_4_4_4_4
1007,53,1326405600,6,7,6,1326409200,3600,578940,582540,3600,26_26_10_10_10_10_10_1_1_10_1_1_2_2_2_2_3_3_5_5_5_5_6
1008,66,1326406860,4,5,4,1326417480,10620,926460,4817700,3891240,3_3_4_4_4_4_4_4_4_4_4_4_4_4_4_4_4_4_4
1009,83,1326408960,7,14,19,1326428220,19260,348960,1818000,1469040,19_19_19_19_19_19_19_19_19_19_19_19_19_19_19_19_19_19_19_19_19_19_19_19_19_19_19_19_7_19_7
1010,53,1326409200,6,7,99,1326409200,0,582540,582540,0,26_26_10_10_10_10_10_1_1_10_1_1_2_2_2_2_3_3_5_5_5_5_6_6
1011,66,1326417480,4,5,4,1326622860,205380,937080,4817700,3880620,3_3_4_4_4_4_4_4_4_4_4_4_4_4_4_4_4_4_4_4
1012,83,1326428220,19,14,1,1326430800,2580,368220,1818000,1449780,19_19_19_19_19_19_19_19_19_19_19_19_19_19_19_19_19_19_19_19_19_19_19_19_19_19_19_19_7_19_7_19
1013,86,1326428760,0,14,1,1326430800,2040,82740,3519180,3436440,0_0_0_0
1014,131,1326428820,16,14,16,1326431340,2520,168720,6825900,6657180,16_16_16_16_16_16_16_16_16_16_16_16_16_16
1015,72,1326428880,17,12,17,1326430320,1440,245640,2385960,2140320,17_17_17_1_17_1_17_1_1_17_17_17
1016,72,1326430320,17,8,1,1326445200,14880,247080,2385960,2138880,17_17_17_1_17_1_17_1_1_17_17_17_17
1017,122,1326430380,1,18,1,1326433260,2880,82200,861720,779520,10_10_10_10_1
1018,86,1326430800,1,9,0,1326432180,1380,84780,3519180,3434400,0_0_0_0_1
1019,83,1326430800,1,2,1,1326434400,3600,370800,1818000,1447200,19_19_19_19_19_19_19_19_19_19_19_19_19_19_19_19_19_19_19_19_19_19_19_19_19_19_19_19_7_19_7_19_1
1020,131,1326431340,16,20,16,1326451080,19740,171240,6825900,6654660,16_16_16_16_16_16_16_16_16_16_16_16_16_16_16
1021,86,1326432180,0,0,0,1326432240,60,86160,3519180,3433020,0_0_0_0_1_0
1022,86,1326432240,0,0,0,1326436680,4440,86220,3519180,3432960,0_0_0_0_1_0_0
1023,122,1326433260,1,18,10,1326433680,420,85080,861720,776640,10_10_10_10_1_1
1024,122,1326433680,10,16,10,1326451200,17520,85500,861720,776220,10_10_10_10_1_1_10
1025,83,1326434400,1,2,1,1326435600,1200,374400,1818000,1443600,19_19_19_19_19_19_19_19_19_19_19_19_19_19_19_19_19_19_19_19_19_19_19_19_19_19_19_19_7_19_7_19_1_1_1
1026,83,1326434400,1,2,1,1326434400,0,374400,1818000,1443600,19_19_19_19_19_19_19_19_19_19_19_19_19_19_19_19_19_19_19_19_19_19_19_19_19_19_19_19_7_19_7_19_1_1
1027,83,1326435600,1,2,1,1326436200,600,375600,1818000,1442400,19_19_19_19_19_19_19_19_19_19_19_19_19_19_19_19_19_19_19_19_19_19_19_19_19_19_19_19_7_19_7_19_1_1_1_1_1
1028,83,1326435600,1,2,1,1326435600,0,375600,1818000,1442400,19_19_19_19_19_19_19_19_19_19_19_19_19_19_19_19_19_19_19_19_19_19_19_19_19_19_19_19_7_19_7_19_1_1_1_1
1029,83,1326436200,1,2,1,1326436800,600,376200,1818000,1441800,19_19_19_19_19_19_19_19_19_19_19_19_19_19_19_19_19_19_19_19_19_19_19_19_19_19_19_19_7_19_7_19_1_1_1_1_1_1_1
1030,83,1326436200,1,2,1,1326436200,0,376200,1818000,1441800,19_19_19_19_19_19_19_19_19_19_19_19_19_19_19_19_19_19_19_19_19_19_19_19_19_19_19_19_7_19_7_19_1_1_1_1_1_1
1031,86,1326436680,0,0,0,1326451800,15120,90660,3519180,3428520,0_0_0_0_1_0_0_0
1032,83,1326436800,1,2,7,1326439920,3120,376800,1818000,1441200,19_19_19_19_19_19_19_19_19_19_19_19_19_19_19_19_19_19_19_19_19_19_19_19_19_19_19_19_7_19_7_19_1_1_1_1_1_1_1_1
1033,62,1326438000,5,2,5,1326441600,3600,136860,3674460,3537600,34_34_5
1034,83,1326439920,7,20,7,1326439980,60,379920,1818000,1438080,19_19_19_19_19_19_19_19_19_19_19_19_19_19_19_19_19_19_19_19_19_19_19_19_19_19_19_19_7_19_7_19_1_1_1_1_1_1_1_1_7
1035,83,1326439980,7,20,1,1326630600,190620,379980,1818000,1438020,19_19_19_19_19_19_19_19_19_19_19_19_19_19_19_19_19_19_19_19_19_19_19_19_19_19_19_19_7_19_7_19_1_1_1_1_1_1_1_1_7_7
1036,100,1326440340,5,9,5,1326444840,4500,777840,919500,141660,10_10_10_10_10_10_1_1_1_1_1_1_2_9_2_9_5_5_5
1037,62,1326441600,5,2,6,1326578400,136800,140460,3674460,3534000,34_34_5_5
1038,100,1326444840,5,9,6,1326578400,133560,782340,919500,137160,10_10_10_10_10_10_1_1_1_1_1_1_2_9_2_9_5_5_5_5
1039,72,1326445200,1,18,1,1326450600,5400,261960,2385960,2124000,17_17_17_1_17_1_17_1_1_17_17_17_17_1
1040,76,1326448800,5,2,5,1326451980,3180,907200,7552500,6645300,3_3_3_3_3_3_3_3_3_18_3_18_18_18_18_18_3_3_3_1_1_3_17_17_17_18_17_17_18_18_18_18_18_17_17_18_3_3_18_17_18_18_17_18_18_17_17_17_5_5_5_5_1_1_17_17_17_2_2_17_17_17_5_5_5_5_5
1041,88,1326448980,5,9,5,1326453480,4500,422340,555360,133020,1_1_2_2_2_2_3_3_3_3_5_5_5
1042,118,1326450300,5,18,5,1326451920,1620,328200,459900,131700,3_3_3_3_13_13_13_13_13_5_13_13_13_13_5_13_5_5_5
1043,72,1326450600,1,18,17,1326451680,1080,267360,2385960,2118600,17_17_17_1_17_1_17_1_1_17_17_17_17_1_1
1044,131,1326451080,16,20,16,1326538800,87720,190980,6825900,6634920,16_16_16_16_16_16_16_16_16_16_16_16_16_16_16_16
1045,122,1326451200,10,16,10,1326612720,161520,103020,861720,758700,10_10_10_10_1_1_10_10
1046,72,1326451680,17,8,17,1326451680,0,268440,2385960,2117520,17_17_17_1_17_1_17_1_1_17_17_17_17_1_1_17
1047,72,1326451680,17,10,17,1326524400,72720,268440,2385960,2117520,17_17_17_1_17_1_17_1_1_17_17_17_17_1_1_17_17
1048,86,1326451800,1,9,0,1326538800,87000,105780,3519180,3413400,0_0_0_0_1_0_0_0_0_1
1049,86,1326451800,0,0,1,1326451800,0,105780,3519180,3413400,0_0_0_0_1_0_0_0_0
1050,118,1326451920,5,18,6,1326578400,126480,329820,459900,130080,3_3_3_3_13_13_13_13_13_5_13_13_13_13_5_13_5_5_5_5
1051,76,1326451980,5,2,17,1326590220,138240,910380,7552500,6642120,3_3_3_3_3_3_3_3_3_18_3_18_18_18_18_18_3_3_3_1_1_3_17_17_17_18_17_17_18_18_18_18_18_17_17_18_3_3_18_17_18_18_17_18_18_17_17_17_5_5_5_5_1_1_17_17_17_2_2_17_17_17_5_5_5_5_5_5
1052,88,1326453480,5,9,6,1326578400,124920,426840,555360,128520,1_1_2_2_2_2_3_3_3_3_5_5_5_5
1053,72,1326524400,38,0,38,1326538800,14400,341160,2385960,2044800,17_17_17_1_17_1_17_1_1_17_17_17_17_1_1_17_17_17_38
1054,72,1326524400,17,10,38,1326524400,0,341160,2385960,2044800,17_17_17_1_17_1_17_1_1_17_17_17_17_1_1_17_17_17
1055,131,1326538800,16,11,16,1326538800,0,278700,6825900,6547200,16_16_16_16_16_16_16_16_16_16_16_16_16_16_16_16_16
1056,131,1326538800,16,0,16,1326571200,32400,278700,6825900,6547200,16_16_16_16_16_16_16_16_16_16_16_16_16_16_16_16_16_16
1057,72,1326538800,38,0,17,1326578100,39300,355560,2385960,2030400,17_17_17_1_17_1_17_1_1_17_17_17_17_1_1_17_17_17_38_38
1058,86,1326538800,0,0,0,1326553200,14400,192780,3519180,3326400,0_0_0_0_1_0_0_0_0_1_0
1059,86,1326553200,0,11,0,1326571200,18000,207180,3519180,3312000,0_0_0_0_1_0_0_0_0_1_0_0
1060,105,1326570360,14,17,14,1326578040,7680,1003500,1314480,310980,1_16_1_2_16_2_3_3_13_13_13_13_13_13_3_3_14_14_14_14_14
1061,86,1326571200,0,11,0,1326572100,900,225180,3519180,3294000,0_0_0_0_1_0_0_0_0_1_0_0_0
1062,131,1326571200,16,11,16,1326574500,3300,311100,6825900,6514800,16_16_16_16_16_16_16_16_16_16_16_16_16_16_16_16_16_16_16
1063,86,1326572100,0,11,1,1326578400,6300,226080,3519180,3293100,0_0_0_0_1_0_0_0_0_1_0_0_0_0
1064,131,1326574500,16,11,16,1326578400,3900,314400,6825900,6511500,16_16_16_16_16_16_16_16_16_16_16_16_16_16_16_16_16_16_16_16
1065,112,1326574560,19,11,19,1326602280,27720,0,1303440,1303440,19
1066,105,1326578040,14,17,13,1326578100,60,1011180,1314480,303300,1_16_1_2_16_2_3_3_13_13_13_13_13_13_3_3_14_14_14_14_14_14
1067,72,1326578100,17,10,17,1326590220,12120,394860,2385960,1991100,17_17_17_1_17_1_17_1_1_17_17_17_17_1_1_17_17_17_38_38_17
1068,105,1326578100,13,17,13,1326579900,1800,1011240,1314480,303240,1_16_1_2_16_2_3_3_13_13_13_13_13_13_3_3_14_14_14_14_14_14_13
1069,88,1326578400,6,7,6,1326582000,3600,551760,555360,3600,1_1_2_2_2_2_3_3_3_3_5_5_5_5_6_6
1070,100,1326578400,6,7,6,1326582000,3600,915900,919500,3600,10_10_10_10_10_10_1_1_1_1_1_1_2_9_2_9_5_5_5_5_6
1071,78,1326578400,6,7,6,1326582000,3600,518400,1818900,1300500,40_40_34_34_5_5_5_5_6
1072,62,1326578400,6,7,6,1326582000,3600,277260,3674460,3397200,34_34_5_5_6
1073,118,1326578400,6,7,6,1326582000,3600,456300,459900,3600,3_3_3_3_13_13_13_13_13_5_13_13_13_13_5_13_5_5_5_5_6
1074,88,1326578400,6,7,6,1326578400,0,551760,555360,3600,1_1_2_2_2_2_3_3_3_3_5_5_5_5_6
1075,106,1326578400,6,7,6,1326582000,3600,997200,1023180,25980,46_46_46_46_46_46_46_46_1_1_2_2_9_9_46_46_46_46_1_1_46_46_1_1_1_39_1_39_2_2_9_9_1_1_3_3_18_18_18_18_18_18_18_18_5_5_5_5_6
1076,86,1326578400,1,14,1,1326582900,4500,232380,3519180,3286800,0_0_0_0_1_0_0_0_0_1_0_0_0_0_1
1077,131,1326578400,16,14,16,1326582900,4500,318300,6825900,6507600,16_16_16_16_16_16_16_16_16_16_16_16_16_16_16_16_16_16_16_16_16
1078,105,1326579900,13,17,13,1326579960,60,1013040,1314480,301440,1_16_1_2_16_2_3_3_13_13_13_13_13_13_3_3_14_14_14_14_14_14_13_13
1079,105,1326579960,13,17,13,1326602400,22440,1013100,1314480,301380,1_16_1_2_16_2_3_3_13_13_13_13_13_13_3_3_14_14_14_14_14_14_13_13_13
1080,88,1326582000,6,7,99,1326582000,0,555360,555360,0,1_1_2_2_2_2_3_3_3_3_5_5_5_5_6_6_6_6
1081,88,1326582000,6,7,6,1326582000,0,555360,555360,0,1_1_2_2_2_2_3_3_3_3_5_5_5_5_6_6_6
1082,78,1326582000,6,7,3,1327874400,1292400,522000,1818900,1296900,40_40_34_34_5_5_5_5_6_6
1083,100,1326582000,6,7,99,1326582000,0,919500,919500,0,10_10_10_10_10_10_1_1_1_1_1_1_2_9_2_9_5_5_5_5_6_6
1084,118,1326582000,6,7,99,1326582000,0,459900,459900,0,3_3_3_3_13_13_13_13_13_5_13_13_13_13_5_13_5_5_5_5_6_6
1085,62,1326582000,6,7,11,1329727500,3145500,280860,3674460,3393600,34_34_5_5_6_6
1086,106,1326582000,6,7,5,1326603120,21120,1000800,1023180,22380,46_46_46_46_46_46_46_46_1_1_2_2_9_9_46_46_46_46_1_1_46_46_1_1_1_39_1_39_2_2_9_9_1_1_3_3_18_18_18_18_18_18_18_18_5_5_5_5_6_6
1087,131,1326582900,16,14,16,1326599940,17040,322800,6825900,6503100,16_16_16_16_16_16_16_16_16_16_16_16_16_16_16_16_16_16_16_16_16_16
1088,86,1326582900,1,14,0,1326595260,12360,236880,3519180,3282300,0_0_0_0_1_0_0_0_0_1_0_0_0_0_1_1
1089,72,1326590220,17,10,1,1326610800,20580,406980,2385960,1978980,17_17_17_1_17_1_17_1_1_17_17_17_17_1_1_17_17_17_38_38_17_17
1090,76,1326590220,17,10,17,1326603600,13380,1048620,7552500,6503880,3_3_3_3_3_3_3_3_3_18_3_18_18_18_18_18_3_3_3_1_1_3_17_17_17_18_17_17_18_18_18_18_18_17_17_18_3_3_18_17_18_18_17_18_18_17_17_17_5_5_5_5_1_1_17_17_17_2_2_17_17_17_5_5_5_5_5_5_17
1091,86,1326595260,0,11,0,1326613920,18660,249240,3519180,3269940,0_0_0_0_1_0_0_0_0_1_0_0_0_0_1_1_0
1092,131,1326599940,16,11,16,1326609600,9660,339840,6825900,6486060,16_16_16_16_16_16_16_16_16_16_16_16_16_16_16_16_16_16_16_16_16_16_16
1093,112,1326602280,19,11,19,1326613500,11220,27720,1303440,1275720,19_19
1094,105,1326602400,13,17,13,1326650520,48120,1035540,1314480,278940,1_16_1_2_16_2_3_3_13_13_13_13_13_13_3_3_14_14_14_14_14_14_13_13_13_13
1095,127,1326603000,5,9,5,1326603720,720,534540,599940,65400,7_7_7_7_1_7_1_1_7_1_2_2_3_3_9_9_3_3_3_3_2_2_5
1096,106,1326603120,5,18,5,1326604380,1260,1021920,1023180,1260,46_46_46_46_46_46_46_46_1_1_2_2_9_9_46_46_46_46_1_1_46_46_1_1_1_39_1_39_2_2_9_9_1_1_3_3_18_18_18_18_18_18_18_18_5_5_5_5_6_6_5
1097,76,1326603600,17,10,5,1326603600,0,1062000,7552500,6490500,3_3_3_3_3_3_3_3_3_18_3_18_18_18_18_18_3_3_3_1_1_3_17_17_17_18_17_17_18_18_18_18_18_17_17_18_3_3_18_17_18_18_17_18_18_17_17_17_5_5_5_5_1_1_17_17_17_2_2_17_17_17_5_5_5_5_5_5_17_17
1098,76,1326603600,5,2,5,1326609600,6000,1062000,7552500,6490500,3_3_3_3_3_3_3_3_3_18_3_18_18_18_18_18_3_3_3_1_1_3_17_17_17_18_17_17_18_18_18_18_18_17_17_18_3_3_18_17_18_18_17_18_18_17_17_17_5_5_5_5_1_1_17_17_17_2_2_17_17_17_5_5_5_5_5_5_17_17_5
1099,127,1326603720,5,9,6,1326664800,61080,535260,599940,64680,7_7_7_7_1_7_1_1_7_1_2_2_3_3_9_9_3_3_3_3_2_2_5_5
1100,106,1326604380,5,18,99,1326604380,0,1023180,1023180,0,46_46_46_46_46_46_46_46_1_1_2_2_9_9_46_46_46_46_1_1_46_46_1_1_1_39_1_39_2_2_9_9_1_1_3_3_18_18_18_18_18_18_18_18_5_5_5_5_6_6_5_5
1101,91,1326604740,5,9,5,1326617700,12960,849540,1030200,180660,10_10_10_10_10_10_1_1_1_1_2_2_3_3_3_2_3_2_5
1102,61,1326607680,34,15,3,1326615180,7500,1152480,6225300,5072820,4_4_18_18_34_34_34
1103,77,1326608160,0,1,0,1326629160,21000,0,3257040,3257040,0
1104,131,1326609600,16,20,16,1326614100,4500,349500,6825900,6476400,16_16_16_16_16_16_16_16_16_16_16_16_16_16_16_16_16_16_16_16_16_16_16_16
1105,76,1326609600,5,2,5,1326610800,1200,1068000,7552500,6484500,3_3_3_3_3_3_3_3_3_18_3_18_18_18_18_18_3_3_3_1_1_3_17_17_17_18_17_17_18_18_18_18_18_17_17_18_3_3_18_17_18_18_17_18_18_17_17_17_5_5_5_5_1_1_17_17_17_2_2_17_17_17_5_5_5_5_5_5_17_17_5_5
1106,76,1326610800,5,2,17,1326611400,600,1069200,7552500,6483300,3_3_3_3_3_3_3_3_3_18_3_18_18_18_18_18_3_3_3_1_1_3_17_17_17_18_17_17_18_18_18_18_18_17_17_18_3_3_18_17_18_18_17_18_18_17_17_17_5_5_5_5_1_1_17_17_17_2_2_17_17_17_5_5_5_5_5_5_17_17_5_5_5
1107,72,1326610800,1,18,24,1326611880,1080,427560,2385960,1958400,17_17_17_1_17_1_17_1_1_17_17_17_17_1_1_17_17_17_38_38_17_17_1
1108,76,1326611400,17,12,5,1326624600,13200,1069800,7552500,6482700,3_3_3_3_3_3_3_3_3_18_3_18_18_18_18_18_3_3_3_1_1_3_17_17_17_18_17_17_18_18_18_18_18_17_17_18_3_3_18_17_18_18_17_18_18_17_17_17_5_5_5_5_1_1_17_17_17_2_2_17_17_17_5_5_5_5_5_5_17_17_5_5_5_17
1109,72,1326611880,24,8,24,1326637500,25620,428640,2385960,1957320,17_17_17_1_17_1_17_1_1_17_17_17_17_1_1_17_17_17_38_38_17_17_1_24
1110,87,1326612000,5,9,5,1326612060,60,1034400,1090800,56400,19_19_19_19_19_19_19_19_19_19_1_1_19_19_19_19_1_1_1_1_2_2_2_2_21_3_3_21_3_3_3_3_3_3_3_3_13_13_13_13_13_13_5_5_14_14_6_6_14_14_5_5_5
1111,87,1326612060,5,9,6,1326664800,52740,1034460,1090800,56340,19_19_19_19_19_19_19_19_19_19_1_1_19_19_19_19_1_1_1_1_2_2_2_2_21_3_3_21_3_3_3_3_3_3_3_3_13_13_13_13_13_13_5_5_14_14_6_6_14_14_5_5_5_5
1112,122,1326612720,10,16,10,1326643080,30360,264540,861720,597180,10_10_10_10_1_1_10_10_10
1113,112,1326613500,19,20,19,1326616260,2760,38940,1303440,1264500,19_19_19
1114,86,1326613920,0,0,1,1326619980,6060,267900,3519180,3251280,0_0_0_0_1_0_0_0_0_1_0_0_0_0_1_1_0_0
1115,131,1326614100,16,0,16,1326631380,17280,354000,6825900,6471900,16_16_16_16_16_16_16_16_16_16_16_16_16_16_16_16_16_16_16_16_16_16_16_16_16
1116,61,1326615180,3,4,3,1326615600,420,1159980,6225300,5065320,4_4_18_18_34_34_34_3
1117,61,1326615600,3,3,34,1326627000,11400,1160400,6225300,5064900,4_4_18_18_34_34_34_3_3
1118,112,1326616260,19,14,19,1326616440,180,41700,1303440,1261740,19_19_19_19
1119,112,1326616440,19,20,1,1326618180,1740,41880,1303440,1261560,19_19_19_19_19
1120,104,1326617520,18,19,18,1326630360,12840,253620,935100,681480,3_3_18
1121,91,1326617700,5,9,6,1326751200,133500,862500,1030200,167700,10_10_10_10_10_10_1_1_1_1_2_2_3_3_3_2_3_2_5_5
1122,112,1326618180,1,9,1,1326619740,1560,43620,1303440,1259820,19_19_19_19_19_1
1123,112,1326619740,1,9,19,1326627540,7800,45180,1303440,1258260,19_19_19_19_19_1_1
1124,86,1326619980,1,9,1,1326623820,3840,273960,3519180,3245220,0_0_0_0_1_0_0_0_0_1_0_0_0_0_1_1_0_0_1
1125,93,1326622440,5,6,5,1326622500,60,1023540,1242300,218760,3_3_3_3_18_18_18_18_18_18_18_18_18_18_5_5_5
1126,93,1326622500,5,6,6,1326751200,128700,1023600,1242300,218700,3_3_3_3_18_18_18_18_18_18_18_18_18_18_5_5_5_5
1127,66,1326622860,4,5,3,1326633240,10380,1142460,4817700,3675240,3_3_4_4_4_4_4_4_4_4_4_4_4_4_4_4_4_4_4_4_4
1128,121,1326623400,5,6,5,1326633060,9660,611700,856140,244440,7_7_7_7_7_7_3_3_1_1_2_2_9_9_3_9_9_3_18_18_18_18_18_18_5
1129,86,1326623820,1,9,1,1326632640,8820,277800,3519180,3241380,0_0_0_0_1_0_0_0_0_1_0_0_0_0_1_1_0_0_1_1
1130,76,1326624600,5,2,5,1326626400,1800,1083000,7552500,6469500,3_3_3_3_3_3_3_3_3_18_3_18_18_18_18_18_3_3_3_1_1_3_17_17_17_18_17_17_18_18_18_18_18_17_17_18_3_3_18_17_18_18_17_18_18_17_17_17_5_5_5_5_1_1_17_17_17_2_2_17_17_17_5_5_5_5_5_5_17_17_5_5_5_17_5
1131,76,1326626400,5,2,5,1326628800,2400,1084800,7552500,6467700,3_3_3_3_3_3_3_3_3_18_3_18_18_18_18_18_3_3_3_1_1_3_17_17_17_18_17_17_18_18_18_18_18_17_17_18_3_3_18_17_18_18_17_18_18_17_17_17_5_5_5_5_1_1_17_17_17_2_2_17_17_17_5_5_5_5_5_5_17_17_5_5_5_17_5_5
1132,61,1326627000,34,15,3,1326633120,6120,1171800,6225300,5053500,4_4_18_18_34_34_34_3_3_34
1133,112,1326627540,19,14,19,1326654900,27360,52980,1303440,1250460,19_19_19_19_19_1_1_19
1134,76,1326628800,5,2,5,1326630600,1800,1087200,7552500,6465300,3_3_3_3_3_3_3_3_3_18_3_18_18_18_18_18_3_3_3_1_1_3_17_17_17_18_17_17_18_18_18_18_18_17_17_18_3_3_18_17_18_18_17_18_18_17_17_17_5_5_5_5_1_1_17_17_17_2_2_17_17_17_5_5_5_5_5_5_17_17_5_5_5_17_5_5_5_5
1135,76,1326628800,5,2,5,1326628800,0,1087200,7552500,6465300,3_3_3_3_3_3_3_3_3_18_3_18_18_18_18_18_3_3_3_1_1_3_17_17_17_18_17_17_18_18_18_18_18_17_17_18_3_3_18_17_18_18_17_18_18_17_17_17_5_5_5_5_1_1_17_17_17_2_2_17_17_17_5_5_5_5_5_5_17_17_5_5_5_17_5_5_5
1136,77,1326629160,0,1,1,1326629220,60,21000,3257040,3236040,0_0
1137,77,1326629220,0,1,0,1326634560,5340,21060,3257040,3235980,0_0_1_0
1138,77,1326629220,1,9,0,1326629220,0,21060,3257040,3235980,0_0_1
1139,104,1326630360,18,19,18,1326630420,60,266460,935100,668640,3_3_18_18
1140,104,1326630420,18,19,18,1326636540,6120,266520,935100,668580,3_3_18_18_18
1141,83,1326630600,1,2,1,1326631380,780,570600,1818000,1247400,19_19_19_19_19_19_19_19_19_19_19_19_19_19_19_19_19_19_19_19_19_19_19_19_19_19_19_19_7_19_7_19_1_1_1_1_1_1_1_1_7_7_1
1142,76,1326630600,5,2,17,1326635820,5220,1089000,7552500,6463500,3_3_3_3_3_3_3_3_3_18_3_18_18_18_18_18_3_3_3_1_1_3_17_17_17_18_17_17_18_18_18_18_18_17_17_18_3_3_18_17_18_18_17_18_18_17_17_17_5_5_5_5_1_1_17_17_17_2_2_17_17_17_5_5_5_5_5_5_17_17_5_5_5_17_5_5_5_5_5
1143,83,1326631380,1,2,3,1327269600,638220,571380,1818000,1246620,19_19_19_19_19_19_19_19_19_19_19_19_19_19_19_19_19_19_19_19_19_19_19_19_19_19_19_19_7_19_7_19_1_1_1_1_1_1_1_1_7_7_1_1
1144,131,1326631380,16,20,1,1326699000,67620,371280,6825900,6454620,16_16_16_16_16_16_16_16_16_16_16_16_16_16_16_16_16_16_16_16_16_16_16_16_16_16
1145,86,1326632640,1,1,1,1326634260,1620,286620,3519180,3232560,0_0_0_0_1_0_0_0_0_1_0_0_0_0_1_1_0_0_1_1_1
1146,121,1326633060,5,6,6,1326837600,204540,621360,856140,234780,7_7_7_7_7_7_3_3_1_1_2_2_9_9_3_9_9_3_18_18_18_18_18_18_5_5
1147,61,1326633120,3,4,3,1326641220,8100,1177920,6225300,5047380,4_4_18_18_34_34_34_3_3_34_3
1148,66,1326633240,3,4,3,1326635820,2580,1152840,4817700,3664860,3_3_4_4_4_4_4_4_4_4_4_4_4_4_4_4_4_4_4_4_4_3
1149,86,1326634260,1,9,1,1326634320,60,288240,3519180,3230940,0_0_0_0_1_0_0_0_0_1_0_0_0_0_1_1_0_0_1_1_1_1
1150,86,1326634320,1,9,1,1326636540,2220,288300,3519180,3230880,0_0_0_0_1_0_0_0_0_1_0_0_0_0_1_1_0_0_1_1_1_1_1
1151,77,1326634560,0,1,1,1326636480,1920,26400,3257040,3230640,0_0_1_0_0
1152,76,1326635820,17,12,17,1326637440,1620,1094220,7552500,6458280,3_3_3_3_3_3_3_3_3_18_3_18_18_18_18_18_3_3_3_1_1_3_17_17_17_18_17_17_18_18_18_18_18_17_17_18_3_3_18_17_18_18_17_18_18_17_17_17_5_5_5_5_1_1_17_17_17_2_2_17_17_17_5_5_5_5_5_5_17_17_5_5_5_17_5_5_5_5_5_17
1153,66,1326635820,3,4,4,1326636540,720,1155420,4817700,3662280,3_3_4_4_4_4_4_4_4_4_4_4_4_4_4_4_4_4_4_4_4_3_3
1154,77,1326636480,1,9,0,1326654840,18360,28320,3257040,3228720,0_0_1_0_0_1
1155,104,1326636540,18,19,18,1326637080,540,272640,935100,662460,3_3_18_18_18_18
1156,86,1326636540,1,1,2,1327319160,682620,290520,3519180,3228660,0_0_0_0_1_0_0_0_0_1_0_0_0_0_1_1_0_0_1_1_1_1_1_1
1157,66,1326636540,4,5,4,1326637140,600,1156140,4817700,3661560,3_3_4_4_4_4_4_4_4_4_4_4_4_4_4_4_4_4_4_4_4_3_3_4
1158,104,1326637080,18,23,18,1326663240,26160,273180,935100,661920,3_3_18_18_18_18_18
1159,66,1326637140,4,23,4,1326663180,26040,1156740,4817700,3660960,3_3_4_4_4_4_4_4_4_4_4_4_4_4_4_4_4_4_4_4_4_3_3_4_4
1160,76,1326637440,17,10,17,1326643380,5940,1095840,7552500,6456660,3_3_3_3_3_3_3_3_3_18_3_18_18_18_18_18_3_3_3_1_1_3_17_17_17_18_17_17_18_18_18_18_18_17_17_18_3_3_18_17_18_18_17_18_18_17_17_17_5_5_5_5_1_1_17_17_17_2_2_17_17_17_5_5_5_5_5_5_17_17_5_5_5_17_5_5_5_5_5_17_17
1161,72,1326637500,24,8,24,1326637560,60,454260,2385960,1931700,17_17_17_1_17_1_17_1_1_17_17_17_17_1_1_17_17_17_38_38_17_17_1_24_24
1162,72,1326637560,24,8,24,1326642720,5160,454320,2385960,1931640,17_17_17_1_17_1_17_1_1_17_17_17_17_1_1_17_17_17_38_38_17_17_1_24_24_24
1163,61,1326641220,3,3,34,1326689820,48600,1186020,6225300,5039280,4_4_18_18_34_34_34_3_3_34_3_3
1164,72,1326642720,24,8,1,1326643080,360,459480,2385960,1926480,17_17_17_1_17_1_17_1_1_17_17_17_17_1_1_17_17_17_38_38_17_17_1_24_24_24_24
1165,72,1326643080,1,18,24,1326690180,47100,459840,2385960,1926120,17_17_17_1_17_1_17_1_1_17_17_17_17_1_1_17_17_17_38_38_17_17_1_24_24_24_24_1
1166,122,1326643080,10,16,10,1326650760,7680,294900,861720,566820,10_10_10_10_1_1_10_10_10_10
1167,76,1326643380,17,10,1,1326712800,69420,1101780,7552500,6450720,3_3_3_3_3_3_3_3_3_18_3_18_18_18_18_18_3_3_3_1_1_3_17_17_17_18_17_17_18_18_18_18_18_17_17_18_3_3_18_17_18_18_17_18_18_17_17_17_5_5_5_5_1_1_17_17_17_2_2_17_17_17_5_5_5_5_5_5_17_17_5_5_5_17_5_5_5_5_5_17_17_17
1168,12,1326643440,17,10,17,1326663600,20160,0,850020,850020,17
1169,105,1326650520,13,17,13,1326663120,12600,1083660,1314480,230820,1_16_1_2_16_2_3_3_13_13_13_13_13_13_3_3_14_14_14_14_14_14_13_13_13_13_13
1170,122,1326650760,10,0,10,1326658500,7740,302580,861720,559140,10_10_10_10_1_1_10_10_10_10_10
1171,77,1326654840,0,11,0,1326659040,4200,46680,3257040,3210360,0_0_1_0_0_1_0
1172,112,1326654900,19,11,19,1326674220,19320,80340,1303440,1223100,19_19_19_19_19_1_1_19_19
1173,122,1326658500,10,0,1,1326690000,31500,310320,861720,551400,10_10_10_10_1_1_10_10_10_10_10_10
1174,77,1326659040,0,11,0,1326659100,60,50880,3257040,3206160,0_0_1_0_0_1_0_0
1175,77,1326659100,0,11,0,1326674040,14940,50940,3257040,3206100,0_0_1_0_0_1_0_0_0
1176,105,1326663120,13,17,13,1326684000,20880,1096260,1314480,218220,1_16_1_2_16_2_3_3_13_13_13_13_13_13_3_3_14_14_14_14_14_14_13_13_13_13_13_13
1177,66,1326663180,4,17,4,1326663540,360,1182780,4817700,3634920,3_3_4_4_4_4_4_4_4_4_4_4_4_4_4_4_4_4_4_4_4_3_3_4_4_4
1178,104,1326663240,18,17,18,1326663480,240,299340,935100,635760,3_3_18_18_18_18_18_18
1179,104,1326663480,18,23,18,1326681180,17700,299580,935100,635520,3_3_18_18_18_18_18_18_18
1180,66,1326663540,4,23,4,1326683820,20280,1183140,4817700,3634560,3_3_4_4_4_4_4_4_4_4_4_4_4_4_4_4_4_4_4_4_4_3_3_4_4_4_4
1181,12,1326663600,17,10,17,1326689940,26340,20160,850020,829860,17_17
1182,115,1326664800,19,20,19,1326669300,4500,0,954000,954000,19
1183,87,1326664800,6,7,6,1326668400,3600,1087200,1090800,3600,19_19_19_19_19_19_19_19_19_19_1_1_19_19_19_19_1_1_1_1_2_2_2_2_21_3_3_21_3_3_3_3_3_3_3_3_13_13_13_13_13_13_5_5_14_14_6_6_14_14_5_5_5_5_6
1184,129,1326664800,6,7,6,1326668400,3600,1184400,1188000,3600,26_26_8_8_2_2_5_5_6
1185,146,1326664800,3,4,3,1326664800,0,1137600,6670800,5533200,16_16_16_16_16_16_16_1_16_1_16_1_1_16_1_16_16_2_1_1_16_1_2_16_2_2_3
1186,127,1326664800,6,7,6,1326668400,3600,596340,599940,3600,7_7_7_7_1_7_1_1_7_1_2_2_3_3_9_9_3_3_3_3_2_2_5_5_6_6
1187,127,1326664800,6,7,6,1326664800,0,596340,599940,3600,7_7_7_7_1_7_1_1_7_1_2_2_3_3_9_9_3_3_3_3_2_2_5_5_6
1188,146,1326664800,3,4,3,1326669300,4500,1137600,6670800,5533200,16_16_16_16_16_16_16_1_16_1_16_1_1_16_1_16_16_2_1_1_16_1_2_16_2_2_3_3
1189,129,1326668400,6,7,99,1326668400,0,1188000,1188000,0,26_26_8_8_2_2_5_5_6_6
1190,127,1326668400,6,7,99,1326668400,0,599940,599940,0,7_7_7_7_1_7_1_1_7_1_2_2_3_3_9_9_3_3_3_3_2_2_5_5_6_6_6_6
1191,127,1326668400,6,7,6,1326668400,0,599940,599940,0,7_7_7_7_1_7_1_1_7_1_2_2_3_3_9_9_3_3_3_3_2_2_5_5_6_6_6
1192,87,1326668400,6,7,99,1326668400,0,1090800,1090800,0,19_19_19_19_19_19_19_19_19_19_1_1_19_19_19_19_1_1_1_1_2_2_2_2_21_3_3_21_3_3_3_3_3_3_3_3_13_13_13_13_13_13_5_5_14_14_6_6_14_14_5_5_5_5_6_6
1193,115,1326669300,19,20,19,1326751200,81900,4500,954000,949500,19_19
1194,146,1326669300,3,4,3,1326669300,0,1142100,6670800,5528700,16_16_16_16_16_16_16_1_16_1_16_1_1_16_1_16_16_2_1_1_16_1_2_16_2_2_3_3_3
1195,146,1326669300,3,4,21,1326701400,32100,1142100,6670800,5528700,16_16_16_16_16_16_16_1_16_1_16_1_1_16_1_16_16_2_1_1_16_1_2_16_2_2_3_3_3_3
1196,77,1326674040,0,11,0,1326674160,120,65880,3257040,3191160,0_0_1_0_0_1_0_0_0_0
1197,77,1326674160,0,11,0,1326681480,7320,66000,3257040,3191040,0_0_1_0_0_1_0_0_0_0_0
1198,112,1326674220,19,11,1,1326792480,118260,99660,1303440,1203780,19_19_19_19_19_1_1_19_19_19
1199,117,1326674280,19,11,19,1326688560,14280,0,1144740,1144740,19
1200,104,1326681180,18,17,15,1326872520,191340,317280,935100,617820,3_3_18_18_18_18_18_18_18_18
1201,77,1326681480,0,11,0,1326691740,10260,73320,3257040,3183720,0_0_1_0_0_1_0_0_0_0_0_0
1202,66,1326683820,4,17,4,1326734880,51060,1203420,4817700,3614280,3_3_4_4_4_4_4_4_4_4_4_4_4_4_4_4_4_4_4_4_4_3_3_4_4_4_4_4
1203,105,1326684000,13,17,13,1326689700,5700,1117140,1314480,197340,1_16_1_2_16_2_3_3_13_13_13_13_13_13_3_3_14_14_14_14_14_14_13_13_13_13_13_13_13
1204,117,1326688560,19,11,19,1326690000,1440,14280,1144740,1130460,19_19
1205,105,1326689700,13,17,13,1326737640,47940,1122840,1314480,191640,1_16_1_2_16_2_3_3_13_13_13_13_13_13_3_3_14_14_14_14_14_14_13_13_13_13_13_13_13_13
1206,61,1326689820,34,15,35,1326701640,11820,1234620,6225300,4990680,4_4_18_18_34_34_34_3_3_34_3_3_34
1207,12,1326689940,17,12,1,1326697200,7260,46500,850020,803520,17_17_17
1208,97,1326690000,1,2,1,1326696000,6000,0,294600,294600,1
1209,117,1326690000,19,14,1,1326702600,12600,15720,1144740,1129020,19_19_19
1210,122,1326690000,1,18,1,1326696000,6000,341820,861720,519900,10_10_10_10_1_1_10_10_10_10_10_10_1
1211,72,1326690180,24,8,1,1326700800,10620,506940,2385960,1879020,17_17_17_1_17_1_17_1_1_17_17_17_17_1_1_17_17_17_38_38_17_17_1_24_24_24_24_1_24
1212,77,1326691740,0,20,0,1326723960,32220,83580,3257040,3173460,0_0_1_0_0_1_0_0_0_0_0_0_0
1213,79,1326693600,10,13,10,1326722940,29340,1065600,4151700,3086100,15_1_15_1_26_26_26_26_26_26_26_26_26_26_26_26_26_26_26_26_8_8_1_1_10
1214,140,1326694320,2,3,2,1326695280,960,1027200,1300140,272940,26_26_26_26_10_10_10_10_10_10_1_1_2
1215,140,1326695280,2,3,3,1326695280,0,1028160,1300140,271980,26_26_26_26_10_10_10_10_10_10_1_1_2_2
1216,140,1326695280,3,3,3,1326699420,4140,1028160,1300140,271980,26_26_26_26_10_10_10_10_10_10_1_1_2_2_3
1217,97,1326696000,1,2,1,1326697200,1200,6000,294600,288600,1_1
1218,122,1326696000,1,18,9,1326713940,17940,347820,861720,513900,10_10_10_10_1_1_10_10_10_10_10_10_1_1
1219,97,1326697200,1,2,1,1326699000,1800,7200,294600,287400,1_1_1
1220,12,1326697200,1,18,17,1326700140,2940,53760,850020,796260,17_17_17_1
1221,97,1326699000,1,2,1,1326982800,283800,9000,294600,285600,1_1_1_1
1222,131,1326699000,1,2,1,1326710520,11520,438900,6825900,6387000,16_16_16_16_16_16_16_16_16_16_16_16_16_16_16_16_16_16_16_16_16_16_16_16_16_16_1
1223,140,1326699420,3,3,14,1326713820,14400,1032300,1300140,267840,26_26_26_26_10_10_10_10_10_10_1_1_2_2_3_3
1224,12,1326700140,17,12,17,1326700200,60,56700,850020,793320,17_17_17_1_17
1225,12,1326700200,17,12,1,1326700440,240,56760,850020,793260,17_17_17_1_17_17
1226,12,1326700440,1,18,17,1326723720,23280,57000,850020,793020,17_17_17_1_17_17_1
1227,72,1326700800,1,18,1,1326702600,1800,517560,2385960,1868400,17_17_17_1_17_1_17_1_1_17_17_17_17_1_1_17_17_17_38_38_17_17_1_24_24_24_24_1_24_1
1228,146,1326701400,21,4,21,1326703020,1620,1174200,6670800,5496600,16_16_16_16_16_16_16_1_16_1_16_1_1_16_1_16_16_2_1_1_16_1_2_16_2_2_3_3_3_3_21
1229,61,1326701640,35,19,34,1326703620,1980,1246440,6225300,4978860,4_4_18_18_34_34_34_3_3_34_3_3_34_35
1230,117,1326702600,1,18,19,1326704400,1800,28320,1144740,1116420,19_19_19_1
1231,72,1326702600,1,18,24,1326722280,19680,519360,2385960,1866600,17_17_17_1_17_1_17_1_1_17_17_17_17_1_1_17_17_17_38_38_17_17_1_24_24_24_24_1_24_1_1
1232,146,1326703020,21,4,3,1326708780,5760,1175820,6670800,5494980,16_16_16_16_16_16_16_1_16_1_16_1_1_16_1_16_16_2_1_1_16_1_2_16_2_2_3_3_3_3_21_21
1233,61,1326703620,34,15,35,1326721380,17760,1248420,6225300,4976880,4_4_18_18_34_34_34_3_3_34_3_3_34_35_34
1234,117,1326704400,19,14,19,1326704460,60,30120,1144740,1114620,19_19_19_1_19
1235,117,1326704460,19,14,1,1326710880,6420,30180,1144740,1114560,19_19_19_1_19_19
1236,146,1326708780,3,4,3,1326710700,1920,1181580,6670800,5489220,16_16_16_16_16_16_16_1_16_1_16_1_1_16_1_16_16_2_1_1_16_1_2_16_2_2_3_3_3_3_21_21_3
1237,131,1326710520,1,2,1,1326710580,60,450420,6825900,6375480,16_16_16_16_16_16_16_16_16_16_16_16_16_16_16_16_16_16_16_16_16_16_16_16_16_16_1_1
1238,131,1326710580,1,2,1,1326711000,420,450480,6825900,6375420,16_16_16_16_16_16_16_16_16_16_16_16_16_16_16_16_16_16_16_16_16_16_16_16_16_16_1_1_1
1239,146,1326710700,3,4,3,1326718200,7500,1183500,6670800,5487300,16_16_16_16_16_16_16_1_16_1_16_1_1_16_1_16_16_2_1_1_16_1_2_16_2_2_3_3_3_3_21_21_3_3
1240,117,1326710880,1,18,19,1326724740,13860,36600,1144740,1108140,19_19_19_1_19_19_1
1241,131,1326711000,1,2,2,1326719280,8280,450900,6825900,6375000,16_16_16_16_16_16_16_16_16_16_16_16_16_16_16_16_16_16_16_16_16_16_16_16_16_16_1_1_1_1
1242,76,1326712800,1,2,1,1326720840,8040,1171200,7552500,6381300,3_3_3_3_3_3_3_3_3_18_3_18_18_18_18_18_3_3_3_1_1_3_17_17_17_18_17_17_18_18_18_18_18_17_17_18_3_3_18_17_18_18_17_18_18_17_17_17_5_5_5_5_1_1_17_17_17_2_2_17_17_17_5_5_5_5_5_5_17_17_5_5_5_17_5_5_5_5_5_17_17_17_1
1243,138,1326712800,47,18,47,1326718800,6000,1225200,1785600,560400,10_10_10_10_10_1_10_10_1_10_10_10_10_10_10_1_10_1_9_9_47
1244,140,1326713820,14,15,14,1326718440,4620,1046700,1300140,253440,26_26_26_26_10_10_10_10_10_10_1_1_2_2_3_3_14
1245,122,1326713940,9,3,9,1326722880,8940,365760,861720,495960,10_10_10_10_1_1_10_10_10_10_10_10_1_1_9
1246,108,1326715860,1,2,1,1326715920,60,0,3191940,3191940,1
1247,108,1326715920,1,2,1,1326723840,7920,60,3191940,3191880,1_1
1248,146,1326718200,3,4,3,1326719220,1020,1191000,6670800,5479800,16_16_16_16_16_16_16_1_16_1_16_1_1_16_1_16_16_2_1_1_16_1_2_16_2_2_3_3_3_3_21_21_3_3_3
1249,140,1326718440,14,15,14,1326718440,0,1051320,1300140,248820,26_26_26_26_10_10_10_10_10_10_1_1_2_2_3_3_14_14
1250,140,1326718440,14,15,14,1326721980,3540,1051320,1300140,248820,26_26_26_26_10_10_10_10_10_10_1_1_2_2_3_3_14_14_14
1251,138,1326718800,47,18,2,1326794280,75480,1231200,1785600,554400,10_10_10_10_10_1_10_10_1_10_10_10_10_10_10_1_10_1_9_9_47_47
1252,146,1326719220,3,4,3,1326784020,64800,1192020,6670800,5478780,16_16_16_16_16_16_16_1_16_1_16_1_1_16_1_16_16_2_1_1_16_1_2_16_2_2_3_3_3_3_21_21_3_3_3_3
1253,131,1326719280,2,4,2,1326726180,6900,459180,6825900,6366720,16_16_16_16_16_16_16_16_16_16_16_16_16_16_16_16_16_16_16_16_16_16_16_16_16_16_1_1_1_1_2
1254,76,1326720840,1,2,1,1326722040,1200,1179240,7552500,6373260,3_3_3_3_3_3_3_3_3_18_3_18_18_18_18_18_3_3_3_1_1_3_17_17_17_18_17_17_18_18_18_18_18_17_17_18_3_3_18_17_18_18_17_18_18_17_17_17_5_5_5_5_1_1_17_17_17_2_2_17_17_17_5_5_5_5_5_5_17_17_5_5_5_17_5_5_5_5_5_17_17_17_1_1_1
1255,76,1326720840,1,2,1,1326720840,0,1179240,7552500,6373260,3_3_3_3_3_3_3_3_3_18_3_18_18_18_18_18_3_3_3_1_1_3_17_17_17_18_17_17_18_18_18_18_18_17_17_18_3_3_18_17_18_18_17_18_18_17_17_17_5_5_5_5_1_1_17_17_17_2_2_17_17_17_5_5_5_5_5_5_17_17_5_5_5_17_5_5_5_5_5_17_17_17_1_1
1256,61,1326721380,35,19,35,1326724380,3000,1266180,6225300,4959120,4_4_18_18_34_34_34_3_3_34_3_3_34_35_34_35
1257,140,1326721980,14,15,14,1326775800,53820,1054860,1300140,245280,26_26_26_26_10_10_10_10_10_10_1_1_2_2_3_3_14_14_14_14
1258,76,1326722040,1,2,1,1326722040,0,1180440,7552500,6372060,3_3_3_3_3_3_3_3_3_18_3_18_18_18_18_18_3_3_3_1_1_3_17_17_17_18_17_17_18_18_18_18_18_17_17_18_3_3_18_17_18_18_17_18_18_17_17_17_5_5_5_5_1_1_17_17_17_2_2_17_17_17_5_5_5_5_5_5_17_17_5_5_5_17_5_5_5_5_5_17_17_17_1_1_1_1
1259,76,1326722040,1,2,1,1326722400,360,1180440,7552500,6372060,3_3_3_3_3_3_3_3_3_18_3_18_18_18_18_18_3_3_3_1_1_3_17_17_17_18_17_17_18_18_18_18_18_17_17_18_3_3_18_17_18_18_17_18_18_17_17_17_5_5_5_5_1_1_17_17_17_2_2_17_17_17_5_5_5_5_5_5_17_17_5_5_5_17_5_5_5_5_5_17_17_17_1_1_1_1_1
1260,72,1326722280,24,8,24,1326723720,1440,539040,2385960,1846920,17_17_17_1_17_1_17_1_1_17_17_17_17_1_1_17_17_17_38_38_17_17_1_24_24_24_24_1_24_1_1_24
1261,76,1326722400,1,2,1,1326722400,0,1180800,7552500,6371700,3_3_3_3_3_3_3_3_3_18_3_18_18_18_18_18_3_3_3_1_1_3_17_17_17_18_17_17_18_18_18_18_18_17_17_18_3_3_18_17_18_18_17_18_18_17_17_17_5_5_5_5_1_1_17_17_17_2_2_17_17_17_5_5_5_5_5_5_17_17_5_5_5_17_5_5_5_5_5_17_17_17_1_1_1_1_1_1
1262,76,1326722400,1,2,1,1326723000,600,1180800,7552500,6371700,3_3_3_3_3_3_3_3_3_18_3_18_18_18_18_18_3_3_3_1_1_3_17_17_17_18_17_17_18_18_18_18_18_17_17_18_3_3_18_17_18_18_17_18_18_17_17_17_5_5_5_5_1_1_17_17_17_2_2_17_17_17_5_5_5_5_5_5_17_17_5_5_5_17_5_5_5_5_5_17_17_17_1_1_1_1_1_1_1
1263,122,1326722880,3,3,3,1326727320,4440,374700,861720,487020,10_10_10_10_1_1_10_10_10_10_10_10_1_1_9_9_3
1264,122,1326722880,9,3,3,1326722880,0,374700,861720,487020,10_10_10_10_1_1_10_10_10_10_10_10_1_1_9_9
1265,79,1326722940,10,13,10,1326778620,55680,1094940,4151700,3056760,15_1_15_1_26_26_26_26_26_26_26_26_26_26_26_26_26_26_26_26_8_8_1_1_10_10
1266,76,1326723000,1,2,2,1326781080,58080,1181400,7552500,6371100,3_3_3_3_3_3_3_3_3_18_3_18_18_18_18_18_3_3_3_1_1_3_17_17_17_18_17_17_18_18_18_18_18_17_17_18_3_3_18_17_18_18_17_18_18_17_17_17_5_5_5_5_1_1_17_17_17_2_2_17_17_17_5_5_5_5_5_5_17_17_5_5_5_17_5_5_5_5_5_17_17_17_1_1_1_1_1_1_1_1
1267,130,1326723660,26,16,26,1326729060,5400,0,3083940,3083940,26
1268,12,1326723720,17,12,17,1326730080,6360,80280,850020,769740,17_17_17_1_17_17_1_17
1269,72,1326723720,24,12,24,1326728880,5160,540480,2385960,1845480,17_17_17_1_17_1_17_1_1_17_17_17_17_1_1_17_17_17_38_38_17_17_1_24_24_24_24_1_24_1_1_24_24
1270,108,1326723840,1,2,17,1326725880,2040,7980,3191940,3183960,1_1_1
1271,77,1326723960,0,20,0,1326726300,2340,115800,3257040,3141240,0_0_1_0_0_1_0_0_0_0_0_0_0_0
1272,61,1326724380,35,23,35,1326750000,25620,1269180,6225300,4956120,4_4_18_18_34_34_34_3_3_34_3_3_34_35_34_35_35
1273,117,1326724740,19,14,1,1326782280,57540,50460,1144740,1094280,19_19_19_1_19_19_1_19
1274,108,1326725880,17,10,1,1326729600,3720,10020,3191940,3181920,1_1_1_17
1275,131,1326726180,2,4,3,1329129480,2403300,466080,6825900,6359820,16_16_16_16_16_16_16_16_16_16_16_16_16_16_16_16_16_16_16_16_16_16_16_16_16_16_1_1_1_1_2_2
1276,77,1326726300,0,14,0,1326729120,2820,118140,3257040,3138900,0_0_1_0_0_1_0_0_0_0_0_0_0_0_0
1277,122,1326727320,3,3,14,1326797280,69960,379140,861720,482580,10_10_10_10_1_1_10_10_10_10_10_10_1_1_9_9_3_3
1278,72,1326728880,24,12,24,1326728940,60,545640,2385960,1840320,17_17_17_1_17_1_17_1_1_17_17_17_17_1_1_17_17_17_38_38_17_17_1_24_24_24_24_1_24_1_1_24_24_24
1279,72,1326728940,24,12,24,1326729000,60,545700,2385960,1840260,17_17_17_1_17_1_17_1_1_17_17_17_17_1_1_17_17_17_38_38_17_17_1_24_24_24_24_1_24_1_1_24_24_24_24
1280,72,1326729000,24,12,8,1326776400,47400,545760,2385960,1840200,17_17_17_1_17_1_17_1_1_17_17_17_17_1_1_17_17_17_38_38_17_17_1_24_24_24_24_1_24_1_1_24_24_24_24_24
1281,130,1326729060,26,16,26,1326737460,8400,5400,3083940,3078540,26_26
1282,77,1326729120,0,14,0,1326737640,8520,120960,3257040,3136080,0_0_1_0_0_1_0_0_0_0_0_0_0_0_0_0
1283,108,1326729600,1,2,17,1326730080,480,13740,3191940,3178200,1_1_1_17_1
1284,12,1326730080,17,10,17,1326749880,19800,86640,850020,763380,17_17_17_1_17_17_1_17_17
1285,108,1326730080,17,10,17,1326910080,180000,14220,3191940,3177720,1_1_1_17_1_17
1286,66,1326734880,4,23,4,1326741600,6720,1254480,4817700,3563220,3_3_4_4_4_4_4_4_4_4_4_4_4_4_4_4_4_4_4_4_4_3_3_4_4_4_4_4_4
1287,130,1326737460,26,0,26,1326758640,21180,13800,3083940,3070140,26_26_26
1288,105,1326737640,13,17,13,1326750600,12960,1170780,1314480,143700,1_16_1_2_16_2_3_3_13_13_13_13_13_13_3_3_14_14_14_14_14_14_13_13_13_13_13_13_13_13_13
1289,77,1326737640,0,11,0,1326775740,38100,129480,3257040,3127560,0_0_1_0_0_1_0_0_0_0_0_0_0_0_0_0_0
1290,132,1326737760,19,11,19,1326751200,13440,0,1658640,1658640,19
1291,66,1326741600,4,23,4,1326741660,60,1261200,4817700,3556500,3_3_4_4_4_4_4_4_4_4_4_4_4_4_4_4_4_4_4_4_4_3_3_4_4_4_4_4_4_4
1292,66,1326741660,4,23,4,1326750000,8340,1261260,4817700,3556440,3_3_4_4_4_4_4_4_4_4_4_4_4_4_4_4_4_4_4_4_4_3_3_4_4_4_4_4_4_4_4
1293,12,1326749880,17,10,17,1326749940,60,106440,850020,743580,17_17_17_1_17_17_1_17_17_17
1294,12,1326749940,17,0,17,1326775020,25080,106500,850020,743520,17_17_17_1_17_17_1_17_17_17_17
1295,66,1326750000,4,23,5,1326960660,210660,1269600,4817700,3548100,3_3_4_4_4_4_4_4_4_4_4_4_4_4_4_4_4_4_4_4_4_3_3_4_4_4_4_4_4_4_4_4
1296,61,1326750000,35,23,36,1326750720,720,1294800,6225300,4930500,4_4_18_18_34_34_34_3_3_34_3_3_34_35_34_35_35_35
1297,105,1326750600,13,17,5,1326798000,47400,1183740,1314480,130740,1_16_1_2_16_2_3_3_13_13_13_13_13_13_3_3_14_14_14_14_14_14_13_13_13_13_13_13_13_13_13_13
1298,61,1326750720,36,17,36,1326775020,24300,1295520,6225300,4929780,4_4_18_18_34_34_34_3_3_34_3_3_34_35_34_35_35_35_36
1299,91,1326751200,6,7,6,1326754800,3600,996000,1030200,34200,10_10_10_10_10_10_1_1_1_1_2_2_3_3_3_2_3_2_5_5_6
1300,132,1326751200,19,11,19,1326751260,60,13440,1658640,1645200,19_19
1301,115,1326751200,19,20,19,1326755700,4500,86400,954000,867600,19_19_19
1302,93,1326751200,6,7,6,1326754800,3600,1152300,1242300,90000,3_3_3_3_18_18_18_18_18_18_18_18_18_18_5_5_5_5_6
1303,132,1326751260,19,11,19,1326757800,6540,13500,1658640,1645140,19_19_19
1304,93,1326754800,6,7,6,1326837600,82800,1155900,1242300,86400,3_3_3_3_18_18_18_18_18_18_18_18_18_18_5_5_5_5_6_6
1305,91,1326754800,6,7,5,1326780900,26100,999600,1030200,30600,10_10_10_10_10_10_1_1_1_1_2_2_3_3_3_2_3_2_5_5_6_6
1306,115,1326755700,19,20,19,1327255380,499680,90900,954000,863100,19_19_19_19
1307,132,1326757800,19,11,19,1326792360,34560,20040,1658640,1638600,19_19_19_19
1308,130,1326758640,26,0,26,1326758640,0,34980,3083940,3048960,26_26_26_26
1309,130,1326758640,26,11,26,1326774060,15420,34980,3083940,3048960,26_26_26_26_26
1310,130,1326774060,26,11,8,1326789000,14940,50400,3083940,3033540,26_26_26_26_26_26
1311,61,1326775020,36,17,35,1326775980,960,1319820,6225300,4905480,4_4_18_18_34_34_34_3_3_34_3_3_34_35_34_35_35_35_36_36
1312,12,1326775020,17,0,17,1326789960,14940,131580,850020,718440,17_17_17_1_17_17_1_17_17_17_17_17
1313,77,1326775740,0,11,1,1326806760,31020,167580,3257040,3089460,0_0_1_0_0_1_0_0_0_0_0_0_0_0_0_0_0_0
1314,140,1326775800,14,15,14,1326777480,1680,1108680,1300140,191460,26_26_26_26_10_10_10_10_10_10_1_1_2_2_3_3_14_14_14_14_14
1315,61,1326775980,35,19,35,1326808980,33000,1320780,6225300,4904520,4_4_18_18_34_34_34_3_3_34_3_3_34_35_34_35_35_35_36_36_35
1316,60,1326776400,5,2,5,1326782400,6000,1118400,7401300,6282900,3_3_18_18_18_18_18_18_5
1317,110,1326776400,4,5,4,1326784980,8580,1234800,5579400,4344600,1_1_0_0_1_1_1_1_2_2_2_2_4
1318,72,1326776400,8,18,8,1326782400,6000,593160,2385960,1792800,17_17_17_1_17_1_17_1_1_17_17_17_17_1_1_17_17_17_38_38_17_17_1_24_24_24_24_1_24_1_1_24_24_24_24_24_8
1319,1,1326776460,7,8,8,1326790800,14340,0,1447140,1447140,7
1320,140,1326777480,14,15,14,1326777720,240,1110360,1300140,189780,26_26_26_26_10_10_10_10_10_10_1_1_2_2_3_3_14_14_14_14_14_14
1321,140,1326777720,14,15,14,1326791400,13680,1110600,1300140,189540,26_26_26_26_10_10_10_10_10_10_1_1_2_2_3_3_14_14_14_14_14_14_14
1322,79,1326778620,10,13,10,1326785280,6660,1150620,4151700,3001080,15_1_15_1_26_26_26_26_26_26_26_26_26_26_26_26_26_26_26_26_8_8_1_1_10_10_10
1323,49,1326780000,30,26,30,1326805200,25200,511200,3991980,3480780,29_29_30
1324,91,1326780900,5,9,5,1326785400,4500,1025700,1030200,4500,10_10_10_10_10_10_1_1_1_1_2_2_3_3_3_2_3_2_5_5_6_6_5
1325,76,1326781080,2,3,2,1326785880,4800,1239480,7552500,6313020,3_3_3_3_3_3_3_3_3_18_3_18_18_18_18_18_3_3_3_1_1_3_17_17_17_18_17_17_18_18_18_18_18_17_17_18_3_3_18_17_18_18_17_18_18_17_17_17_5_5_5_5_1_1_17_17_17_2_2_17_17_17_5_5_5_5_5_5_17_17_5_5_5_17_5_5_5_5_5_17_17_17_1_1_1_1_1_1_1_1_2
1326,117,1326782280,1,9,1,1326789840,7560,108000,1144740,1036740,19_19_19_1_19_19_1_19_1
1327,60,1326782400,5,2,5,1326783600,1200,1124400,7401300,6276900,3_3_18_18_18_18_18_18_5_5
1328,72,1326782400,8,18,2,1327325400,543000,599160,2385960,1786800,17_17_17_1_17_1_17_1_1_17_17_17_17_1_1_17_17_17_38_38_17_17_1_24_24_24_24_1_24_1_1_24_24_24_24_24_8_8
1329,60,1326783600,5,2,5,1326797400,13800,1125600,7401300,6275700,3_3_18_18_18_18_18_18_5_5_5
1330,146,1326784020,3,3,21,1326793500,9480,1256820,6670800,5413980,16_16_16_16_16_16_16_1_16_1_16_1_1_16_1_16_16_2_1_1_16_1_2_16_2_2_3_3_3_3_21_21_3_3_3_3_3
1331,110,1326784980,4,5,4,1326785040,60,1243380,5579400,4336020,1_1_0_0_1_1_1_1_2_2_2_2_4_4
1332,110,1326785040,4,5,4,1326808920,23880,1243440,5579400,4335960,1_1_0_0_1_1_1_1_2_2_2_2_4_4_4
1333,79,1326785280,10,13,10,1326787260,1980,1157280,4151700,2994420,15_1_15_1_26_26_26_26_26_26_26_26_26_26_26_26_26_26_26_26_8_8_1_1_10_10_10_10
1334,91,1326785400,5,9,99,1326785400,0,1030200,1030200,0,10_10_10_10_10_10_1_1_1_1_2_2_3_3_3_2_3_2_5_5_6_6_5_5
1335,76,1326785880,2,3,34,1326806040,20160,1244280,7552500,6308220,3_3_3_3_3_3_3_3_3_18_3_18_18_18_18_18_3_3_3_1_1_3_17_17_17_18_17_17_18_18_18_18_18_17_17_18_3_3_18_17_18_18_17_18_18_17_17_17_5_5_5_5_1_1_17_17_17_2_2_17_17_17_5_5_5_5_5_5_17_17_5_5_5_17_5_5_5_5_5_17_17_17_1_1_1_1_1_1_1_1_2_2
1336,142,1326787020,1,9,1,1326788400,1380,1028580,7299960,6271380,0_0_0_0_0_0_0_1_1_0_0_0_0_0_0_0_0_1_1_0_0_0_0_0_0_1_1_0_0_0_0_0_0_1_1_0_0_0_0_0_0_0_1_0_1_0_0_0_1
1337,79,1326787260,10,16,10,1326797700,10440,1159260,4151700,2992440,15_1_15_1_26_26_26_26_26_26_26_26_26_26_26_26_26_26_26_26_8_8_1_1_10_10_10_10_10
1338,142,1326788400,1,9,1,1326791520,3120,1029960,7299960,6270000,0_0_0_0_0_0_0_1_1_0_0_0_0_0_0_0_0_1_1_0_0_0_0_0_0_1_1_0_0_0_0_0_0_1_1_0_0_0_0_0_0_0_1_0_1_0_0_0_1_1
1339,130,1326789000,8,18,8,1326797400,8400,65340,3083940,3018600,26_26_26_26_26_26_8
1340,117,1326789840,1,9,2,1327405080,615240,115560,1144740,1029180,19_19_19_1_19_19_1_19_1_1
1341,12,1326789960,17,12,17,1326794460,4500,146520,850020,703500,17_17_17_1_17_17_1_17_17_17_17_17_17
1342,133,1326790800,17,12,17,1326805200,14400,0,6181200,6181200,17
1343,1,1326790800,8,9,7,1326791100,300,14340,1447140,1432800,7_8
1344,1,1326791100,7,8,8,1326791700,600,14640,1447140,1432500,7_8_7
1345,140,1326791400,14,15,5,1326798000,6600,1124280,1300140,175860,26_26_26_26_10_10_10_10_10_10_1_1_2_2_3_3_14_14_14_14_14_14_14_14
1346,142,1326791520,1,9,1,1326792900,1380,1033080,7299960,6266880,0_0_0_0_0_0_0_1_1_0_0_0_0_0_0_0_0_1_1_0_0_0_0_0_0_1_1_0_0_0_0_0_0_1_1_0_0_0_0_0_0_0_1_0_1_0_0_0_1_1_1
1347,1,1326791700,8,9,7,1326821040,29340,15240,1447140,1431900,7_8_7_8
1348,67,1326791880,1,9,1,1326792120,240,1292580,3120480,1827900,2_3_3_3_2_3_3_3_1
1349,67,1326792120,1,9,27,1327813200,1021080,1292820,3120480,1827660,2_3_3_3_2_3_3_3_1_1
1350,132,1326792360,19,14,19,1326798780,6420,54600,1658640,1604040,19_19_19_19_19
1351,112,1326792480,1,9,1,1326799980,7500,217920,1303440,1085520,19_19_19_19_19_1_1_19_19_19_1
1352,142,1326792900,1,9,27,1326837600,44700,1034460,7299960,6265500,0_0_0_0_0_0_0_1_1_0_0_0_0_0_0_0_0_1_1_0_0_0_0_0_0_1_1_0_0_0_0_0_0_1_1_0_0_0_0_0_0_0_1_0_1_0_0_0_1_1_1_1
1353,146,1326793500,21,4,3,1326799620,6120,1266300,6670800,5404500,16_16_16_16_16_16_16_1_16_1_16_1_1_16_1_16_16_2_1_1_16_1_2_16_2_2_3_3_3_3_21_21_3_3_3_3_3_21
1354,138,1326794280,2,3,2,1326795060,780,1306680,1785600,478920,10_10_10_10_10_1_10_10_1_10_10_10_10_10_10_1_10_1_9_9_47_47_2
1355,12,1326794460,17,12,1,1326862800,68340,151020,850020,699000,17_17_17_1_17_17_1_17_17_17_17_17_17_17
1356,138,1326795060,2,3,3,1326797220,2160,1307460,1785600,478140,10_10_10_10_10_1_10_10_1_10_10_10_10_10_10_1_10_1_9_9_47_47_2_2
1357,138,1326797220,3,3,3,1326799620,2400,1309620,1785600,475980,10_10_10_10_10_1_10_10_1_10_10_10_10_10_10_1_10_1_9_9_47_47_2_2_3
1358,122,1326797280,14,15,14,1326799920,2640,449100,861720,412620,10_10_10_10_1_1_10_10_10_10_10_10_1_1_9_9_3_3_14
1359,130,1326797400,8,18,26,1326798000,600,73740,3083940,3010200,26_26_26_26_26_26_8_8
1360,60,1326797400,5,2,5,1326862800,65400,1139400,7401300,6261900,3_3_18_18_18_18_18_18_5_5_5_5
1361,79,1326797700,10,16,41,1326862800,65100,1169700,4151700,2982000,15_1_15_1_26_26_26_26_26_26_26_26_26_26_26_26_26_26_26_26_8_8_1_1_10_10_10_10_10_10
1362,140,1326798000,5,9,5,1326816180,18180,1130880,1300140,169260,26_26_26_26_10_10_10_10_10_10_1_1_2_2_3_3_14_14_14_14_14_14_14_14_5
1363,130,1326798000,26,16,26,1326805200,7200,74340,3083940,3009600,26_26_26_26_26_26_8_8_26
1364,105,1326798000,5,6,5,1326812400,14400,1231140,1314480,83340,1_16_1_2_16_2_3_3_13_13_13_13_13_13_3_3_14_14_14_14_14_14_13_13_13_13_13_13_13_13_13_13_5
1365,132,1326798780,19,14,19,1326863700,64920,61020,1658640,1597620,19_19_19_19_19_19
1366,74,1326799200,1,2,1,1326808740,9540,0,2979600,2979600,1
1367,138,1326799620,3,3,14,1326866940,67320,1312020,1785600,473580,10_10_10_10_10_1_10_10_1_10_10_10_10_10_10_1_10_1_9_9_47_47_2_2_3_3
1368,103,1326799620,2,3,2,1326803100,3480,998640,4719960,3721320,19_19_19_19_19_19_19_1_1_19_19_19_19_1_1_19_19_19_19_19_1_1_2
1369,146,1326799620,3,3,21,1326802560,2940,1272420,6670800,5398380,16_16_16_16_16_16_16_1_16_1_16_1_1_16_1_16_16_2_1_1_16_1_2_16_2_2_3_3_3_3_21_21_3_3_3_3_3_21_3
1370,122,1326799920,14,15,18,1326826740,26820,451740,861720,409980,10_10_10_10_1_1_10_10_10_10_10_10_1_1_9_9_3_3_14_14
1371,112,1326799980,1,9,47,1327322760,522780,225420,1303440,1078020,19_19_19_19_19_1_1_19_19_19_1_1
1372,33,1326800820,24,8,24,1326806220,5400,0,78900,78900,24
1373,146,1326802560,21,4,3,1326837600,35040,1275360,6670800,5395440,16_16_16_16_16_16_16_1_16_1_16_1_1_16_1_16_16_2_1_1_16_1_2_16_2_2_3_3_3_3_21_21_3_3_3_3_3_21_3_21
1374,103,1326803100,9,3,2,1326805320,2220,1002120,4719960,3717840,19_19_19_19_19_19_19_1_1_19_19_19_19_1_1_19_19_19_19_19_1_1_2_2_9
1375,103,1326803100,2,3,9,1326803100,0,1002120,4719960,3717840,19_19_19_19_19_19_19_1_1_19_19_19_19_1_1_19_19_19_19_19_1_1_2_2
1376,130,1326805200,26,16,26,1326811680,6480,81540,3083940,3002400,26_26_26_26_26_26_8_8_26_26
1377,133,1326805200,17,12,17,1326808500,3300,14400,6181200,6166800,17_17_17
1378,133,1326805200,17,12,17,1326805200,0,14400,6181200,6166800,17_17
1379,49,1326805200,30,26,5,1330207200,3402000,536400,3991980,3455580,29_29_30_30
1380,103,1326805320,2,4,2,1326808380,3060,1004340,4719960,3715620,19_19_19_19_19_19_19_1_1_19_19_19_19_1_1_19_19_19_19_19_1_1_2_2_9_2
1381,76,1326806040,34,15,34,1326808020,1980,1264440,7552500,6288060,3_3_3_3_3_3_3_3_3_18_3_18_18_18_18_18_3_3_3_1_1_3_17_17_17_18_17_17_18_18_18_18_18_17_17_18_3_3_18_17_18_18_17_18_18_17_17_17_5_5_5_5_1_1_17_17_17_2_2_17_17_17_5_5_5_5_5_5_17_17_5_5_5_17_5_5_5_5_5_17_17_17_1_1_1_1_1_1_1_1_2_2_34
1382,33,1326806220,24,8,24,1326807060,840,5400,78900,73500,24_24
1383,77,1326806760,1,9,0,1326808200,1440,198600,3257040,3058440,0_0_1_0_0_1_0_0_0_0_0_0_0_0_0_0_0_0_1
1384,33,1326807060,24,8,24,1326808560,1500,6240,78900,72660,24_24_24
1385,76,1326808020,34,15,5,1326949200,141180,1266420,7552500,6286080,3_3_3_3_3_3_3_3_3_18_3_18_18_18_18_18_3_3_3_1_1_3_17_17_17_18_17_17_18_18_18_18_18_17_17_18_3_3_18_17_18_18_17_18_18_17_17_17_5_5_5_5_1_1_17_17_17_2_2_17_17_17_5_5_5_5_5_5_17_17_5_5_5_17_5_5_5_5_5_17_17_17_1_1_1_1_1_1_1_1_2_2_34_34
1386,77,1326808200,0,1,1,1326808380,180,200040,3257040,3057000,0_0_1_0_0_1_0_0_0_0_0_0_0_0_0_0_0_0_1_0
1387,103,1326808380,2,4,9,1326811500,3120,1007400,4719960,3712560,19_19_19_19_19_19_19_1_1_19_19_19_19_1_1_19_19_19_19_19_1_1_2_2_9_2_2
1388,77,1326808380,1,9,0,1326819000,10620,200220,3257040,3056820,0_0_1_0_0_1_0_0_0_0_0_0_0_0_0_0_0_0_1_0_1
1389,133,1326808500,17,12,17,1326810720,2220,17700,6181200,6163500,17_17_17_17
1390,33,1326808560,24,8,24,1326810180,1620,7740,78900,71160,24_24_24_24
1391,74,1326808740,1,2,34,1329646320,2837580,9540,2979600,2970060,1_1
1392,110,1326808920,4,5,4,1326826440,17520,1267320,5579400,4312080,1_1_0_0_1_1_1_1_2_2_2_2_4_4_4_4
1393,61,1326808980,35,19,35,1326948660,139680,1353780,6225300,4871520,4_4_18_18_34_34_34_3_3_34_3_3_34_35_34_35_35_35_36_36_35_35
1394,33,1326810180,24,10,24,1326820980,10800,9360,78900,69540,24_24_24_24_24
1395,133,1326810720,17,10,17,1326836520,25800,19920,6181200,6161280,17_17_17_17_17
1396,103,1326811500,9,3,9,1327225560,414060,1010520,4719960,3709440,19_19_19_19_19_19_19_1_1_19_19_19_19_1_1_19_19_19_19_19_1_1_2_2_9_2_2_9
1397,130,1326811680,26,13,26,1326816480,4800,88020,3083940,2995920,26_26_26_26_26_26_8_8_26_26_26
1398,105,1326812400,5,6,6,1326837600,25200,1245540,1314480,68940,1_16_1_2_16_2_3_3_13_13_13_13_13_13_3_3_14_14_14_14_14_14_13_13_13_13_13_13_13_13_13_13_5_5
1399,134,1326813420,0,1,0,1326815820,2400,0,3656580,3656580,0
1400,134,1326815820,0,1,0,1326823740,7920,2400,3656580,3654180,0_0
1401,140,1326816180,5,9,5,1326874800,58620,1149060,1300140,151080,26_26_26_26_10_10_10_10_10_10_1_1_2_2_3_3_14_14_14_14_14_14_14_14_5_5
1402,130,1326816480,26,13,26,1326816540,60,92820,3083940,2991120,26_26_26_26_26_26_8_8_26_26_26_26
1403,130,1326816540,26,13,26,1326818400,1860,92880,3083940,2991060,26_26_26_26_26_26_8_8_26_26_26_26_26
1404,130,1326818400,26,13,26,1326818460,60,94740,3083940,2989200,26_26_26_26_26_26_8_8_26_26_26_26_26_26
1405,130,1326818460,26,13,26,1326818700,240,94800,3083940,2989140,26_26_26_26_26_26_8_8_26_26_26_26_26_26_26
1406,130,1326818700,26,13,26,1326823800,5100,95040,3083940,2988900,26_26_26_26_26_26_8_8_26_26_26_26_26_26_26_26
1407,77,1326819000,0,1,2,1327311840,492840,210840,3257040,3046200,0_0_1_0_0_1_0_0_0_0_0_0_0_0_0_0_0_0_1_0_1_0
1408,33,1326820980,24,10,6,1326837600,16620,20160,78900,58740,24_24_24_24_24_24
1409,1,1326821040,7,10,7,1326823260,2220,44580,1447140,1402560,7_8_7_8_7
1410,113,1326823260,16,0,16,1326835440,12180,0,3646740,3646740,16
1411,1,1326823260,7,10,7,1326823260,0,46800,1447140,1400340,7_8_7_8_7_7
1412,1,1326823260,7,10,7,1326836580,13320,46800,1447140,1400340,7_8_7_8_7_7_7
1413,134,1326823740,0,11,0,1326832560,8820,10320,3656580,3646260,0_0_0
1414,130,1326823800,26,11,26,1326861060,37260,100140,3083940,2983800,26_26_26_26_26_26_8_8_26_26_26_26_26_26_26_26_26
1415,110,1326826440,4,17,4,1326860760,34320,1284840,5579400,4294560,1_1_0_0_1_1_1_1_2_2_2_2_4_4_4_4_4
1416,122,1326826740,18,23,18,1326840780,14040,478560,861720,383160,10_10_10_10_1_1_10_10_10_10_10_10_1_1_9_9_3_3_14_14_18
1417,134,1326832560,0,11,0,1326832620,60,19140,3656580,3637440,0_0_0_0
1418,134,1326832620,0,11,0,1326861120,28500,19200,3656580,3637380,0_0_0_0_0
1419,113,1326835440,16,0,16,1326835500,60,12180,3646740,3634560,16_16
1420,113,1326835500,16,0,16,1326852180,16680,12240,3646740,3634500,16_16_16
1421,133,1326836520,17,10,17,1326837000,480,45720,6181200,6135480,17_17_17_17_17_17
1422,1,1326836580,7,10,7,1326836940,360,60120,1447140,1387020,7_8_7_8_7_7_7_7
1423,1,1326836940,7,11,7,1326861120,24180,60480,1447140,1386660,7_8_7_8_7_7_7_7_7
1424,133,1326837000,17,11,17,1326861420,24420,46200,6181200,6135000,17_17_17_17_17_17_17
1425,142,1326837600,27,26,27,1326842100,4500,1079160,7299960,6220800,0_0_0_0_0_0_0_1_1_0_0_0_0_0_0_0_0_1_1_0_0_0_0_0_0_1_1_0_0_0_0_0_0_1_1_0_0_0_0_0_0_0_1_0_1_0_0_0_1_1_1_1_27
1426,146,1326837600,3,4,3,1326842100,4500,1310400,6670800,5360400,16_16_16_16_16_16_16_1_16_1_16_1_1_16_1_16_16_2_1_1_16_1_2_16_2_2_3_3_3_3_21_21_3_3_3_3_3_21_3_21_3
1427,33,1326837600,6,7,6,1326841200,3600,36780,78900,42120,24_24_24_24_24_24_6
1428,93,1326837600,6,7,6,1326841200,3600,1238700,1242300,3600,3_3_3_3_18_18_18_18_18_18_18_18_18_18_5_5_5_5_6_6_6
1429,121,1326837600,6,7,6,1326841200,3600,825900,856140,30240,7_7_7_7_7_7_3_3_1_1_2_2_9_9_3_9_9_3_18_18_18_18_18_18_5_5_6
1430,105,1326837600,6,7,6,1326841200,3600,1270740,1314480,43740,1_16_1_2_16_2_3_3_13_13_13_13_13_13_3_3_14_14_14_14_14_14_13_13_13_13_13_13_13_13_13_13_5_5_6
1431,122,1326840780,18,23,18,1326845220,4440,492600,861720,369120,10_10_10_10_1_1_10_10_10_10_10_10_1_1_9_9_3_3_14_14_18_18_18
1432,122,1326840780,18,23,18,1326840780,0,492600,861720,369120,10_10_10_10_1_1_10_10_10_10_10_10_1_1_9_9_3_3_14_14_18_18
1433,93,1326841200,6,7,99,1326841200,0,1242300,1242300,0,3_3_3_3_18_18_18_18_18_18_18_18_18_18_5_5_5_5_6_6_6_6
1434,105,1326841200,6,7,5,1326881280,40080,1274340,1314480,40140,1_16_1_2_16_2_3_3_13_13_13_13_13_13_3_3_14_14_14_14_14_14_13_13_13_13_13_13_13_13_13_13_5_5_6_6
1435,121,1326841200,6,7,5,1326862800,21600,829500,856140,26640,7_7_7_7_7_7_3_3_1_1_2_2_9_9_3_9_9_3_18_18_18_18_18_18_5_5_6_6
1436,33,1326841200,6,7,8,1326862200,21000,40380,78900,38520,24_24_24_24_24_24_6_6
1437,146,1326842100,3,4,3,1326865200,23100,1314900,6670800,5355900,16_16_16_16_16_16_16_1_16_1_16_1_1_16_1_16_16_2_1_1_16_1_2_16_2_2_3_3_3_3_21_21_3_3_3_3_3_21_3_21_3_3
1438,142,1326842100,27,26,27,1326870000,27900,1083660,7299960,6216300,0_0_0_0_0_0_0_1_1_0_0_0_0_0_0_0_0_1_1_0_0_0_0_0_0_1_1_0_0_0_0_0_0_1_1_0_0_0_0_0_0_0_1_0_1_0_0_0_1_1_1_1_27_27
1439,122,1326845220,18,23,18,1326862980,17760,497040,861720,364680,10_10_10_10_1_1_10_10_10_10_10_10_1_1_9_9_3_3_14_14_18_18_18_18
1440,63,1326851460,16,0,16,1326857460,6000,0,6232860,6232860,16
1441,113,1326852180,16,0,1,1326868560,16380,28920,3646740,3617820,16_16_16_16
1442,63,1326857460,16,0,16,1326857520,60,6000,6232860,6226860,16_16
1443,63,1326857520,16,0,16,1326861540,4020,6060,6232860,6226800,16_16_16
1444,110,1326860760,4,17,4,1326866280,5520,1319160,5579400,4260240,1_1_0_0_1_1_1_1_2_2_2_2_4_4_4_4_4_4
1445,130,1326861060,26,11,26,1326863400,2340,137400,3083940,2946540,26_26_26_26_26_26_8_8_26_26_26_26_26_26_26_26_26_26
1446,1,1326861120,7,11,7,1326862740,1620,84660,1447140,1362480,7_8_7_8_7_7_7_7_7_7
1447,134,1326861120,0,11,0,1326910380,49260,47700,3656580,3608880,0_0_0_0_0_0
1448,133,1326861420,17,11,17,1326863400,1980,70620,6181200,6110580,17_17_17_17_17_17_17_17
1449,63,1326861540,16,0,16,1326862860,1320,10080,6232860,6222780,16_16_16_16
1450,33,1326862200,8,9,8,1326865380,3180,61380,78900,17520,24_24_24_24_24_24_6_6_8
1451,1,1326862740,7,8,7,1326864240,1500,86280,1447140,1360860,7_8_7_8_7_7_7_7_7_7_7
1452,79,1326862800,41,38,1,1326877260,14460,1234800,4151700,2916900,15_1_15_1_26_26_26_26_26_26_26_26_26_26_26_26_26_26_26_26_8_8_1_1_10_10_10_10_10_10_41
1453,60,1326862800,5,2,5,1326866400,3600,1204800,7401300,6196500,3_3_18_18_18_18_18_18_5_5_5_5_5
1454,12,1326862800,1,18,17,1326868500,5700,219360,850020,630660,17_17_17_1_17_17_1_17_17_17_17_17_17_17_1
1455,121,1326862800,5,6,5,1326867840,5040,851100,856140,5040,7_7_7_7_7_7_3_3_1_1_2_2_9_9_3_9_9_3_18_18_18_18_18_18_5_5_6_6_5
1456,63,1326862860,16,20,16,1326869040,6180,11400,6232860,6221460,16_16_16_16_16
1457,122,1326862980,18,19,18,1326895380,32400,514800,861720,346920,10_10_10_10_1_1_10_10_10_10_10_10_1_1_9_9_3_3_14_14_18_18_18_18_18
1458,130,1326863400,26,16,8,1326888000,24600,139740,3083940,2944200,26_26_26_26_26_26_8_8_26_26_26_26_26_26_26_26_26_26_26
1459,133,1326863400,17,12,17,1326868200,4800,72600,6181200,6108600,17_17_17_17_17_17_17_17_17
1460,132,1326863700,19,14,19,1326865260,1560,125940,1658640,1532700,19_19_19_19_19_19_19
1461,1,1326864240,7,8,7,1326897180,32940,87780,1447140,1359360,7_8_7_8_7_7_7_7_7_7_7_7
1462,148,1326864300,7,8,7,1326888900,24600,0,1938900,1938900,7
1463,146,1326865200,3,4,3,1326869040,3840,1338000,6670800,5332800,16_16_16_16_16_16_16_1_16_1_16_1_1_16_1_16_16_2_1_1_16_1_2_16_2_2_3_3_3_3_21_21_3_3_3_3_3_21_3_21_3_3_3
1464,132,1326865260,19,14,19,1326876060,10800,127500,1658640,1531140,19_19_19_19_19_19_19_19
1465,33,1326865380,8,9,2,1326865500,120,64560,78900,14340,24_24_24_24_24_24_6_6_8_8
1466,33,1326865500,2,15,2,1326867900,2400,64680,78900,14220,24_24_24_24_24_24_6_6_8_8_2
1467,110,1326866280,4,5,4,1326873000,6720,1324680,5579400,4254720,1_1_0_0_1_1_1_1_2_2_2_2_4_4_4_4_4_4_4
1468,60,1326866400,5,2,5,1326868800,2400,1208400,7401300,6192900,3_3_18_18_18_18_18_18_5_5_5_5_5_5_5
1469,60,1326866400,5,2,5,1326866400,0,1208400,7401300,6192900,3_3_18_18_18_18_18_18_5_5_5_5_5_5
1470,138,1326866940,14,15,14,1326870000,3060,1379340,1785600,406260,10_10_10_10_10_1_10_10_1_10_10_10_10_10_10_1_10_1_9_9_47_47_2_2_3_3_14
1471,111,1326867480,2,5,2,1326879420,11940,1408680,3974400,2565720,0_0_0_0_0_0_0_0_0_0_0_1_0_1_0_0_0_0_1_0_1_0_0_0_0_0_0_1_1_0_1_1_2
1472,121,1326867840,5,6,99,1326867840,0,856140,856140,0,7_7_7_7_7_7_3_3_1_1_2_2_9_9_3_9_9_3_18_18_18_18_18_18_5_5_6_6_5_5
1473,33,1326867900,2,15,5,1326875220,7320,67080,78900,11820,24_24_24_24_24_24_6_6_8_8_2_2
1474,133,1326868200,17,12,17,1326902760,34560,77400,6181200,6103800,17_17_17_17_17_17_17_17_17_17
1475,12,1326868500,17,12,17,1326868560,60,225060,850020,624960,17_17_17_1_17_17_1_17_17_17_17_17_17_17_1_17
1476,12,1326868560,17,12,1,1326868680,120,225120,850020,624900,17_17_17_1_17_17_1_17_17_17_17_17_17_17_1_17_17
1477,113,1326868560,1,6,1,1326881220,12660,45300,3646740,3601440,16_16_16_16_1
1478,12,1326868680,1,18,17,1326873000,4320,225240,850020,624780,17_17_17_1_17_17_1_17_17_17_17_17_17_17_1_17_17_1
1479,60,1326868800,5,2,34,1329046920,2178120,1210800,7401300,6190500,3_3_18_18_18_18_18_18_5_5_5_5_5_5_5_5
1480,63,1326869040,16,20,16,1326909360,40320,17580,6232860,6215280,16_16_16_16_16_16
1481,146,1326869040,3,4,21,1326877320,8280,1341840,6670800,5328960,16_16_16_16_16_16_16_1_16_1_16_1_1_16_1_16_16_2_1_1_16_1_2_16_2_2_3_3_3_3_21_21_3_3_3_3_3_21_3_21_3_3_3_3
1482,138,1326870000,5,18,14,1326870660,660,1382400,1785600,403200,10_10_10_10_10_1_10_10_1_10_10_10_10_10_10_1_10_1_9_9_47_47_2_2_3_3_14_14_5_5_5
1483,138,1326870000,14,18,5,1326870000,0,1382400,1785600,403200,10_10_10_10_10_1_10_10_1_10_10_10_10_10_10_1_10_1_9_9_47_47_2_2_3_3_14_14
1484,138,1326870000,5,18,5,1326870000,0,1382400,1785600,403200,10_10_10_10_10_1_10_10_1_10_10_10_10_10_10_1_10_1_9_9_47_47_2_2_3_3_14_14_5
1485,138,1326870000,5,18,5,1326870000,0,1382400,1785600,403200,10_10_10_10_10_1_10_10_1_10_10_10_10_10_10_1_10_1_9_9_47_47_2_2_3_3_14_14_5_5
1486,142,1326870000,27,26,27,1326884400,14400,1111560,7299960,6188400,0_0_0_0_0_0_0_1_1_0_0_0_0_0_0_0_0_1_1_0_0_0_0_0_0_1_1_0_0_0_0_0_0_1_1_0_0_0_0_0_0_0_1_0_1_0_0_0_1_1_1_1_27_27_27
1487,138,1326870660,14,15,14,1326870720,60,1383060,1785600,402540,10_10_10_10_10_1_10_10_1_10_10_10_10_10_10_1_10_1_9_9_47_47_2_2_3_3_14_14_5_5_5_14
1488,138,1326870720,14,15,14,1326874500,3780,1383120,1785600,402480,10_10_10_10_10_1_10_10_1_10_10_10_10_10_10_1_10_1_9_9_47_47_2_2_3_3_14_14_5_5_5_14_14
1489,104,1326872520,15,2,15,1326883800,11280,508620,935100,426480,3_3_18_18_18_18_18_18_18_18_15
1490,12,1326873000,17,12,17,1326873360,360,229560,850020,620460,17_17_17_1_17_17_1_17_17_17_17_17_17_17_1_17_17_1_17
1491,110,1326873000,4,5,4,1326902280,29280,1331400,5579400,4248000,1_1_0_0_1_1_1_1_2_2_2_2_4_4_4_4_4_4_4_4
1492,12,1326873360,17,12,17,1326873420,60,229920,850020,620100,17_17_17_1_17_17_1_17_17_17_17_17_17_17_1_17_17_1_17_17
1493,12,1326873420,17,12,1,1326874440,1020,229980,850020,620040,17_17_17_1_17_17_1_17_17_17_17_17_17_17_1_17_17_1_17_17_17
1494,12,1326874440,1,9,1,1326878940,4500,231000,850020,619020,17_17_17_1_17_17_1_17_17_17_17_17_17_17_1_17_17_1_17_17_17_1
1495,138,1326874500,14,18,5,1326883800,9300,1386900,1785600,398700,10_10_10_10_10_1_10_10_1_10_10_10_10_10_10_1_10_1_9_9_47_47_2_2_3_3_14_14_5_5_5_14_14_14
1496,140,1326874800,5,9,5,1326895620,20820,1207680,1300140,92460,26_26_26_26_10_10_10_10_10_10_1_1_2_2_3_3_14_14_14_14_14_14_14_14_5_5_5
1497,33,1326875220,5,9,5,1326879720,4500,74400,78900,4500,24_24_24_24_24_24_6_6_8_8_2_2_5
1498,132,1326876060,19,14,19,1326892260,16200,138300,1658640,1520340,19_19_19_19_19_19_19_19_19
1499,79,1326877260,1,6,1,1326895320,18060,1249260,4151700,2902440,15_1_15_1_26_26_26_26_26_26_26_26_26_26_26_26_26_26_26_26_8_8_1_1_10_10_10_10_10_10_41_1
1500,146,1326877320,21,4,3,1326878220,900,1350120,6670800,5320680,16_16_16_16_16_16_16_1_16_1_16_1_1_16_1_16_16_2_1_1_16_1_2_16_2_2_3_3_3_3_21_21_3_3_3_3_3_21_3_21_3_3_3_3_21
1501,146,1326878220,3,4,21,1326881520,3300,1351020,6670800,5319780,16_16_16_16_16_16_16_1_16_1_16_1_1_16_1_16_16_2_1_1_16_1_2_16_2_2_3_3_3_3_21_21_3_3_3_3_3_21_3_21_3_3_3_3_21_3
1502,12,1326878940,1,9,17,1326893520,14580,235500,850020,614520,17_17_17_1_17_17_1_17_17_17_17_17_17_17_1_17_17_1_17_17_17_1_1
1503,111,1326879420,2,5,4,1327190340,310920,1420620,3974400,2553780,0_0_0_0_0_0_0_0_0_0_0_1_0_1_0_0_0_0_1_0_1_0_0_0_0_0_0_1_1_0_1_1_2_2
1504,33,1326879720,5,9,99,1326879720,0,78900,78900,0,24_24_24_24_24_24_6_6_8_8_2_2_5_5
1505,113,1326881220,1,6,2,1326958320,77100,57960,3646740,3588780,16_16_16_16_1_1
1506,105,1326881280,5,6,5,1326881340,60,1314420,1314480,60,1_16_1_2_16_2_3_3_13_13_13_13_13_13_3_3_14_14_14_14_14_14_13_13_13_13_13_13_13_13_13_13_5_5_6_6_5
1507,105,1326881340,5,6,99,1326881340,0,1314480,1314480,0,1_16_1_2_16_2_3_3_13_13_13_13_13_13_3_3_14_14_14_14_14_14_13_13_13_13_13_13_13_13_13_13_5_5_6_6_5_5
1508,146,1326881520,21,4,3,1326881520,0,1354320,6670800,5316480,16_16_16_16_16_16_16_1_16_1_16_1_1_16_1_16_16_2_1_1_16_1_2_16_2_2_3_3_3_3_21_21_3_3_3_3_3_21_3_21_3_3_3_3_21_3_21
1509,146,1326881520,3,4,18,1326978240,96720,1354320,6670800,5316480,16_16_16_16_16_16_16_1_16_1_16_1_1_16_1_16_16_2_1_1_16_1_2_16_2_2_3_3_3_3_21_21_3_3_3_3_3_21_3_21_3_3_3_3_21_3_21_3
1510,138,1326883800,5,18,14,1326894300,10500,1396200,1785600,389400,10_10_10_10_10_1_10_10_1_10_10_10_10_10_10_1_10_1_9_9_47_47_2_2_3_3_14_14_5_5_5_14_14_14_5
1511,104,1326883800,15,2,15,1326885600,1800,519900,935100,415200,3_3_18_18_18_18_18_18_18_18_15_15
1512,142,1326884400,27,26,1,1326952800,68400,1125960,7299960,6174000,0_0_0_0_0_0_0_1_1_0_0_0_0_0_0_0_0_1_1_0_0_0_0_0_0_1_1_0_0_0_0_0_0_1_1_0_0_0_0_0_0_0_1_0_1_0_0_0_1_1_1_1_27_27_27_27
1513,104,1326885600,15,2,15,1326895680,10080,521700,935100,413400,3_3_18_18_18_18_18_18_18_18_15_15_15
1514,130,1326888000,8,18,26,1326891540,3540,164340,3083940,2919600,26_26_26_26_26_26_8_8_26_26_26_26_26_26_26_26_26_26_26_8
1515,148,1326888900,7,8,7,1326888960,60,24600,1938900,1914300,7_7
1516,148,1326888960,7,8,7,1326895440,6480,24660,1938900,1914240,7_7_7
1517,130,1326891540,26,16,8,1326894600,3060,167880,3083940,2916060,26_26_26_26_26_26_8_8_26_26_26_26_26_26_26_26_26_26_26_8_26
1518,132,1326892260,19,14,19,1326892320,60,154500,1658640,1504140,19_19_19_19_19_19_19_19_19_19
1519,132,1326892320,19,14,19,1326895140,2820,154560,1658640,1504080,19_19_19_19_19_19_19_19_19_19_19
1520,12,1326893520,17,12,7,1326951540,58020,250080,850020,599940,17_17_17_1_17_17_1_17_17_17_17_17_17_17_1_17_17_1_17_17_17_1_1_17
1521,138,1326894300,14,15,5,1326963420,69120,1406700,1785600,378900,10_10_10_10_10_1_10_10_1_10_10_10_10_10_10_1_10_1_9_9_47_47_2_2_3_3_14_14_5_5_5_14_14_14_5_14
1522,130,1326894600,8,18,17,1327903560,1008960,170940,3083940,2913000,26_26_26_26_26_26_8_8_26_26_26_26_26_26_26_26_26_26_26_8_26_8
1523,145,1326895020,10,16,10,1326901860,6840,0,586680,586680,10
1524,132,1326895140,19,14,19,1326910200,15060,157380,1658640,1501260,19_19_19_19_19_19_19_19_19_19_19_19
1525,79,1326895320,1,6,41,1326902400,7080,1267320,4151700,2884380,15_1_15_1_26_26_26_26_26_26_26_26_26_26_26_26_26_26_26_26_8_8_1_1_10_10_10_10_10_10_41_1_1
1526,122,1326895380,18,19,18,1326895560,180,547200,861720,314520,10_10_10_10_1_1_10_10_10_10_10_10_1_1_9_9_3_3_14_14_18_18_18_18_18_18
1527,148,1326895440,7,10,7,1326895680,240,31140,1938900,1907760,7_7_7_7
1528,122,1326895560,18,23,18,1326902220,6660,547380,861720,314340,10_10_10_10_1_1_10_10_10_10_10_10_1_1_9_9_3_3_14_14_18_18_18_18_18_18_18
1529,140,1326895620,5,9,6,1326924000,28380,1228500,1300140,71640,26_26_26_26_10_10_10_10_10_10_1_1_2_2_3_3_14_14_14_14_14_14_14_14_5_5_5_5
1530,148,1326895680,7,10,1,1326948780,53100,31380,1938900,1907520,7_7_7_7_7
1531,104,1326895680,15,2,15,1326956400,60720,531780,935100,403320,3_3_18_18_18_18_18_18_18_18_15_15_15_15
1532,1,1326897180,7,10,7,1326902100,4920,120720,1447140,1326420,7_8_7_8_7_7_7_7_7_7_7_7_7
1533,145,1326901860,10,16,10,1326952800,50940,6840,586680,579840,10_10
1534,1,1326902100,7,10,7,1326902220,120,125640,1447140,1321500,7_8_7_8_7_7_7_7_7_7_7_7_7_7
1535,1,1326902220,7,10,7,1326909840,7620,125760,1447140,1321380,7_8_7_8_7_7_7_7_7_7_7_7_7_7_7
1536,122,1326902220,18,23,18,1326910680,8460,554040,861720,307680,10_10_10_10_1_1_10_10_10_10_10_10_1_1_9_9_3_3_14_14_18_18_18_18_18_18_18_18
1537,110,1326902280,4,23,4,1326916620,14340,1360680,5579400,4218720,1_1_0_0_1_1_1_1_2_2_2_2_4_4_4_4_4_4_4_4_4
1538,79,1326902400,41,38,6,1326924000,21600,1274400,4151700,2877300,15_1_15_1_26_26_26_26_26_26_26_26_26_26_26_26_26_26_26_26_8_8_1_1_10_10_10_10_10_10_41_1_1_41
1539,133,1326902760,17,10,17,1326908880,6120,111960,6181200,6069240,17_17_17_17_17_17_17_17_17_17_17
1540,133,1326908880,17,10,17,1326908940,60,118080,6181200,6063120,17_17_17_17_17_17_17_17_17_17_17_17
1541,133,1326908940,17,10,17,1326909900,960,118140,6181200,6063060,17_17_17_17_17_17_17_17_17_17_17_17_17
1542,63,1326909360,16,0,16,1326910320,960,57900,6232860,6174960,16_16_16_16_16_16_16
1543,1,1326909840,7,10,7,1326910200,360,133380,1447140,1313760,7_8_7_8_7_7_7_7_7_7_7_7_7_7_7_7
1544,133,1326909900,17,10,17,1326910140,240,119100,6181200,6062100,17_17_17_17_17_17_17_17_17_17_17_17_17_17
1545,108,1326910080,17,10,17,1326922200,12120,194220,3191940,2997720,1_1_1_17_1_17_17
1546,133,1326910140,17,11,17,1326947400,37260,119340,6181200,6061860,17_17_17_17_17_17_17_17_17_17_17_17_17_17_17
1547,1,1326910200,7,11,7,1326947340,37140,133740,1447140,1313400,7_8_7_8_7_7_7_7_7_7_7_7_7_7_7_7_7
1548,132,1326910200,19,11,19,1326947340,37140,172440,1658640,1486200,19_19_19_19_19_19_19_19_19_19_19_19_19
1549,63,1326910320,16,0,16,1326910320,0,58860,6232860,6174000,16_16_16_16_16_16_16_16
1550,63,1326910320,16,0,0,1326933060,22740,58860,6232860,6174000,16_16_16_16_16_16_16_16_16
1551,134,1326910380,0,0,0,1326915240,4860,96960,3656580,3559620,0_0_0_0_0_0_0
1552,122,1326910680,18,17,18,1326932520,21840,562500,861720,299220,10_10_10_10_1_1_10_10_10_10_10_10_1_1_9_9_3_3_14_14_18_18_18_18_18_18_18_18_18
1553,134,1326915240,0,0,0,1326933000,17760,101820,3656580,3554760,0_0_0_0_0_0_0_0_0
1554,134,1326915240,0,0,0,1326915240,0,101820,3656580,3554760,0_0_0_0_0_0_0_0
1555,110,1326916620,4,23,4,1326916680,60,1375020,5579400,4204380,1_1_0_0_1_1_1_1_2_2_2_2_4_4_4_4_4_4_4_4_4_4
1556,110,1326916680,4,23,4,1326922980,6300,1375080,5579400,4204320,1_1_0_0_1_1_1_1_2_2_2_2_4_4_4_4_4_4_4_4_4_4_4
1557,108,1326922200,17,10,17,1327295400,373200,206340,3191940,2985600,1_1_1_17_1_17_17_17
1558,110,1326922980,4,23,4,1326932640,9660,1381380,5579400,4198020,1_1_0_0_1_1_1_1_2_2_2_2_4_4_4_4_4_4_4_4_4_4_4_4
1559,140,1326924000,6,30,6,1326927600,3600,1256880,1300140,43260,26_26_26_26_10_10_10_10_10_10_1_1_2_2_3_3_14_14_14_14_14_14_14_14_5_5_5_5_6
1560,79,1326924000,6,30,6,1326927600,3600,1296000,4151700,2855700,15_1_15_1_26_26_26_26_26_26_26_26_26_26_26_26_26_26_26_26_8_8_1_1_10_10_10_10_10_10_41_1_1_41_6
1561,140,1326927600,6,30,5,1326962760,35160,1260480,1300140,39660,26_26_26_26_10_10_10_10_10_10_1_1_2_2_3_3_14_14_14_14_14_14_14_14_5_5_5_5_6_6
1562,79,1326927600,6,30,41,1326949500,21900,1299600,4151700,2852100,15_1_15_1_26_26_26_26_26_26_26_26_26_26_26_26_26_26_26_26_8_8_1_1_10_10_10_10_10_10_41_1_1_41_6_6
1563,122,1326932520,18,17,5,1326949200,16680,584340,861720,277380,10_10_10_10_1_1_10_10_10_10_10_10_1_1_9_9_3_3_14_14_18_18_18_18_18_18_18_18_18_18
1564,110,1326932640,4,17,4,1326947040,14400,1391040,5579400,4188360,1_1_0_0_1_1_1_1_2_2_2_2_4_4_4_4_4_4_4_4_4_4_4_4_4
1565,134,1326933000,0,0,1,1326949680,16680,119580,3656580,3537000,0_0_0_0_0_0_0_0_0_0
1566,63,1326933060,0,0,0,1326943980,10920,81600,6232860,6151260,16_16_16_16_16_16_16_16_16_0
1567,63,1326943980,0,0,16,1326948360,4380,92520,6232860,6140340,16_16_16_16_16_16_16_16_16_0_0
1568,110,1326947040,4,17,4,1326947100,60,1405440,5579400,4173960,1_1_0_0_1_1_1_1_2_2_2_2_4_4_4_4_4_4_4_4_4_4_4_4_4_4
1569,110,1326947100,4,17,4,1326951600,4500,1405500,5579400,4173900,1_1_0_0_1_1_1_1_2_2_2_2_4_4_4_4_4_4_4_4_4_4_4_4_4_4_4
1570,1,1326947340,7,11,7,1326982320,34980,170880,1447140,1276260,7_8_7_8_7_7_7_7_7_7_7_7_7_7_7_7_7_7
1571,132,1326947340,19,11,1,1326948780,1440,209580,1658640,1449060,19_19_19_19_19_19_19_19_19_19_19_19_19_19
1572,133,1326947400,17,11,17,1326993780,46380,156600,6181200,6024600,17_17_17_17_17_17_17_17_17_17_17_17_17_17_17_17
1573,63,1326948360,16,0,16,1326950520,2160,96900,6232860,6135960,16_16_16_16_16_16_16_16_16_0_0_16
1574,61,1326948660,35,19,35,1326963120,14460,1493460,6225300,4731840,4_4_18_18_34_34_34_3_3_34_3_3_34_35_34_35_35_35_36_36_35_35_35
1575,148,1326948780,1,9,7,1326949620,840,84480,1938900,1854420,7_7_7_7_7_1
1576,132,1326948780,1,9,1,1326958500,9720,211020,1658640,1447620,19_19_19_19_19_19_19_19_19_19_19_19_19_19_1
1577,82,1326949080,14,15,14,1326954720,5640,921360,2195880,1274520,1_1_2_2_3_3_14
1578,76,1326949200,5,2,5,1326955200,6000,1407600,7552500,6144900,3_3_3_3_3_3_3_3_3_18_3_18_18_18_18_18_3_3_3_1_1_3_17_17_17_18_17_17_18_18_18_18_18_17_17_18_3_3_18_17_18_18_17_18_18_17_17_17_5_5_5_5_1_1_17_17_17_2_2_17_17_17_5_5_5_5_5_5_17_17_5_5_5_17_5_5_5_5_5_17_17_17_1_1_1_1_1_1_1_1_2_2_34_34_5
1579,122,1326949200,5,18,2,1326951540,2340,601020,861720,260700,10_10_10_10_1_1_10_10_10_10_10_10_1_1_9_9_3_3_14_14_18_18_18_18_18_18_18_18_18_18_5
1580,79,1326949500,41,38,41,1326979860,30360,1321500,4151700,2830200,15_1_15_1_26_26_26_26_26_26_26_26_26_26_26_26_26_26_26_26_8_8_1_1_10_10_10_10_10_10_41_1_1_41_6_6_41
1581,119,1326949620,7,8,7,1326979320,29700,0,2742780,2742780,7
1582,148,1326949620,7,8,1,1326953040,3420,85320,1938900,1853580,7_7_7_7_7_1_7
1583,135,1326949620,19,14,19,1326978840,29220,875220,5649480,4774260,19_19_19
1584,134,1326949680,1,6,1,1326960480,10800,136260,3656580,3520320,0_0_0_0_0_0_0_0_0_0_1
1585,63,1326950520,16,20,0,1326952680,2160,99060,6232860,6133800,16_16_16_16_16_16_16_16_16_0_0_16_16
1586,12,1326951540,7,12,7,1326956400,4860,308100,850020,541920,17_17_17_1_17_17_1_17_17_17_17_17_17_17_1_17_17_1_17_17_17_1_1_17_7
1587,122,1326951540,2,15,2,1326951600,60,603360,861720,258360,10_10_10_10_1_1_10_10_10_10_10_10_1_1_9_9_3_3_14_14_18_18_18_18_18_18_18_18_18_18_5_2
1588,122,1326951600,2,15,2,1326954660,3060,603420,861720,258300,10_10_10_10_1_1_10_10_10_10_10_10_1_1_9_9_3_3_14_14_18_18_18_18_18_18_18_18_18_18_5_2_2_2
1589,110,1326951600,4,17,4,1326951720,120,1410000,5579400,4169400,1_1_0_0_1_1_1_1_2_2_2_2_4_4_4_4_4_4_4_4_4_4_4_4_4_4_4_4
1590,122,1326951600,2,15,2,1326951600,0,603420,861720,258300,10_10_10_10_1_1_10_10_10_10_10_10_1_1_9_9_3_3_14_14_18_18_18_18_18_18_18_18_18_18_5_2_2
1591,110,1326951720,4,5,4,1326967020,15300,1410120,5579400,4169280,1_1_0_0_1_1_1_1_2_2_2_2_4_4_4_4_4_4_4_4_4_4_4_4_4_4_4_4_4
1592,63,1326952680,0,1,16,1326954420,1740,101220,6232860,6131640,16_16_16_16_16_16_16_16_16_0_0_16_16_0
1593,142,1326952800,27,26,27,1326953460,660,1194360,7299960,6105600,0_0_0_0_0_0_0_1_1_0_0_0_0_0_0_0_0_1_1_0_0_0_0_0_0_1_1_0_0_0_0_0_0_1_1_0_0_0_0_0_0_0_1_0_1_0_0_0_1_1_1_1_27_27_27_27_1_27
1594,142,1326952800,1,9,27,1326952800,0,1194360,7299960,6105600,0_0_0_0_0_0_0_1_1_0_0_0_0_0_0_0_0_1_1_0_0_0_0_0_0_1_1_0_0_0_0_0_0_1_1_0_0_0_0_0_0_0_1_0_1_0_0_0_1_1_1_1_27_27_27_27_1
1595,145,1326952800,10,16,10,1326963600,10800,57780,586680,528900,10_10_10
1596,148,1326953040,1,9,9,1327310580,357540,88740,1938900,1850160,7_7_7_7_7_1_7_1
1597,142,1326953460,27,26,1,1326985200,31740,1195020,7299960,6104940,0_0_0_0_0_0_0_1_1_0_0_0_0_0_0_0_0_1_1_0_0_0_0_0_0_1_1_0_0_0_0_0_0_1_1_0_0_0_0_0_0_0_1_0_1_0_0_0_1_1_1_1_27_27_27_27_1_27_27
1598,63,1326954420,16,20,16,1326980520,26100,102960,6232860,6129900,16_16_16_16_16_16_16_16_16_0_0_16_16_0_16
1599,122,1326954660,2,15,5,1326964200,9540,606480,861720,255240,10_10_10_10_1_1_10_10_10_10_10_10_1_1_9_9_3_3_14_14_18_18_18_18_18_18_18_18_18_18_5_2_2_2_2
1600,82,1326954720,14,15,14,1326980880,26160,927000,2195880,1268880,1_1_2_2_3_3_14_14_14
1601,82,1326954720,14,15,14,1326954720,0,927000,2195880,1268880,1_1_2_2_3_3_14_14
1602,123,1326954780,16,20,16,1326968760,13980,0,3545820,3545820,16
1603,76,1326955200,5,2,5,1326960000,4800,1413600,7552500,6138900,3_3_3_3_3_3_3_3_3_18_3_18_18_18_18_18_3_3_3_1_1_3_17_17_17_18_17_17_18_18_18_18_18_17_17_18_3_3_18_17_18_18_17_18_18_17_17_17_5_5_5_5_1_1_17_17_17_2_2_17_17_17_5_5_5_5_5_5_17_17_5_5_5_17_5_5_5_5_5_17_17_17_1_1_1_1_1_1_1_1_2_2_34_34_5_5
1604,104,1326956400,15,2,15,1326958200,1800,592500,935100,342600,3_3_18_18_18_18_18_18_18_18_15_15_15_15_15
1605,12,1326956400,7,12,17,1326956460,60,312960,850020,537060,17_17_17_1_17_17_1_17_17_17_17_17_17_17_1_17_17_1_17_17_17_1_1_17_7_7
1606,12,1326956460,17,12,17,1326981600,25140,313020,850020,537000,17_17_17_1_17_17_1_17_17_17_17_17_17_17_1_17_17_1_17_17_17_1_1_17_7_7_17
1607,104,1326958200,5,2,5,1326960000,1800,594300,935100,340800,3_3_18_18_18_18_18_18_18_18_15_15_15_15_15_15_5
1608,104,1326958200,15,2,5,1326958200,0,594300,935100,340800,3_3_18_18_18_18_18_18_18_18_15_15_15_15_15_15
1609,113,1326958320,2,4,2,1326962820,4500,135060,3646740,3511680,16_16_16_16_1_1_2
1610,132,1326958500,1,9,1,1327035420,76920,220740,1658640,1437900,19_19_19_19_19_19_19_19_19_19_19_19_19_19_1_1
1611,76,1326960000,5,2,5,1326970200,10200,1418400,7552500,6134100,3_3_3_3_3_3_3_3_3_18_3_18_18_18_18_18_3_3_3_1_1_3_17_17_17_18_17_17_18_18_18_18_18_17_17_18_3_3_18_17_18_18_17_18_18_17_17_17_5_5_5_5_1_1_17_17_17_2_2_17_17_17_5_5_5_5_5_5_17_17_5_5_5_17_5_5_5_5_5_17_17_17_1_1_1_1_1_1_1_1_2_2_34_34_5_5_5
1612,104,1326960000,5,2,15,1326972000,12000,596100,935100,339000,3_3_18_18_18_18_18_18_18_18_15_15_15_15_15_15_5_5
1613,134,1326960480,1,6,2,1326966720,6240,147060,3656580,3509520,0_0_0_0_0_0_0_0_0_0_1_1
1614,66,1326960660,5,6,5,1326981720,21060,1480260,4817700,3337440,3_3_4_4_4_4_4_4_4_4_4_4_4_4_4_4_4_4_4_4_4_3_3_4_4_4_4_4_4_4_4_4_5
1615,140,1326962760,5,9,5,1326967260,4500,1295640,1300140,4500,26_26_26_26_10_10_10_10_10_10_1_1_2_2_3_3_14_14_14_14_14_14_14_14_5_5_5_5_6_6_5
1616,113,1326962820,2,4,48,1327327200,364380,139560,3646740,3507180,16_16_16_16_1_1_2_2
1617,61,1326963120,35,19,34,1327043460,80340,1507920,6225300,4717380,4_4_18_18_34_34_34_3_3_34_3_3_34_35_34_35_35_35_36_36_35_35_35_35
1618,138,1326963420,5,18,5,1326980160,16740,1475820,1785600,309780,10_10_10_10_10_1_10_10_1_10_10_10_10_10_10_1_10_1_9_9_47_47_2_2_3_3_14_14_5_5_5_14_14_14_5_14_5
1619,145,1326963600,10,16,10,1326963840,240,68580,586680,518100,10_10_10_10
1620,145,1326963840,10,16,10,1326967740,3900,68820,586680,517860,10_10_10_10_10
1621,122,1326964200,5,18,6,1327183200,219000,616020,861720,245700,10_10_10_10_1_1_10_10_10_10_10_10_1_1_9_9_3_3_14_14_18_18_18_18_18_18_18_18_18_18_5_2_2_2_2_5
1622,134,1326966720,2,15,2,1326971220,4500,153300,3656580,3503280,0_0_0_0_0_0_0_0_0_0_1_1_2
1623,110,1326967020,4,5,4,1326967020,0,1425420,5579400,4153980,1_1_0_0_1_1_1_1_2_2_2_2_4_4_4_4_4_4_4_4_4_4_4_4_4_4_4_4_4_4
1624,110,1326967020,4,5,4,1326987600,20580,1425420,5579400,4153980,1_1_0_0_1_1_1_1_2_2_2_2_4_4_4_4_4_4_4_4_4_4_4_4_4_4_4_4_4_4_4
1625,140,1326967260,5,9,99,1326967260,0,1300140,1300140,0,26_26_26_26_10_10_10_10_10_10_1_1_2_2_3_3_14_14_14_14_14_14_14_14_5_5_5_5_6_6_5_5
1626,145,1326967740,10,16,10,1326967740,0,72720,586680,513960,10_10_10_10_10_10
1627,145,1326967740,10,16,10,1326979440,11700,72720,586680,513960,10_10_10_10_10_10_10
1628,123,1326968760,16,20,16,1326968820,60,13980,3545820,3531840,16_16
1629,123,1326968820,16,20,16,1326980460,11640,14040,3545820,3531780,16_16_16
1630,76,1326970200,5,2,6,1327010400,40200,1428600,7552500,6123900,3_3_3_3_3_3_3_3_3_18_3_18_18_18_18_18_3_3_3_1_1_3_17_17_17_18_17_17_18_18_18_18_18_17_17_18_3_3_18_17_18_18_17_18_18_17_17_17_5_5_5_5_1_1_17_17_17_2_2_17_17_17_5_5_5_5_5_5_17_17_5_5_5_17_5_5_5_5_5_17_17_17_1_1_1_1_1_1_1_1_2_2_34_34_5_5_5_5
1631,134,1326971220,2,15,3,1327213320,242100,157800,3656580,3498780,0_0_0_0_0_0_0_0_0_0_1_1_2_2
1632,104,1326972000,15,2,15,1326982680,10680,608100,935100,327000,3_3_18_18_18_18_18_18_18_18_15_15_15_15_15_15_5_5_15
1633,146,1326978240,18,19,18,1326982200,3960,1451040,6670800,5219760,16_16_16_16_16_16_16_1_16_1_16_1_1_16_1_16_16_2_1_1_16_1_2_16_2_2_3_3_3_3_21_21_3_3_3_3_3_21_3_21_3_3_3_3_21_3_21_3_18
1634,135,1326978840,19,14,19,1326978900,60,904440,5649480,4745040,19_19_19_19
1635,135,1326978900,19,14,19,1326981360,2460,904500,5649480,4744980,19_19_19_19_19
1636,119,1326979320,7,8,7,1326983820,4500,29700,2742780,2713080,7_7
1637,145,1326979440,10,16,10,1327039740,60300,84420,586680,502260,10_10_10_10_10_10_10_10
1638,79,1326979860,41,38,41,1327037100,57240,1351860,4151700,2799840,15_1_15_1_26_26_26_26_26_26_26_26_26_26_26_26_26_26_26_26_8_8_1_1_10_10_10_10_10_10_41_1_1_41_6_6_41_41
1639,138,1326980160,5,18,5,1327209960,229800,1492560,1785600,293040,10_10_10_10_10_1_10_10_1_10_10_10_10_10_10_1_10_1_9_9_47_47_2_2_3_3_14_14_5_5_5_14_14_14_5_14_5_5
1640,123,1326980460,16,20,16,1327400520,420060,25680,3545820,3520140,16_16_16_16
1641,63,1326980520,16,20,0,1326986940,6420,129060,6232860,6103800,16_16_16_16_16_16_16_16_16_0_0_16_16_0_16_16
1642,82,1326980880,14,15,5,1327038840,57960,953160,2195880,1242720,1_1_2_2_3_3_14_14_14_14
1643,135,1326981360,19,14,19,1326996600,15240,906960,5649480,4742520,19_19_19_19_19_19
1644,12,1326981600,17,12,17,1326982080,480,338160,850020,511860,17_17_17_1_17_17_1_17_17_17_17_17_17_17_1_17_17_1_17_17_17_1_1_17_7_7_17_17
1645,66,1326981720,5,6,5,1327220040,238320,1501320,4817700,3316380,3_3_4_4_4_4_4_4_4_4_4_4_4_4_4_4_4_4_4_4_4_3_3_4_4_4_4_4_4_4_4_4_5_5
1646,12,1326982080,17,10,17,1326993660,11580,338640,850020,511380,17_17_17_1_17_17_1_17_17_17_17_17_17_17_1_17_17_1_17_17_17_1_1_17_7_7_17_17_17
1647,146,1326982200,18,19,18,1326982380,180,1455000,6670800,5215800,16_16_16_16_16_16_16_1_16_1_16_1_1_16_1_16_16_2_1_1_16_1_2_16_2_2_3_3_3_3_21_21_3_3_3_3_3_21_3_21_3_3_3_3_21_3_21_3_18_18
1648,1,1326982320,7,10,7,1326989340,7020,205860,1447140,1241280,7_8_7_8_7_7_7_7_7_7_7_7_7_7_7_7_7_7_7
1649,146,1326982380,18,23,18,1327000260,17880,1455180,6670800,5215620,16_16_16_16_16_16_16_1_16_1_16_1_1_16_1_16_16_2_1_1_16_1_2_16_2_2_3_3_3_3_21_21_3_3_3_3_3_21_3_21_3_3_3_3_21_3_21_3_18_18_18
1650,104,1326982680,15,2,5,1327233600,250920,618780,935100,316320,3_3_18_18_18_18_18_18_18_18_15_15_15_15_15_15_5_5_15_15
1651,97,1326982800,1,2,1,1326984600,1800,292800,294600,1800,1_1_1_1_1
1652,119,1326983820,7,8,1,1326984600,780,34200,2742780,2708580,7_7_7
1653,119,1326984600,1,2,1,1326989040,4440,34980,2742780,2707800,7_7_7_1
1654,97,1326984600,1,2,99,1326984600,0,294600,294600,0,1_1_1_1_1_1
1655,142,1326985200,1,9,27,1327208400,223200,1226760,7299960,6073200,0_0_0_0_0_0_0_1_1_0_0_0_0_0_0_0_0_1_1_0_0_0_0_0_0_1_1_0_0_0_0_0_0_1_1_0_0_0_0_0_0_0_1_0_1_0_0_0_1_1_1_1_27_27_27_27_1_27_27_1
1656,63,1326986940,0,1,16,1326988620,1680,135480,6232860,6097380,16_16_16_16_16_16_16_16_16_0_0_16_16_0_16_16_0
1657,110,1326987600,4,5,4,1326987720,120,1446000,5579400,4133400,1_1_0_0_1_1_1_1_2_2_2_2_4_4_4_4_4_4_4_4_4_4_4_4_4_4_4_4_4_4_4_4
1658,110,1326987720,4,23,4,1326992340,4620,1446120,5579400,4133280,1_1_0_0_1_1_1_1_2_2_2_2_4_4_4_4_4_4_4_4_4_4_4_4_4_4_4_4_4_4_4_4_4
1659,63,1326988620,16,20,16,1326995880,7260,137160,6232860,6095700,16_16_16_16_16_16_16_16_16_0_0_16_16_0_16_16_0_16
1660,119,1326989040,1,2,7,1327035420,46380,39420,2742780,2703360,7_7_7_1_1
1661,1,1326989340,7,10,7,1326989400,60,212880,1447140,1234260,7_8_7_8_7_7_7_7_7_7_7_7_7_7_7_7_7_7_7_7
1662,1,1326989400,7,10,7,1326996480,7080,212940,1447140,1234200,7_8_7_8_7_7_7_7_7_7_7_7_7_7_7_7_7_7_7_7_7
1663,110,1326992340,4,23,4,1326997020,4680,1450740,5579400,4128660,1_1_0_0_1_1_1_1_2_2_2_2_4_4_4_4_4_4_4_4_4_4_4_4_4_4_4_4_4_4_4_4_4_4
1664,12,1326993660,17,10,2,1327237260,243600,350220,850020,499800,17_17_17_1_17_17_1_17_17_17_17_17_17_17_1_17_17_1_17_17_17_1_1_17_7_7_17_17_17_17
1665,133,1326993780,17,10,17,1327001100,7320,202980,6181200,5978220,17_17_17_17_17_17_17_17_17_17_17_17_17_17_17_17_17
1666,63,1326995880,16,0,0,1326995880,0,144420,6232860,6088440,16_16_16_16_16_16_16_16_16_0_0_16_16_0_16_16_0_16_16
1667,63,1326995880,0,0,0,1326995940,60,144420,6232860,6088440,16_16_16_16_16_16_16_16_16_0_0_16_16_0_16_16_0_16_16_0
1668,63,1326995940,16,0,16,1327035240,39300,144480,6232860,6088380,16_16_16_16_16_16_16_16_16_0_0_16_16_0_16_16_0_16_16_0_0_16
1669,63,1326995940,0,0,16,1326995940,0,144480,6232860,6088380,16_16_16_16_16_16_16_16_16_0_0_16_16_0_16_16_0_16_16_0_0
1670,1,1326996480,7,10,7,1326996540,60,220020,1447140,1227120,7_8_7_8_7_7_7_7_7_7_7_7_7_7_7_7_7_7_7_7_7_7
1671,1,1326996540,7,11,7,1327029000,32460,220080,1447140,1227060,7_8_7_8_7_7_7_7_7_7_7_7_7_7_7_7_7_7_7_7_7_7_7
1672,135,1326996600,19,11,19,1327000500,3900,922200,5649480,4727280,19_19_19_19_19_19_19
1673,110,1326997020,4,17,4,1327008300,11280,1455420,5579400,4123980,1_1_0_0_1_1_1_1_2_2_2_2_4_4_4_4_4_4_4_4_4_4_4_4_4_4_4_4_4_4_4_4_4_4_4
1674,146,1327000260,18,23,18,1327000260,0,1473060,6670800,5197740,16_16_16_16_16_16_16_1_16_1_16_1_1_16_1_16_16_2_1_1_16_1_2_16_2_2_3_3_3_3_21_21_3_3_3_3_3_21_3_21_3_3_3_3_21_3_21_3_18_18_18_18
1675,146,1327000260,18,23,18,1327009200,8940,1473060,6670800,5197740,16_16_16_16_16_16_16_1_16_1_16_1_1_16_1_16_16_2_1_1_16_1_2_16_2_2_3_3_3_3_21_21_3_3_3_3_3_21_3_21_3_3_3_3_21_3_21_3_18_18_18_18_18
1676,135,1327000500,19,11,19,1327143780,143280,926100,5649480,4723380,19_19_19_19_19_19_19_19
1677,133,1327001100,17,10,17,1327001160,60,210300,6181200,5970900,17_17_17_17_17_17_17_17_17_17_17_17_17_17_17_17_17_17
1678,133,1327001160,17,11,17,1327034880,33720,210360,6181200,5970840,17_17_17_17_17_17_17_17_17_17_17_17_17_17_17_17_17_17_17
1679,110,1327008300,4,17,4,1327035240,26940,1466700,5579400,4112700,1_1_0_0_1_1_1_1_2_2_2_2_4_4_4_4_4_4_4_4_4_4_4_4_4_4_4_4_4_4_4_4_4_4_4_4
1680,146,1327009200,18,23,3,1329817500,2808300,1482000,6670800,5188800,16_16_16_16_16_16_16_1_16_1_16_1_1_16_1_16_16_2_1_1_16_1_2_16_2_2_3_3_3_3_21_21_3_3_3_3_3_21_3_21_3_3_3_3_21_3_21_3_18_18_18_18_18_18
1681,76,1327010400,6,24,6,1327014000,3600,1468800,7552500,6083700,3_3_3_3_3_3_3_3_3_18_3_18_18_18_18_18_3_3_3_1_1_3_17_17_17_18_17_17_18_18_18_18_18_17_17_18_3_3_18_17_18_18_17_18_18_17_17_17_5_5_5_5_1_1_17_17_17_2_2_17_17_17_5_5_5_5_5_5_17_17_5_5_5_17_5_5_5_5_5_17_17_17_1_1_1_1_1_1_1_1_2_2_34_34_5_5_5_5_6
1682,98,1327010400,3,4,3,1327014900,4500,1270980,7319880,6048900,34_34_2_2_35_35_34_34_2_2_3
1683,76,1327014000,6,24,3,1330265700,3251700,1472400,7552500,6080100,3_3_3_3_3_3_3_3_3_18_3_18_18_18_18_18_3_3_3_1_1_3_17_17_17_18_17_17_18_18_18_18_18_17_17_18_3_3_18_17_18_18_17_18_18_17_17_17_5_5_5_5_1_1_17_17_17_2_2_17_17_17_5_5_5_5_5_5_17_17_5_5_5_17_5_5_5_5_5_17_17_17_1_1_1_1_1_1_1_1_2_2_34_34_5_5_5_5_6_6
1684,98,1327014900,3,4,3,1327036020,21120,1275480,7319880,6044400,34_34_2_2_35_35_34_34_2_2_3_3
1685,1,1327029000,7,11,7,1327192920,163920,252540,1447140,1194600,7_8_7_8_7_7_7_7_7_7_7_7_7_7_7_7_7_7_7_7_7_7_7_7
1686,133,1327034880,17,11,17,1327035480,600,244080,6181200,5937120,17_17_17_17_17_17_17_17_17_17_17_17_17_17_17_17_17_17_17_17
1687,63,1327035240,16,0,16,1327035240,0,183780,6232860,6049080,16_16_16_16_16_16_16_16_16_0_0_16_16_0_16_16_0_16_16_0_0_16_16
1688,63,1327035240,16,0,0,1327044120,8880,183780,6232860,6049080,16_16_16_16_16_16_16_16_16_0_0_16_16_0_16_16_0_16_16_0_0_16_16_16
1689,110,1327035240,4,15,4,1327043460,8220,1493640,5579400,4085760,1_1_0_0_1_1_1_1_2_2_2_2_4_4_4_4_4_4_4_4_4_4_4_4_4_4_4_4_4_4_4_4_4_4_4_4_4
1690,119,1327035420,7,8,7,1327044120,8700,85800,2742780,2656980,7_7_7_1_1_7
1691,132,1327035420,1,9,1,1327037460,2040,297660,1658640,1360980,19_19_19_19_19_19_19_19_19_19_19_19_19_19_1_1_1
1692,133,1327035480,17,8,17,1327044060,8580,244680,6181200,5936520,17_17_17_17_17_17_17_17_17_17_17_17_17_17_17_17_17_17_17_17_17
1693,98,1327036020,3,4,3,1327041660,5640,1296600,7319880,6023280,34_34_2_2_35_35_34_34_2_2_3_3_3
1694,79,1327037100,41,38,41,1327051920,14820,1409100,4151700,2742600,15_1_15_1_26_26_26_26_26_26_26_26_26_26_26_26_26_26_26_26_8_8_1_1_10_10_10_10_10_10_41_1_1_41_6_6_41_41_41
1695,132,1327037460,1,9,2,1327909680,872220,299700,1658640,1358940,19_19_19_19_19_19_19_19_19_19_19_19_19_19_1_1_1_1
1696,82,1327038840,5,9,5,1327056600,17760,1011120,2195880,1184760,1_1_2_2_3_3_14_14_14_14_5
1697,145,1327039740,10,16,10,1327055940,16200,144720,586680,441960,10_10_10_10_10_10_10_10_10
1698,98,1327041660,3,4,3,1327051020,9360,1302240,7319880,6017640,34_34_2_2_35_35_34_34_2_2_3_3_3_3
1699,61,1327043460,34,15,34,1327056840,13380,1588260,6225300,4637040,4_4_18_18_34_34_34_3_3_34_3_3_34_35_34_35_35_35_36_36_35_35_35_35_34
1700,110,1327043460,4,15,4,1327177560,134100,1501860,5579400,4077540,1_1_0_0_1_1_1_1_2_2_2_2_4_4_4_4_4_4_4_4_4_4_4_4_4_4_4_4_4_4_4_4_4_4_4_4_4_4
1701,133,1327044060,17,8,17,1327189560,145500,253260,6181200,5927940,17_17_17_17_17_17_17_17_17_17_17_17_17_17_17_17_17_17_17_17_17_17
1702,119,1327044120,7,8,7,1327050240,6120,94500,2742780,2648280,7_7_7_1_1_7_7
1703,63,1327044120,0,1,0,1327063920,19800,192660,6232860,6040200,16_16_16_16_16_16_16_16_16_0_0_16_16_0_16_16_0_16_16_0_0_16_16_16_0
1704,119,1327050240,7,8,7,1327050300,60,100620,2742780,2642160,7_7_7_1_1_7_7_7
1705,119,1327050300,7,8,7,1327055280,4980,100680,2742780,2642100,7_7_7_1_1_7_7_7_7
1706,98,1327051020,3,4,3,1327056000,4980,1311600,7319880,6008280,34_34_2_2_35_35_34_34_2_2_3_3_3_3_3
1707,79,1327051920,41,38,18,1327183200,131280,1423920,4151700,2727780,15_1_15_1_26_26_26_26_26_26_26_26_26_26_26_26_26_26_26_26_8_8_1_1_10_10_10_10_10_10_41_1_1_41_6_6_41_41_41_41
1708,119,1327055280,7,8,7,1327256520,201240,105660,2742780,2637120,7_7_7_1_1_7_7_7_7_7
1709,145,1327055940,10,16,10,1327208280,152340,160920,586680,425760,10_10_10_10_10_10_10_10_10_10
1710,98,1327056000,3,4,18,1327175760,119760,1316580,7319880,6003300,34_34_2_2_35_35_34_34_2_2_3_3_3_3_3_3
1711,82,1327056600,5,9,5,1327208100,151500,1028880,2195880,1167000,1_1_2_2_3_3_14_14_14_14_5_5
1712,61,1327056840,34,15,34,1327327740,270900,1601640,6225300,4623660,4_4_18_18_34_34_34_3_3_34_3_3_34_35_34_35_35_35_36_36_35_35_35_35_34_34
1713,63,1327063920,0,1,16,1327143180,79260,212460,6232860,6020400,16_16_16_16_16_16_16_16_16_0_0_16_16_0_16_16_0_16_16_0_0_16_16_16_0_0
1714,63,1327143180,16,14,0,1327143240,60,291720,6232860,5941140,16_16_16_16_16_16_16_16_16_0_0_16_16_0_16_16_0_16_16_0_0_16_16_16_0_0_16
1715,63,1327143240,0,14,0,1327172100,28860,291780,6232860,5941080,16_16_16_16_16_16_16_16_16_0_0_16_16_0_16_16_0_16_16_0_0_16_16_16_0_0_16_0
1716,135,1327143780,19,14,19,1327172580,28800,1069380,5649480,4580100,19_19_19_19_19_19_19_19_19
1717,63,1327172100,0,14,16,1327182840,10740,320640,6232860,5912220,16_16_16_16_16_16_16_16_16_0_0_16_16_0_16_16_0_16_16_0_0_16_16_16_0_0_16_0_0
1718,135,1327172580,19,14,19,1327181280,8700,1098180,5649480,4551300,19_19_19_19_19_19_19_19_19_19
1719,98,1327175760,18,5,18,1327177500,1740,1436340,7319880,5883540,34_34_2_2_35_35_34_34_2_2_3_3_3_3_3_3_18
1720,98,1327177500,18,5,3,1327183200,5700,1438080,7319880,5881800,34_34_2_2_35_35_34_34_2_2_3_3_3_3_3_3_18_18
1721,110,1327177560,4,5,4,1327190340,12780,1635960,5579400,3943440,1_1_0_0_1_1_1_1_2_2_2_2_4_4_4_4_4_4_4_4_4_4_4_4_4_4_4_4_4_4_4_4_4_4_4_4_4_4_4
1722,135,1327181280,19,12,19,1327206660,25380,1106880,5649480,4542600,19_19_19_19_19_19_19_19_19_19_19
1723,63,1327182840,16,14,0,1327183200,360,331380,6232860,5901480,16_16_16_16_16_16_16_16_16_0_0_16_16_0_16_16_0_16_16_0_0_16_16_16_0_0_16_0_0_16
1724,98,1327183200,3,4,3,1327187700,4500,1443780,7319880,5876100,34_34_2_2_35_35_34_34_2_2_3_3_3_3_3_3_18_18_3
1725,63,1327183200,0,0,16,1327183320,120,331740,6232860,5901120,16_16_16_16_16_16_16_16_16_0_0_16_16_0_16_16_0_16_16_0_0_16_16_16_0_0_16_0_0_16_0
1726,79,1327183200,15,6,18,1327187700,4500,1555200,4151700,2596500,15_1_15_1_26_26_26_26_26_26_26_26_26_26_26_26_26_26_26_26_8_8_1_1_10_10_10_10_10_10_41_1_1_41_6_6_41_41_41_41_18_14_15
1727,122,1327183200,6,24,6,1327186800,3600,835020,861720,26700,10_10_10_10_1_1_10_10_10_10_10_10_1_1_9_9_3_3_14_14_18_18_18_18_18_18_18_18_18_18_5_2_2_2_2_5_6
1728,79,1327183200,14,25,15,1327183200,0,1555200,4151700,2596500,15_1_15_1_26_26_26_26_26_26_26_26_26_26_26_26_26_26_26_26_8_8_1_1_10_10_10_10_10_10_41_1_1_41_6_6_41_41_41_41_18_14
1729,79,1327183200,18,25,14,1327183200,0,1555200,4151700,2596500,15_1_15_1_26_26_26_26_26_26_26_26_26_26_26_26_26_26_26_26_8_8_1_1_10_10_10_10_10_10_41_1_1_41_6_6_41_41_41_41_18
1730,63,1327183320,16,12,0,1327184100,780,331860,6232860,5901000,16_16_16_16_16_16_16_16_16_0_0_16_16_0_16_16_0_16_16_0_0_16_16_16_0_0_16_0_0_16_0_16
1731,63,1327184100,0,12,0,1327187700,3600,332640,6232860,5900220,16_16_16_16_16_16_16_16_16_0_0_16_16_0_16_16_0_16_16_0_0_16_16_16_0_0_16_0_0_16_0_16_0
1732,122,1327186800,6,24,5,1327207800,21000,838620,861720,23100,10_10_10_10_1_1_10_10_10_10_10_10_1_1_9_9_3_3_14_14_18_18_18_18_18_18_18_18_18_18_5_2_2_2_2_5_6_6
1733,98,1327187700,3,4,3,1327217160,29460,1448280,7319880,5871600,34_34_2_2_35_35_34_34_2_2_3_3_3_3_3_3_18_18_3_3
1734,63,1327187700,0,0,0,1327206660,18960,336240,6232860,5896620,16_16_16_16_16_16_16_16_16_0_0_16_16_0_16_16_0_16_16_0_0_16_16_16_0_0_16_0_0_16_0_16_0_0
1735,79,1327187700,18,25,15,1327187700,0,1559700,4151700,2592000,15_1_15_1_26_26_26_26_26_26_26_26_26_26_26_26_26_26_26_26_8_8_1_1_10_10_10_10_10_10_41_1_1_41_6_6_41_41_41_41_18_14_15_18
1736,79,1327187700,15,6,14,1327187700,0,1559700,4151700,2592000,15_1_15_1_26_26_26_26_26_26_26_26_26_26_26_26_26_26_26_26_8_8_1_1_10_10_10_10_10_10_41_1_1_41_6_6_41_41_41_41_18_14_15_18_15
1737,79,1327187700,14,25,1,1327209000,21300,1559700,4151700,2592000,15_1_15_1_26_26_26_26_26_26_26_26_26_26_26_26_26_26_26_26_8_8_1_1_10_10_10_10_10_10_41_1_1_41_6_6_41_41_41_41_18_14_15_18_15_14
1738,133,1327189560,17,12,17,1327206780,17220,398760,6181200,5782440,17_17_17_17_17_17_17_17_17_17_17_17_17_17_17_17_17_17_17_17_17_17_17
1739,110,1327190340,4,5,4,1327737600,547260,1648740,5579400,3930660,1_1_0_0_1_1_1_1_2_2_2_2_4_4_4_4_4_4_4_4_4_4_4_4_4_4_4_4_4_4_4_4_4_4_4_4_4_4_4_4
1740,111,1327190340,4,5,4,1327193400,3060,1731540,3974400,2242860,0_0_0_0_0_0_0_0_0_0_0_1_0_1_0_0_0_0_1_0_1_0_0_0_0_0_0_1_1_0_1_1_2_2_4
1741,1,1327192920,7,12,7,1327206840,13920,416460,1447140,1030680,7_8_7_8_7_7_7_7_7_7_7_7_7_7_7_7_7_7_7_7_7_7_7_7_7
1742,111,1327193400,4,5,4,1327193400,0,1734600,3974400,2239800,0_0_0_0_0_0_0_0_0_0_0_1_0_1_0_0_0_0_1_0_1_0_0_0_0_0_0_1_1_0_1_1_2_2_4_4
1743,111,1327193400,4,5,4,1327207980,14580,1734600,3974400,2239800,0_0_0_0_0_0_0_0_0_0_0_1_0_1_0_0_0_0_1_0_1_0_0_0_0_0_0_1_1_0_1_1_2_2_4_4_4
1744,135,1327206660,19,12,1,1327208400,1740,1132260,5649480,4517220,19_19_19_19_19_19_19_19_19_19_19_19
1745,63,1327206660,0,12,16,1327206720,60,355200,6232860,5877660,16_16_16_16_16_16_16_16_16_0_0_16_16_0_16_16_0_16_16_0_0_16_16_16_0_0_16_0_0_16_0_16_0_0_0
1746,63,1327206720,16,12,1,1327208400,1680,355260,6232860,5877600,16_16_16_16_16_16_16_16_16_0_0_16_16_0_16_16_0_16_16_0_0_16_16_16_0_0_16_0_0_16_0_16_0_0_0_16
1747,133,1327206780,17,12,17,1327213800,7020,415980,6181200,5765220,17_17_17_17_17_17_17_17_17_17_17_17_17_17_17_17_17_17_17_17_17_17_17_17
1748,1,1327206840,7,12,7,1327208400,1560,430380,1447140,1016760,7_8_7_8_7_7_7_7_7_7_7_7_7_7_7_7_7_7_7_7_7_7_7_7_7_7
1749,122,1327207800,5,18,5,1327209900,2100,859620,861720,2100,10_10_10_10_1_1_10_10_10_10_10_10_1_1_9_9_3_3_14_14_18_18_18_18_18_18_18_18_18_18_5_2_2_2_2_5_6_6_5
1750,111,1327207980,4,5,4,1327208400,420,1749180,3974400,2225220,0_0_0_0_0_0_0_0_0_0_0_1_0_1_0_0_0_0_1_0_1_0_0_0_0_0_0_1_1_0_1_1_2_2_4_4_4_4
1751,82,1327208100,5,9,5,1327212600,4500,1180380,2195880,1015500,1_1_2_2_3_3_14_14_14_14_5_5_5
1752,145,1327208280,10,16,10,1327208520,240,313260,586680,273420,10_10_10_10_10_10_10_10_10_10_10
1753,63,1327208400,1,2,1,1327214400,6000,356940,6232860,5875920,16_16_16_16_16_16_16_16_16_0_0_16_16_0_16_16_0_16_16_0_0_16_16_16_0_0_16_0_0_16_0_16_0_0_0_16_1
1754,135,1327208400,1,9,19,1327223160,14760,1134000,5649480,4515480,19_19_19_19_19_19_19_19_19_19_19_19_1
1755,142,1327208400,27,27,27,1327237200,28800,1449960,7299960,5850000,0_0_0_0_0_0_0_1_1_0_0_0_0_0_0_0_0_1_1_0_0_0_0_0_0_1_1_0_0_0_0_0_0_1_1_0_0_0_0_0_0_0_1_0_1_0_0_0_1_1_1_1_27_27_27_27_1_27_27_1_27
1756,111,1327208400,4,17,1,1327208760,360,1749600,3974400,2224800,0_0_0_0_0_0_0_0_0_0_0_1_0_1_0_0_0_0_1_0_1_0_0_0_0_0_0_1_1_0_1_1_2_2_4_4_4_4_4
1757,1,1327208400,7,8,7,1327209180,780,431940,1447140,1015200,7_8_7_8_7_7_7_7_7_7_7_7_7_7_7_7_7_7_7_7_7_7_7_7_7_7_7
1758,145,1327208520,10,16,10,1327217820,9300,313500,586680,273180,10_10_10_10_10_10_10_10_10_10_10_10
1759,111,1327208760,1,9,4,1327209000,240,1749960,3974400,2224440,0_0_0_0_0_0_0_0_0_0_0_1_0_1_0_0_0_0_1_0_1_0_0_0_0_0_0_1_1_0_1_1_2_2_4_4_4_4_4_1
1760,79,1327209000,1,6,1,1327212660,3660,1581000,4151700,2570700,15_1_15_1_26_26_26_26_26_26_26_26_26_26_26_26_26_26_26_26_8_8_1_1_10_10_10_10_10_10_41_1_1_41_6_6_41_41_41_41_18_14_15_18_15_14_1
1761,111,1327209000,4,17,4,1327217100,8100,1750200,3974400,2224200,0_0_0_0_0_0_0_0_0_0_0_1_0_1_0_0_0_0_1_0_1_0_0_0_0_0_0_1_1_0_1_1_2_2_4_4_4_4_4_1_4
1762,1,1327209180,7,8,7,1327215720,6540,432720,1447140,1014420,7_8_7_8_7_7_7_7_7_7_7_7_7_7_7_7_7_7_7_7_7_7_7_7_7_7_7_7
1763,56,1327209240,26,8,26,1327209300,60,1149240,6361440,5212200,6_6_5_5_8_8_8_8_26
1764,56,1327209300,26,8,5,1327356000,146700,1149300,6361440,5212140,6_6_5_5_8_8_8_8_26_26
1765,122,1327209900,5,18,99,1327209900,0,861720,861720,0,10_10_10_10_1_1_10_10_10_10_10_10_1_1_9_9_3_3_14_14_18_18_18_18_18_18_18_18_18_18_5_2_2_2_2_5_6_6_5_5
1766,138,1327209960,5,18,5,1327211820,1860,1722360,1785600,63240,10_10_10_10_10_1_10_10_1_10_10_10_10_10_10_1_10_1_9_9_47_47_2_2_3_3_14_14_5_5_5_14_14_14_5_14_5_5_5
1767,138,1327211820,5,18,6,1327269600,57780,1724220,1785600,61380,10_10_10_10_10_1_10_10_1_10_10_10_10_10_10_1_10_1_9_9_47_47_2_2_3_3_14_14_5_5_5_14_14_14_5_14_5_5_5_5
1768,82,1327212600,5,9,6,1327269600,57000,1184880,2195880,1011000,1_1_2_2_3_3_14_14_14_14_5_5_5_5
1769,79,1327212660,1,6,14,1327223880,11220,1584660,4151700,2567040,15_1_15_1_26_26_26_26_26_26_26_26_26_26_26_26_26_26_26_26_8_8_1_1_10_10_10_10_10_10_41_1_1_41_6_6_41_41_41_41_18_14_15_18_15_14_1_1
1770,134,1327213320,3,3,3,1327225500,12180,399900,3656580,3256680,0_0_0_0_0_0_0_0_0_0_1_1_2_2_3
1771,133,1327213800,17,10,17,1327215660,1860,423000,6181200,5758200,17_17_17_17_17_17_17_17_17_17_17_17_17_17_17_17_17_17_17_17_17_17_17_17_17
1772,63,1327214400,1,2,1,1327215600,1200,362940,6232860,5869920,16_16_16_16_16_16_16_16_16_0_0_16_16_0_16_16_0_16_16_0_0_16_16_16_0_0_16_0_0_16_0_16_0_0_0_16_1_1
1773,63,1327215600,1,2,16,1327216080,480,364140,6232860,5868720,16_16_16_16_16_16_16_16_16_0_0_16_16_0_16_16_0_16_16_0_0_16_16_16_0_0_16_0_0_16_0_16_0_0_0_16_1_1_1
1774,133,1327215660,17,10,17,1327215780,120,424860,6181200,5756340,17_17_17_17_17_17_17_17_17_17_17_17_17_17_17_17_17_17_17_17_17_17_17_17_17_17
1775,1,1327215720,7,8,7,1327247220,31500,439260,1447140,1007880,7_8_7_8_7_7_7_7_7_7_7_7_7_7_7_7_7_7_7_7_7_7_7_7_7_7_7_7_7
1776,133,1327215780,17,8,17,1327247220,31440,424980,6181200,5756220,17_17_17_17_17_17_17_17_17_17_17_17_17_17_17_17_17_17_17_17_17_17_17_17_17_17_17
1777,63,1327216080,16,20,16,1327217280,1200,364620,6232860,5868240,16_16_16_16_16_16_16_16_16_0_0_16_16_0_16_16_0_16_16_0_0_16_16_16_0_0_16_0_0_16_0_16_0_0_0_16_1_1_1_16
1778,111,1327217100,4,23,1,1327227180,10080,1758300,3974400,2216100,0_0_0_0_0_0_0_0_0_0_0_1_0_1_0_0_0_0_1_0_1_0_0_0_0_0_0_1_1_0_1_1_2_2_4_4_4_4_4_1_4_4
1779,98,1327217160,3,3,18,1327220040,2880,1477740,7319880,5842140,34_34_2_2_35_35_34_34_2_2_3_3_3_3_3_3_18_18_3_3_3
1780,63,1327217280,16,0,16,1327220880,3600,365820,6232860,5867040,16_16_16_16_16_16_16_16_16_0_0_16_16_0_16_16_0_16_16_0_0_16_16_16_0_0_16_0_0_16_0_16_0_0_0_16_1_1_1_16_16
1781,145,1327217820,10,16,10,1327222920,5100,322800,586680,263880,10_10_10_10_10_10_10_10_10_10_10_10_10
1782,66,1327220040,5,6,5,1327240860,20820,1739640,4817700,3078060,3_3_4_4_4_4_4_4_4_4_4_4_4_4_4_4_4_4_4_4_4_3_3_4_4_4_4_4_4_4_4_4_5_5_5
1783,98,1327220040,18,23,3,1327220460,420,1480620,7319880,5839260,34_34_2_2_35_35_34_34_2_2_3_3_3_3_3_3_18_18_3_3_3_18
1784,98,1327220460,3,3,3,1327231380,10920,1481040,7319880,5838840,34_34_2_2_35_35_34_34_2_2_3_3_3_3_3_3_18_18_3_3_3_18_3
1785,63,1327220880,16,0,0,1327225560,4680,369420,6232860,5863440,16_16_16_16_16_16_16_16_16_0_0_16_16_0_16_16_0_16_16_0_0_16_16_16_0_0_16_0_0_16_0_16_0_0_0_16_1_1_1_16_16_16
1786,145,1327222920,10,16,1,1327233000,10080,327900,586680,258780,10_10_10_10_10_10_10_10_10_10_10_10_10_10
1787,101,1327222980,10,16,8,1327223580,600,0,655020,655020,10
1788,135,1327223160,19,11,1,1327227180,4020,1148760,5649480,4500720,19_19_19_19_19_19_19_19_19_19_19_19_1_19
1789,101,1327223580,8,18,8,1327229400,5820,600,655020,654420,10_8
1790,79,1327223880,14,17,14,1327232280,8400,1595880,4151700,2555820,15_1_15_1_26_26_26_26_26_26_26_26_26_26_26_26_26_26_26_26_8_8_1_1_10_10_10_10_10_10_41_1_1_41_6_6_41_41_41_41_18_14_15_18_15_14_1_1_14
1791,134,1327225500,3,3,13,1327320540,95040,412080,3656580,3244500,0_0_0_0_0_0_0_0_0_0_1_1_2_2_3_3
1792,103,1327225560,9,3,9,1327246020,20460,1424580,4719960,3295380,19_19_19_19_19_19_19_1_1_19_19_19_19_1_1_19_19_19_19_19_1_1_2_2_9_2_2_9_9
1793,63,1327225560,0,0,1,1327229400,3840,374100,6232860,5858760,16_16_16_16_16_16_16_16_16_0_0_16_16_0_16_16_0_16_16_0_0_16_16_16_0_0_16_0_0_16_0_16_0_0_0_16_1_1_1_16_16_16_0
1794,135,1327227180,1,9,19,1327240080,12900,1152780,5649480,4496700,19_19_19_19_19_19_19_19_19_19_19_19_1_19_1
1795,111,1327227180,1,9,4,1327240680,13500,1768380,3974400,2206020,0_0_0_0_0_0_0_0_0_0_0_1_0_1_0_0_0_0_1_0_1_0_0_0_0_0_0_1_1_0_1_1_2_2_4_4_4_4_4_1_4_4_1
1796,63,1327229400,1,2,1,1327231200,1800,377940,6232860,5854920,16_16_16_16_16_16_16_16_16_0_0_16_16_0_16_16_0_16_16_0_0_16_16_16_0_0_16_0_0_16_0_16_0_0_0_16_1_1_1_16_16_16_0_1
1797,101,1327229400,8,18,10,1327248000,18600,6420,655020,648600,10_8_8
1798,63,1327231200,1,2,1,1327236000,4800,379740,6232860,5853120,16_16_16_16_16_16_16_16_16_0_0_16_16_0_16_16_0_16_16_0_0_16_16_16_0_0_16_0_0_16_0_16_0_0_0_16_1_1_1_16_16_16_0_1_1
1799,98,1327231380,3,4,3,1327233420,2040,1491960,7319880,5827920,34_34_2_2_35_35_34_34_2_2_3_3_3_3_3_3_18_18_3_3_3_18_3_3
1800,79,1327232280,14,17,14,1327232340,60,1604280,4151700,2547420,15_1_15_1_26_26_26_26_26_26_26_26_26_26_26_26_26_26_26_26_8_8_1_1_10_10_10_10_10_10_41_1_1_41_6_6_41_41_41_41_18_14_15_18_15_14_1_1_14_14
1801,79,1327232340,14,17,14,1327239840,7500,1604340,4151700,2547360,15_1_15_1_26_26_26_26_26_26_26_26_26_26_26_26_26_26_26_26_8_8_1_1_10_10_10_10_10_10_41_1_1_41_6_6_41_41_41_41_18_14_15_18_15_14_1_1_14_14_14
1802,145,1327233000,1,9,1,1327233060,60,337980,586680,248700,10_10_10_10_10_10_10_10_10_10_10_10_10_10_1
1803,145,1327233060,1,9,3,1327241940,8880,338040,586680,248640,10_10_10_10_10_10_10_10_10_10_10_10_10_10_1_1
1804,98,1327233420,3,4,18,1327236000,2580,1494000,7319880,5825880,34_34_2_2_35_35_34_34_2_2_3_3_3_3_3_3_18_18_3_3_3_18_3_3_3
1805,104,1327233600,5,2,5,1327236000,2400,869700,935100,65400,3_3_18_18_18_18_18_18_18_18_15_15_15_15_15_15_5_5_15_15_5
1806,98,1327236000,18,23,18,1327236060,60,1496580,7319880,5823300,34_34_2_2_35_35_34_34_2_2_3_3_3_3_3_3_18_18_3_3_3_18_3_3_3_18
1807,63,1327236000,1,2,16,1327240380,4380,384540,6232860,5848320,16_16_16_16_16_16_16_16_16_0_0_16_16_0_16_16_0_16_16_0_0_16_16_16_0_0_16_0_0_16_0_16_0_0_0_16_1_1_1_16_16_16_0_1_1_1
1808,104,1327236000,5,2,5,1327237800,1800,872100,935100,63000,3_3_18_18_18_18_18_18_18_18_15_15_15_15_15_15_5_5_15_15_5_5
1809,98,1327236060,18,23,18,1327242780,6720,1496640,7319880,5823240,34_34_2_2_35_35_34_34_2_2_3_3_3_3_3_3_18_18_3_3_3_18_3_3_3_18_18
1810,142,1327237200,27,27,27,1327388400,151200,1478760,7299960,5821200,0_0_0_0_0_0_0_1_1_0_0_0_0_0_0_0_0_1_1_0_0_0_0_0_0_1_1_0_0_0_0_0_0_1_1_0_0_0_0_0_0_0_1_0_1_0_0_0_1_1_1_1_27_27_27_27_1_27_27_1_27_27
1811,12,1327237260,2,4,2,1327239180,1920,593820,850020,256200,17_17_17_1_17_17_1_17_17_17_17_17_17_17_1_17_17_1_17_17_17_1_1_17_7_7_17_17_17_17_2
1812,104,1327237800,5,2,5,1327240140,2340,873900,935100,61200,3_3_18_18_18_18_18_18_18_18_15_15_15_15_15_15_5_5_15_15_5_5_5
1813,12,1327239180,2,4,1,1327303440,64260,595740,850020,254280,17_17_17_1_17_17_1_17_17_17_17_17_17_17_1_17_17_1_17_17_17_1_1_17_7_7_17_17_17_17_2_2
1814,79,1327239840,14,17,1,1328047200,807360,1611840,4151700,2539860,15_1_15_1_26_26_26_26_26_26_26_26_26_26_26_26_26_26_26_26_8_8_1_1_10_10_10_10_10_10_41_1_1_41_6_6_41_41_41_41_18_14_15_18_15_14_1_1_14_14_14_14
1815,135,1327240080,19,11,19,1327240800,720,1165680,5649480,4483800,19_19_19_19_19_19_19_19_19_19_19_19_1_19_1_19
1816,104,1327240140,5,2,6,1327269600,29460,876240,935100,58860,3_3_18_18_18_18_18_18_18_18_15_15_15_15_15_15_5_5_15_15_5_5_5_5
1817,63,1327240380,16,1,0,1327240560,180,388920,6232860,5843940,16_16_16_16_16_16_16_16_16_0_0_16_16_0_16_16_0_16_16_0_0_16_16_16_0_0_16_0_0_16_0_16_0_0_0_16_1_1_1_16_16_16_0_1_1_1_16
1818,63,1327240560,0,1,0,1327240620,60,389100,6232860,5843760,16_16_16_16_16_16_16_16_16_0_0_16_16_0_16_16_0_16_16_0_0_16_16_16_0_0_16_0_0_16_0_16_0_0_0_16_1_1_1_16_16_16_0_1_1_1_16_0
1819,63,1327240620,0,0,16,1327243560,2940,389160,6232860,5843700,16_16_16_16_16_16_16_16_16_0_0_16_16_0_16_16_0_16_16_0_0_16_16_16_0_0_16_0_0_16_0_16_0_0_0_16_1_1_1_16_16_16_0_1_1_1_16_0_0
1820,111,1327240680,4,23,4,1327241220,540,1781880,3974400,2192520,0_0_0_0_0_0_0_0_0_0_0_1_0_1_0_0_0_0_1_0_1_0_0_0_0_0_0_1_1_0_1_1_2_2_4_4_4_4_4_1_4_4_1_4
1821,135,1327240800,19,1,19,1327246200,5400,1166400,5649480,4483080,19_19_19_19_19_19_19_19_19_19_19_19_1_19_1_19_19
1822,66,1327240860,5,6,5,1327305900,65040,1760460,4817700,3057240,3_3_4_4_4_4_4_4_4_4_4_4_4_4_4_4_4_4_4_4_4_3_3_4_4_4_4_4_4_4_4_4_5_5_5_5
1823,111,1327241220,4,19,4,1327251540,10320,1782420,3974400,2191980,0_0_0_0_0_0_0_0_0_0_0_1_0_1_0_0_0_0_1_0_1_0_0_0_0_0_0_1_1_0_1_1_2_2_4_4_4_4_4_1_4_4_1_4_4
1824,145,1327241940,3,15,3,1327245960,4020,346920,586680,239760,10_10_10_10_10_10_10_10_10_10_10_10_10_10_1_1_3
1825,98,1327242780,18,23,3,1327246080,3300,1503360,7319880,5816520,34_34_2_2_35_35_34_34_2_2_3_3_3_3_3_3_18_18_3_3_3_18_3_3_3_18_18_18_18
1826,98,1327242780,18,23,18,1327242780,0,1503360,7319880,5816520,34_34_2_2_35_35_34_34_2_2_3_3_3_3_3_3_18_18_3_3_3_18_3_3_3_18_18_18
1827,63,1327243560,16,20,16,1327254780,11220,392100,6232860,5840760,16_16_16_16_16_16_16_16_16_0_0_16_16_0_16_16_0_16_16_0_0_16_16_16_0_0_16_0_0_16_0_16_0_0_0_16_1_1_1_16_16_16_0_1_1_1_16_0_0_16
1828,145,1327245960,3,15,14,1327246020,60,350940,586680,235740,10_10_10_10_10_10_10_10_10_10_10_10_10_10_1_1_3_3
1829,145,1327246020,14,15,14,1327249620,3600,351000,586680,235680,10_10_10_10_10_10_10_10_10_10_10_10_10_10_1_1_3_3_14
1830,103,1327246020,9,3,9,1327299240,53220,1445040,4719960,3274920,19_19_19_19_19_19_19_1_1_19_19_19_19_1_1_19_19_19_19_19_1_1_2_2_9_2_2_9_9_9
1831,98,1327246080,3,3,3,1327248360,2280,1506660,7319880,5813220,34_34_2_2_35_35_34_34_2_2_3_3_3_3_3_3_18_18_3_3_3_18_3_3_3_18_18_18_18_3
1832,135,1327246200,19,1,1,1327323960,77760,1171800,5649480,4477680,19_19_19_19_19_19_19_19_19_19_19_19_1_19_1_19_19_19
1833,1,1327247220,7,8,8,1327298040,50820,470760,1447140,976380,7_8_7_8_7_7_7_7_7_7_7_7_7_7_7_7_7_7_7_7_7_7_7_7_7_7_7_7_7_7
1834,133,1327247220,17,8,17,1327256340,9120,456420,6181200,5724780,17_17_17_17_17_17_17_17_17_17_17_17_17_17_17_17_17_17_17_17_17_17_17_17_17_17_17_17
1835,101,1327248000,10,16,10,1327268160,20160,25020,655020,630000,10_8_8_10
1836,98,1327248360,3,3,18,1327251480,3120,1508940,7319880,5810940,34_34_2_2_35_35_34_34_2_2_3_3_3_3_3_3_18_18_3_3_3_18_3_3_3_18_18_18_18_3_3
1837,145,1327249620,14,15,14,1327249620,0,354600,586680,232080,10_10_10_10_10_10_10_10_10_10_10_10_10_10_1_1_3_3_14_14
1838,145,1327249620,14,15,14,1327263060,13440,354600,586680,232080,10_10_10_10_10_10_10_10_10_10_10_10_10_10_1_1_3_3_14_14_14
1839,98,1327251480,18,23,18,1327251540,60,1512060,7319880,5807820,34_34_2_2_35_35_34_34_2_2_3_3_3_3_3_3_18_18_3_3_3_18_3_3_3_18_18_18_18_3_3_18
1840,111,1327251540,4,19,4,1327255200,3660,1792740,3974400,2181660,0_0_0_0_0_0_0_0_0_0_0_1_0_1_0_0_0_0_1_0_1_0_0_0_0_0_0_1_1_0_1_1_2_2_4_4_4_4_4_1_4_4_1_4_4_4
1841,98,1327251540,18,19,18,1327269060,17520,1512120,7319880,5807760,34_34_2_2_35_35_34_34_2_2_3_3_3_3_3_3_18_18_3_3_3_18_3_3_3_18_18_18_18_3_3_18_18
1842,63,1327254780,16,1,0,1327255020,240,403320,6232860,5829540,16_16_16_16_16_16_16_16_16_0_0_16_16_0_16_16_0_16_16_0_0_16_16_16_0_0_16_0_0_16_0_16_0_0_0_16_1_1_1_16_16_16_0_1_1_1_16_0_0_16_16
1843,63,1327255020,0,1,16,1327255740,720,403560,6232860,5829300,16_16_16_16_16_16_16_16_16_0_0_16_16_0_16_16_0_16_16_0_0_16_16_16_0_0_16_0_0_16_0_16_0_0_0_16_1_1_1_16_16_16_0_1_1_1_16_0_0_16_16_0
1844,111,1327255200,4,5,4,1327294020,38820,1796400,3974400,2178000,0_0_0_0_0_0_0_0_0_0_0_1_0_1_0_0_0_0_1_0_1_0_0_0_0_0_0_1_1_0_1_1_2_2_4_4_4_4_4_1_4_4_1_4_4_4_4
1845,115,1327255380,19,1,19,1327268040,12660,590580,954000,363420,19_19_19_19_19
1846,63,1327255740,16,14,0,1327255800,60,404280,6232860,5828580,16_16_16_16_16_16_16_16_16_0_0_16_16_0_16_16_0_16_16_0_0_16_16_16_0_0_16_0_0_16_0_16_0_0_0_16_1_1_1_16_16_16_0_1_1_1_16_0_0_16_16_0_16
1847,63,1327255800,0,14,16,1327292400,36600,404340,6232860,5828520,16_16_16_16_16_16_16_16_16_0_0_16_16_0_16_16_0_16_16_0_0_16_16_16_0_0_16_0_0_16_0_16_0_0_0_16_1_1_1_16_16_16_0_1_1_1_16_0_0_16_16_0_16_0
1848,133,1327256340,17,12,17,1327293840,37500,465540,6181200,5715660,17_17_17_17_17_17_17_17_17_17_17_17_17_17_17_17_17_17_17_17_17_17_17_17_17_17_17_17_17
1849,119,1327256520,7,12,7,1327282200,25680,306900,2742780,2435880,7_7_7_1_1_7_7_7_7_7_7
1850,145,1327263060,14,15,2,1327330620,67560,368040,586680,218640,10_10_10_10_10_10_10_10_10_10_10_10_10_10_1_1_3_3_14_14_14_14
1851,115,1327268040,19,1,1,1327294800,26760,603240,954000,350760,19_19_19_19_19_19
1852,101,1327268160,10,14,10,1327292820,24660,45180,655020,609840,10_8_8_10_10
1853,98,1327269060,18,19,18,1327269420,360,1529640,7319880,5790240,34_34_2_2_35_35_34_34_2_2_3_3_3_3_3_3_18_18_3_3_3_18_3_3_3_18_18_18_18_3_3_18_18_18
1854,98,1327269420,18,5,18,1327294140,24720,1530000,7319880,5789880,34_34_2_2_35_35_34_34_2_2_3_3_3_3_3_3_18_18_3_3_3_18_3_3_3_18_18_18_18_3_3_18_18_18_18
1855,83,1327269600,3,4,3,1327274100,4500,1209600,1818000,608400,19_19_19_19_19_19_19_19_19_19_19_19_19_19_19_19_19_19_19_19_19_19_19_19_19_19_19_19_7_19_7_19_1_1_1_1_1_1_1_1_7_7_1_1_3
1856,138,1327269600,6,30,6,1327269600,0,1782000,1785600,3600,10_10_10_10_10_1_10_10_1_10_10_10_10_10_10_1_10_1_9_9_47_47_2_2_3_3_14_14_5_5_5_14_14_14_5_14_5_5_5_5_6
1857,104,1327269600,6,30,6,1327273200,3600,905700,935100,29400,3_3_18_18_18_18_18_18_18_18_15_15_15_15_15_15_5_5_15_15_5_5_5_5_6
1858,82,1327269600,6,30,6,1327273200,3600,1241880,2195880,954000,1_1_2_2_3_3_14_14_14_14_5_5_5_5_6
1859,138,1327269600,6,30,6,1327273200,3600,1782000,1785600,3600,10_10_10_10_10_1_10_10_1_10_10_10_10_10_10_1_10_1_9_9_47_47_2_2_3_3_14_14_5_5_5_14_14_14_5_14_5_5_5_5_6_6
1860,138,1327273200,6,30,99,1327273200,0,1785600,1785600,0,10_10_10_10_10_1_10_10_1_10_10_10_10_10_10_1_10_1_9_9_47_47_2_2_3_3_14_14_5_5_5_14_14_14_5_14_5_5_5_5_6_6_6_6
1861,138,1327273200,6,30,6,1327273200,0,1785600,1785600,0,10_10_10_10_10_1_10_10_1_10_10_10_10_10_10_1_10_1_9_9_47_47_2_2_3_3_14_14_5_5_5_14_14_14_5_14_5_5_5_5_6_6_6
1862,104,1327273200,6,30,5,1327294800,21600,909300,935100,25800,3_3_18_18_18_18_18_18_18_18_15_15_15_15_15_15_5_5_15_15_5_5_5_5_6_6
1863,82,1327273200,6,30,13,1327496400,223200,1245480,2195880,950400,1_1_2_2_3_3_14_14_14_14_5_5_5_5_6_6
1864,83,1327274100,3,4,2,1327319580,45480,1214100,1818000,603900,19_19_19_19_19_19_19_19_19_19_19_19_19_19_19_19_19_19_19_19_19_19_19_19_19_19_19_19_7_19_7_19_1_1_1_1_1_1_1_1_7_7_1_1_3_3
1865,119,1327282200,7,12,7,1327282260,60,332580,2742780,2410200,7_7_7_1_1_7_7_7_7_7_7_7
1866,119,1327282260,7,12,7,1327288800,6540,332640,2742780,2410140,7_7_7_1_1_7_7_7_7_7_7_7_7
1867,94,1327287600,7,12,7,1327294800,7200,0,534480,534480,7
1868,119,1327288800,7,12,1,1327297380,8580,339180,2742780,2403600,7_7_7_1_1_7_7_7_7_7_7_7_7_7
1869,63,1327292400,16,14,0,1327292520,120,440940,6232860,5791920,16_16_16_16_16_16_16_16_16_0_0_16_16_0_16_16_0_16_16_0_0_16_16_16_0_0_16_0_0_16_0_16_0_0_0_16_1_1_1_16_16_16_0_1_1_1_16_0_0_16_16_0_16_0_16
1870,63,1327292520,0,14,0,1327294620,2100,441060,6232860,5791800,16_16_16_16_16_16_16_16_16_0_0_16_16_0_16_16_0_16_16_0_0_16_16_16_0_0_16_0_0_16_0_16_0_0_0_16_1_1_1_16_16_16_0_1_1_1_16_0_0_16_16_0_16_0_16_0
1871,101,1327292820,10,14,10,1327297080,4260,69840,655020,585180,10_8_8_10_10_10
1872,133,1327293840,17,12,1,1327294440,600,503040,6181200,5678160,17_17_17_17_17_17_17_17_17_17_17_17_17_17_17_17_17_17_17_17_17_17_17_17_17_17_17_17_17_17
1873,111,1327294020,4,5,4,1327294860,840,1835220,3974400,2139180,0_0_0_0_0_0_0_0_0_0_0_1_0_1_0_0_0_0_1_0_1_0_0_0_0_0_0_1_1_0_1_1_2_2_4_4_4_4_4_1_4_4_1_4_4_4_4_4
1874,98,1327294140,18,5,18,1327295160,1020,1554720,7319880,5765160,34_34_2_2_35_35_34_34_2_2_3_3_3_3_3_3_18_18_3_3_3_18_3_3_3_18_18_18_18_3_3_18_18_18_18_18
1875,133,1327294440,1,9,1,1327298040,3600,503640,6181200,5677560,17_17_17_17_17_17_17_17_17_17_17_17_17_17_17_17_17_17_17_17_17_17_17_17_17_17_17_17_17_17_1
1876,63,1327294620,0,0,2,1327305960,11340,443160,6232860,5789700,16_16_16_16_16_16_16_16_16_0_0_16_16_0_16_16_0_16_16_0_0_16_16_16_0_0_16_0_0_16_0_16_0_0_0_16_1_1_1_16_16_16_0_1_1_1_16_0_0_16_16_0_16_0_16_0_0
1877,94,1327294800,7,12,7,1327295760,960,7200,534480,527280,7_7
1878,115,1327294800,1,18,19,1327297860,3060,630000,954000,324000,19_19_19_19_19_19_1
1879,104,1327294800,5,2,5,1327296600,1800,930900,935100,4200,3_3_18_18_18_18_18_18_18_18_15_15_15_15_15_15_5_5_15_15_5_5_5_5_6_6_5
1880,111,1327294860,4,22,4,1327332360,37500,1836060,3974400,2138340,0_0_0_0_0_0_0_0_0_0_0_1_0_1_0_0_0_0_1_0_1_0_0_0_0_0_0_1_1_0_1_1_2_2_4_4_4_4_4_1_4_4_1_4_4_4_4_4_4
1881,98,1327295160,18,23,18,1327328400,33240,1555740,7319880,5764140,34_34_2_2_35_35_34_34_2_2_3_3_3_3_3_3_18_18_3_3_3_18_3_3_3_18_18_18_18_3_3_18_18_18_18_18_18
1882,108,1327295400,17,10,17,1327333380,37980,579540,3191940,2612400,1_1_1_17_1_17_17_17_17
1883,102,1327295760,43,20,43,1327307520,11760,0,3198240,3198240,43
1884,94,1327295760,7,8,7,1327327920,32160,8160,534480,526320,7_7_7
1885,104,1327296600,5,2,5,1327296600,0,932700,935100,2400,3_3_18_18_18_18_18_18_18_18_15_15_15_15_15_15_5_5_15_15_5_5_5_5_6_6_5_5
1886,104,1327296600,5,2,5,1327299000,2400,932700,935100,2400,3_3_18_18_18_18_18_18_18_18_15_15_15_15_15_15_5_5_15_15_5_5_5_5_6_6_5_5_5
1887,101,1327297080,10,16,10,1327304640,7560,74100,655020,580920,10_8_8_10_10_10_10
1888,119,1327297380,1,6,1,1327300980,3600,347760,2742780,2395020,7_7_7_1_1_7_7_7_7_7_7_7_7_7_1
1889,115,1327297860,19,11,1,1327305420,7560,633060,954000,320940,19_19_19_19_19_19_1_19
1890,1,1327298040,8,9,8,1327307160,9120,521580,1447140,925560,7_8_7_8_7_7_7_7_7_7_7_7_7_7_7_7_7_7_7_7_7_7_7_7_7_7_7_7_7_7_8
1891,133,1327298040,1,9,17,1327342560,44520,507240,6181200,5673960,17_17_17_17_17_17_17_17_17_17_17_17_17_17_17_17_17_17_17_17_17_17_17_17_17_17_17_17_17_17_1_1
1892,104,1327299000,5,2,99,1327299000,0,935100,935100,0,3_3_18_18_18_18_18_18_18_18_15_15_15_15_15_15_5_5_15_15_5_5_5_5_6_6_5_5_5_5
1893,103,1327299240,9,3,9,1327309560,10320,1498260,4719960,3221700,19_19_19_19_19_19_19_1_1_19_19_19_19_1_1_19_19_19_19_19_1_1_2_2_9_2_2_9_9_9_9
1894,119,1327300980,1,6,2,1327418100,117120,351360,2742780,2391420,7_7_7_1_1_7_7_7_7_7_7_7_7_7_1_1
1895,12,1327303440,1,9,1,1327303500,60,660000,850020,190020,17_17_17_1_17_17_1_17_17_17_17_17_17_17_1_17_17_1_17_17_17_1_1_17_7_7_17_17_17_17_2_2_1
1896,12,1327303500,1,9,2,1327408860,105360,660060,850020,189960,17_17_17_1_17_17_1_17_17_17_17_17_17_17_1_17_17_1_17_17_17_1_1_17_7_7_17_17_17_17_2_2_1_1
1897,101,1327304640,10,16,8,1327305480,840,81660,655020,573360,10_8_8_10_10_10_10_10
1898,115,1327305420,1,18,19,1327308060,2640,640620,954000,313380,19_19_19_19_19_19_1_19_1
1899,101,1327305480,8,18,8,1327311420,5940,82500,655020,572520,10_8_8_10_10_10_10_10_8
1900,66,1327305900,5,6,5,1327327260,21360,1825500,4817700,2992200,3_3_4_4_4_4_4_4_4_4_4_4_4_4_4_4_4_4_4_4_4_3_3_4_4_4_4_4_4_4_4_4_5_5_5_5_5
1901,63,1327305960,2,4,2,1327310520,4560,454500,6232860,5778360,16_16_16_16_16_16_16_16_16_0_0_16_16_0_16_16_0_16_16_0_0_16_16_16_0_0_16_0_0_16_0_16_0_0_0_16_1_1_1_16_16_16_0_1_1_1_16_0_0_16_16_0_16_0_16_0_0_2
1902,1,1327307160,8,9,2,1327476660,169500,530700,1447140,916440,7_8_7_8_7_7_7_7_7_7_7_7_7_7_7_7_7_7_7_7_7_7_7_7_7_7_7_7_7_7_8_8
1903,102,1327307520,43,20,43,1327327800,20280,11760,3198240,3186480,43_43
1904,115,1327308060,19,11,19,1327308060,0,643260,954000,310740,19_19_19_19_19_19_1_19_1_19
1905,115,1327308060,19,11,19,1327327320,19260,643260,954000,310740,19_19_19_19_19_19_1_19_1_19_19
1906,103,1327309560,9,3,14,1327822140,512580,1508580,4719960,3211380,19_19_19_19_19_19_19_1_1_19_19_19_19_1_1_19_19_19_19_19_1_1_2_2_9_2_2_9_9_9_9_9
1907,96,1327309800,10,16,1,1327318200,8400,0,2123400,2123400,10
1908,63,1327310520,2,4,1,1327317600,7080,459060,6232860,5773800,16_16_16_16_16_16_16_16_16_0_0_16_16_0_16_16_0_16_16_0_0_16_16_16_0_0_16_0_0_16_0_16_0_0_0_16_1_1_1_16_16_16_0_1_1_1_16_0_0_16_16_0_16_0_16_0_0_2_2
1909,148,1327310580,9,3,9,1327319520,8940,446280,1938900,1492620,7_7_7_7_7_1_7_1_9
1910,101,1327311420,8,18,2,1327486380,174960,88440,655020,566580,10_8_8_10_10_10_10_10_8_8
1911,77,1327311840,2,0,2,1327315500,3660,703680,3257040,2553360,0_0_1_0_0_1_0_0_0_0_0_0_0_0_0_0_0_0_1_0_1_0_2
1912,77,1327315500,2,0,4,1327433400,117900,707340,3257040,2549700,0_0_1_0_0_1_0_0_0_0_0_0_0_0_0_0_0_0_1_0_1_0_2_2
1913,63,1327317600,1,2,1,1327325400,7800,466140,6232860,5766720,16_16_16_16_16_16_16_16_16_0_0_16_16_0_16_16_0_16_16_0_0_16_16_16_0_0_16_0_0_16_0_16_0_0_0_16_1_1_1_16_16_16_0_1_1_1_16_0_0_16_16_0_16_0_16_0_0_2_2_1
1914,96,1327318200,1,18,10,1327321200,3000,8400,2123400,2115000,10_1
1915,86,1327319160,2,0,2,1327322220,3060,973140,3519180,2546040,0_0_0_0_1_0_0_0_0_1_0_0_0_0_1_1_0_0_1_1_1_1_1_1_2
1916,148,1327319520,9,3,2,1328517720,1198200,455220,1938900,1483680,7_7_7_7_7_1_7_1_9_9
1917,83,1327319580,2,3,2,1327323420,3840,1259580,1818000,558420,19_19_19_19_19_19_19_19_19_19_19_19_19_19_19_19_19_19_19_19_19_19_19_19_19_19_19_19_7_19_7_19_1_1_1_1_1_1_1_1_7_7_1_1_3_3_2
1918,134,1327320540,13,17,13,1327325400,4860,507120,3656580,3149460,0_0_0_0_0_0_0_0_0_0_1_1_2_2_3_3_13
1919,96,1327321200,10,16,10,1327321260,60,11400,2123400,2112000,10_1_10
1920,96,1327321260,10,16,10,1327327740,6480,11460,2123400,2111940,10_1_10_10
1921,86,1327322220,2,0,4,1327346160,23940,976200,3519180,2542980,0_0_0_0_1_0_0_0_0_1_0_0_0_0_1_1_0_0_1_1_1_1_1_1_2_2
1922,112,1327322760,47,9,47,1327322940,180,748200,1303440,555240,19_19_19_19_19_1_1_19_19_19_1_1_47
1923,112,1327322940,47,9,2,1327417260,94320,748380,1303440,555060,19_19_19_19_19_1_1_19_19_19_1_1_47_47
1924,83,1327323420,3,3,3,1327330320,6900,1263420,1818000,554580,19_19_19_19_19_19_19_19_19_19_19_19_19_19_19_19_19_19_19_19_19_19_19_19_19_19_19_19_7_19_7_19_1_1_1_1_1_1_1_1_7_7_1_1_3_3_2_2_3
1925,83,1327323420,2,3,3,1327323420,0,1263420,1818000,554580,19_19_19_19_19_19_19_19_19_19_19_19_19_19_19_19_19_19_19_19_19_19_19_19_19_19_19_19_7_19_7_19_1_1_1_1_1_1_1_1_7_7_1_1_3_3_2_2
1926,135,1327323960,1,9,1,1327327380,3420,1249560,5649480,4399920,19_19_19_19_19_19_19_19_19_19_19_19_1_19_1_19_19_19_1
1927,134,1327325400,13,17,13,1327325460,60,511980,3656580,3144600,0_0_0_0_0_0_0_0_0_0_1_1_2_2_3_3_13_13
1928,63,1327325400,1,2,0,1327327560,2160,473940,6232860,5758920,16_16_16_16_16_16_16_16_16_0_0_16_16_0_16_16_0_16_16_0_0_16_16_16_0_0_16_0_0_16_0_16_0_0_0_16_1_1_1_16_16_16_0_1_1_1_16_0_0_16_16_0_16_0_16_0_0_2_2_1_1
1929,72,1327325400,2,3,2,1327326960,1560,1142160,2385960,1243800,17_17_17_1_17_1_17_1_1_17_17_17_17_1_1_17_17_17_38_38_17_17_1_24_24_24_24_1_24_1_1_24_24_24_24_24_8_8_2
1930,134,1327325460,13,17,13,1327334580,9120,512040,3656580,3144540,0_0_0_0_0_0_0_0_0_0_1_1_2_2_3_3_13_13_13
1931,72,1327326960,2,3,3,1327356000,29040,1143720,2385960,1242240,17_17_17_1_17_1_17_1_1_17_17_17_17_1_1_17_17_17_38_38_17_17_1_24_24_24_24_1_24_1_1_24_24_24_24_24_8_8_2_2
1932,113,1327327200,48,42,3,1327335120,7920,503940,3646740,3142800,16_16_16_16_1_1_2_2_48
1933,66,1327327260,5,6,5,1327391460,64200,1846860,4817700,2970840,3_3_4_4_4_4_4_4_4_4_4_4_4_4_4_4_4_4_4_4_4_3_3_4_4_4_4_4_4_4_4_4_5_5_5_5_5_5
1934,115,1327327320,19,11,1,1327381200,53880,662520,954000,291480,19_19_19_19_19_19_1_19_1_19_19_19
1935,135,1327327380,1,9,1,1327380600,53220,1252980,5649480,4396500,19_19_19_19_19_19_19_19_19_19_19_19_1_19_1_19_19_19_1_1
1936,63,1327327560,0,0,0,1327327740,180,476100,6232860,5756760,16_16_16_16_16_16_16_16_16_0_0_16_16_0_16_16_0_16_16_0_0_16_16_16_0_0_16_0_0_16_0_16_0_0_0_16_1_1_1_16_16_16_0_1_1_1_16_0_0_16_16_0_16_0_16_0_0_2_2_1_1_0
1937,61,1327327740,34,15,34,1327328280,540,1872540,6225300,4352760,4_4_18_18_34_34_34_3_3_34_3_3_34_35_34_35_35_35_36_36_35_35_35_35_34_34_34
1938,96,1327327740,10,16,10,1327327740,0,17940,2123400,2105460,10_1_10_10_10
1939,96,1327327740,10,16,1,1327327860,120,17940,2123400,2105460,10_1_10_10_10_10
1940,63,1327327740,0,1,0,1327342380,14640,476280,6232860,5756580,16_16_16_16_16_16_16_16_16_0_0_16_16_0_16_16_0_16_16_0_0_16_16_16_0_0_16_0_0_16_0_16_0_0_0_16_1_1_1_16_16_16_0_1_1_1_16_0_0_16_16_0_16_0_16_0_0_2_2_1_1_0_0
1941,102,1327327800,43,1,43,1327342380,14580,32040,3198240,3166200,43_43_43
1942,96,1327327860,1,18,10,1327333680,5820,18060,2123400,2105340,10_1_10_10_10_10_1
1943,94,1327327920,7,8,7,1327327980,60,40320,534480,494160,7_7_7_7
1944,94,1327327980,7,8,7,1327331820,3840,40380,534480,494100,7_7_7_7_7
1945,61,1327328280,34,15,34,1327413960,85680,1873080,6225300,4352220,4_4_18_18_34_34_34_3_3_34_3_3_34_35_34_35_35_35_36_36_35_35_35_35_34_34_34_34
1946,98,1327328400,18,23,18,1327328400,0,1588980,7319880,5730900,34_34_2_2_35_35_34_34_2_2_3_3_3_3_3_3_18_18_3_3_3_18_3_3_3_18_18_18_18_3_3_18_18_18_18_18_18_18
1947,98,1327328400,18,15,3,1327328580,180,1588980,7319880,5730900,34_34_2_2_35_35_34_34_2_2_3_3_3_3_3_3_18_18_3_3_3_18_3_3_3_18_18_18_18_3_3_18_18_18_18_18_18_18_18
1948,98,1327328580,3,3,3,1327333080,4500,1589160,7319880,5730720,34_34_2_2_35_35_34_34_2_2_3_3_3_3_3_3_18_18_3_3_3_18_3_3_3_18_18_18_18_3_3_18_18_18_18_18_18_18_18_3
1949,83,1327330320,3,3,2,1327330380,60,1270320,1818000,547680,19_19_19_19_19_19_19_19_19_19_19_19_19_19_19_19_19_19_19_19_19_19_19_19_19_19_19_19_7_19_7_19_1_1_1_1_1_1_1_1_7_7_1_1_3_3_2_2_3_3
1950,83,1327330380,2,3,2,1327330440,60,1270380,1818000,547620,19_19_19_19_19_19_19_19_19_19_19_19_19_19_19_19_19_19_19_19_19_19_19_19_19_19_19_19_7_19_7_19_1_1_1_1_1_1_1_1_7_7_1_1_3_3_2_2_3_3_2
1951,83,1327330440,3,3,3,1327334940,4500,1270440,1818000,547560,19_19_19_19_19_19_19_19_19_19_19_19_19_19_19_19_19_19_19_19_19_19_19_19_19_19_19_19_7_19_7_19_1_1_1_1_1_1_1_1_7_7_1_1_3_3_2_2_3_3_2_2_3
1952,83,1327330440,2,3,3,1327330440,0,1270440,1818000,547560,19_19_19_19_19_19_19_19_19_19_19_19_19_19_19_19_19_19_19_19_19_19_19_19_19_19_19_19_7_19_7_19_1_1_1_1_1_1_1_1_7_7_1_1_3_3_2_2_3_3_2_2
1953,145,1327330620,2,3,2,1327331580,960,435600,586680,151080,10_10_10_10_10_10_10_10_10_10_10_10_10_10_1_1_3_3_14_14_14_14_2
1954,145,1327331580,2,3,5,1327391280,59700,436560,586680,150120,10_10_10_10_10_10_10_10_10_10_10_10_10_10_1_1_3_3_14_14_14_14_2_2
1955,94,1327331820,7,8,7,1327331880,60,44220,534480,490260,7_7_7_7_7_7
1956,94,1327331880,7,8,7,1327333500,1620,44280,534480,490200,7_7_7_7_7_7_7
1957,111,1327332360,4,22,4,1327341360,9000,1873560,3974400,2100840,0_0_0_0_0_0_0_0_0_0_0_1_0_1_0_0_0_0_1_0_1_0_0_0_0_0_0_1_1_0_1_1_2_2_4_4_4_4_4_1_4_4_1_4_4_4_4_4_4_4
1958,98,1327333080,3,3,18,1327354380,21300,1593660,7319880,5726220,34_34_2_2_35_35_34_34_2_2_3_3_3_3_3_3_18_18_3_3_3_18_3_3_3_18_18_18_18_3_3_18_18_18_18_18_18_18_18_3_3
1959,108,1327333380,17,10,17,1327382040,48660,617520,3191940,2574420,1_1_1_17_1_17_17_17_17_17
1960,94,1327333500,7,8,7,1327352400,18900,45900,534480,488580,7_7_7_7_7_7_7_7
1961,96,1327333680,10,16,10,1327372620,38940,23880,2123400,2099520,10_1_10_10_10_10_1_10
1962,134,1327334580,13,17,13,1327380840,46260,521160,3656580,3135420,0_0_0_0_0_0_0_0_0_0_1_1_2_2_3_3_13_13_13_13
1963,83,1327334940,3,3,18,1327385640,50700,1274940,1818000,543060,19_19_19_19_19_19_19_19_19_19_19_19_19_19_19_19_19_19_19_19_19_19_19_19_19_19_19_19_7_19_7_19_1_1_1_1_1_1_1_1_7_7_1_1_3_3_2_2_3_3_2_2_3_3
1964,113,1327335120,3,15,3,1327335180,60,511860,3646740,3134880,16_16_16_16_1_1_2_2_48_3
1965,113,1327335180,3,15,48,1327341600,6420,511920,3646740,3134820,16_16_16_16_1_1_2_2_48_3_3
1966,111,1327341360,4,5,4,1327346160,4800,1882560,3974400,2091840,0_0_0_0_0_0_0_0_0_0_0_1_0_1_0_0_0_0_1_0_1_0_0_0_0_0_0_1_1_0_1_1_2_2_4_4_4_4_4_1_4_4_1_4_4_4_4_4_4_4_4
1967,113,1327341600,48,42,15,1327660860,319260,518340,3646740,3128400,16_16_16_16_1_1_2_2_48_3_3_48
1968,63,1327342380,0,1,0,1327342680,300,490920,6232860,5741940,16_16_16_16_16_16_16_16_16_0_0_16_16_0_16_16_0_16_16_0_0_16_16_16_0_0_16_0_0_16_0_16_0_0_0_16_1_1_1_16_16_16_0_1_1_1_16_0_0_16_16_0_16_0_16_0_0_2_2_1_1_0_0_0
1969,102,1327342380,43,1,16,1327344180,1800,46620,3198240,3151620,43_43_43_43
1970,133,1327342560,17,12,17,1327348080,5520,551760,6181200,5629440,17_17_17_17_17_17_17_17_17_17_17_17_17_17_17_17_17_17_17_17_17_17_17_17_17_17_17_17_17_17_1_1_17
1971,63,1327342680,0,14,2,1327356000,13320,491220,6232860,5741640,16_16_16_16_16_16_16_16_16_0_0_16_16_0_16_16_0_16_16_0_0_16_16_16_0_0_16_0_0_16_0_16_0_0_0_16_1_1_1_16_16_16_0_1_1_1_16_0_0_16_16_0_16_0_16_0_0_2_2_1_1_0_0_0_0
1972,102,1327344180,16,14,16,1327363800,19620,48420,3198240,3149820,43_43_43_43_16
1973,86,1327346160,4,5,4,1327349880,3720,1000140,3519180,2519040,0_0_0_0_1_0_0_0_0_1_0_0_0_0_1_1_0_0_1_1_1_1_1_1_2_2_4
1974,111,1327346160,4,5,18,1328712000,1365840,1887360,3974400,2087040,0_0_0_0_0_0_0_0_0_0_0_1_0_1_0_0_0_0_1_0_1_0_0_0_0_0_0_1_1_0_1_1_2_2_4_4_4_4_4_1_4_4_1_4_4_4_4_4_4_4_4_4
1975,133,1327348080,17,12,17,1327348140,60,557280,6181200,5623920,17_17_17_17_17_17_17_17_17_17_17_17_17_17_17_17_17_17_17_17_17_17_17_17_17_17_17_17_17_17_1_1_17_17
1976,133,1327348140,17,12,17,1327381680,33540,557340,6181200,5623860,17_17_17_17_17_17_17_17_17_17_17_17_17_17_17_17_17_17_17_17_17_17_17_17_17_17_17_17_17_17_1_1_17_17_17
1977,86,1327349880,4,5,4,1327380600,30720,1003860,3519180,2515320,0_0_0_0_1_0_0_0_0_1_0_0_0_0_1_1_0_0_1_1_1_1_1_1_2_2_4_4
1978,94,1327352400,7,12,7,1327374000,21600,64800,534480,469680,7_7_7_7_7_7_7_7_7
1979,98,1327354380,18,15,39,1327566600,212220,1614960,7319880,5704920,34_34_2_2_35_35_34_34_2_2_3_3_3_3_3_3_18_18_3_3_3_18_3_3_3_18_18_18_18_3_3_18_18_18_18_18_18_18_18_3_3_18
1980,56,1327356000,5,18,5,1327356000,0,1296000,6361440,5065440,6_6_5_5_8_8_8_8_26_26_5
1981,63,1327356000,2,4,2,1327360500,4500,504540,6232860,5728320,16_16_16_16_16_16_16_16_16_0_0_16_16_0_16_16_0_16_16_0_0_16_16_16_0_0_16_0_0_16_0_16_0_0_0_16_1_1_1_16_16_16_0_1_1_1_16_0_0_16_16_0_16_0_16_0_0_2_2_1_1_0_0_0_0_2_2_2
1982,63,1327356000,2,4,2,1327356000,0,504540,6232860,5728320,16_16_16_16_16_16_16_16_16_0_0_16_16_0_16_16_0_16_16_0_0_16_16_16_0_0_16_0_0_16_0_16_0_0_0_16_1_1_1_16_16_16_0_1_1_1_16_0_0_16_16_0_16_0_16_0_0_2_2_1_1_0_0_0_0_2
1983,72,1327356000,3,4,3,1327360500,4500,1172760,2385960,1213200,17_17_17_1_17_1_17_1_1_17_17_17_17_1_1_17_17_17_38_38_17_17_1_24_24_24_24_1_24_1_1_24_24_24_24_24_8_8_2_2_3
1984,63,1327356000,2,4,2,1327356000,0,504540,6232860,5728320,16_16_16_16_16_16_16_16_16_0_0_16_16_0_16_16_0_16_16_0_0_16_16_16_0_0_16_0_0_16_0_16_0_0_0_16_1_1_1_16_16_16_0_1_1_1_16_0_0_16_16_0_16_0_16_0_0_2_2_1_1_0_0_0_0_2_2
1985,56,1327356000,5,18,6,1327356000,0,1296000,6361440,5065440,6_6_5_5_8_8_8_8_26_26_5_5
1986,56,1327356000,6,24,6,1327359600,3600,1296000,6361440,5065440,6_6_5_5_8_8_8_8_26_26_5_5_6
1987,56,1327359600,6,24,5,1327360500,900,1299600,6361440,5061840,6_6_5_5_8_8_8_8_26_26_5_5_6_6
1988,56,1327360500,5,18,5,1327404600,44100,1300500,6361440,5060940,6_6_5_5_8_8_8_8_26_26_5_5_6_6_5_5
1989,56,1327360500,5,18,5,1327360500,0,1300500,6361440,5060940,6_6_5_5_8_8_8_8_26_26_5_5_6_6_5
1990,63,1327360500,2,4,2,1327360500,0,509040,6232860,5723820,16_16_16_16_16_16_16_16_16_0_0_16_16_0_16_16_0_16_16_0_0_16_16_16_0_0_16_0_0_16_0_16_0_0_0_16_1_1_1_16_16_16_0_1_1_1_16_0_0_16_16_0_16_0_16_0_0_2_2_1_1_0_0_0_0_2_2_2_2_2
1991,63,1327360500,2,4,0,1327379280,18780,509040,6232860,5723820,16_16_16_16_16_16_16_16_16_0_0_16_16_0_16_16_0_16_16_0_0_16_16_16_0_0_16_0_0_16_0_16_0_0_0_16_1_1_1_16_16_16_0_1_1_1_16_0_0_16_16_0_16_0_16_0_0_2_2_1_1_0_0_0_0_2_2_2_2_2_2
1992,63,1327360500,2,4,2,1327360500,0,509040,6232860,5723820,16_16_16_16_16_16_16_16_16_0_0_16_16_0_16_16_0_16_16_0_0_16_16_16_0_0_16_0_0_16_0_16_0_0_0_16_1_1_1_16_16_16_0_1_1_1_16_0_0_16_16_0_16_0_16_0_0_2_2_1_1_0_0_0_0_2_2_2_2
1993,72,1327360500,3,4,3,1327385640,25140,1177260,2385960,1208700,17_17_17_1_17_1_17_1_1_17_17_17_17_1_1_17_17_17_38_38_17_17_1_24_24_24_24_1_24_1_1_24_24_24_24_24_8_8_2_2_3_3
1994,102,1327363800,16,14,8,1327381200,17400,68040,3198240,3130200,43_43_43_43_16_16
1995,96,1327372620,10,14,10,1327379220,6600,62820,2123400,2060580,10_1_10_10_10_10_1_10_10
1996,94,1327374000,7,12,1,1327467600,93600,86400,534480,448080,7_7_7_7_7_7_7_7_7_7
1997,96,1327379220,10,14,10,1327384980,5760,69420,2123400,2053980,10_1_10_10_10_10_1_10_10_10
1998,63,1327379280,0,14,1,1327381200,1920,527820,6232860,5705040,16_16_16_16_16_16_16_16_16_0_0_16_16_0_16_16_0_16_16_0_0_16_16_16_0_0_16_0_0_16_0_16_0_0_0_16_1_1_1_16_16_16_0_1_1_1_16_0_0_16_16_0_16_0_16_0_0_2_2_1_1_0_0_0_0_2_2_2_2_2_2_0
1999,135,1327380600,1,9,1,1327382400,1800,1306200,5649480,4343280,19_19_19_19_19_19_19_19_19_19_19_19_1_19_1_19_19_19_1_1_1
2000,86,1327380600,4,22,4,1327381200,600,1034580,3519180,2484600,0_0_0_0_1_0_0_0_0_1_0_0_0_0_1_1_0_0_1_1_1_1_1_1_2_2_4_4_4
2001,134,1327380840,13,17,13,1327419360,38520,567420,3656580,3089160,0_0_0_0_0_0_0_0_0_0_1_1_2_2_3_3_13_13_13_13_13
2002,102,1327381200,1,6,16,1327382400,1200,85440,3198240,3112800,43_43_43_43_16_16_8_1
2003,115,1327381200,1,18,1,1327387200,6000,716400,954000,237600,19_19_19_19_19_19_1_19_1_19_19_19_1
2004,86,1327381200,4,5,4,1327387200,6000,1035180,3519180,2484000,0_0_0_0_1_0_0_0_0_1_0_0_0_0_1_1_0_0_1_1_1_1_1_1_2_2_4_4_4_4
2005,63,1327381200,1,2,0,1327381200,0,529740,6232860,5703120,16_16_16_16_16_16_16_16_16_0_0_16_16_0_16_16_0_16_16_0_0_16_16_16_0_0_16_0_0_16_0_16_0_0_0_16_1_1_1_16_16_16_0_1_1_1_16_0_0_16_16_0_16_0_16_0_0_2_2_1_1_0_0_0_0_2_2_2_2_2_2_0_1
2006,102,1327381200,8,6,1,1327381200,0,85440,3198240,3112800,43_43_43_43_16_16_8
2007,63,1327381200,0,0,1,1327387200,6000,529740,6232860,5703120,16_16_16_16_16_16_16_16_16_0_0_16_16_0_16_16_0_16_16_0_0_16_16_16_0_0_16_0_0_16_0_16_0_0_0_16_1_1_1_16_16_16_0_1_1_1_16_0_0_16_16_0_16_0_16_0_0_2_2_1_1_0_0_0_0_2_2_2_2_2_2_0_1_0
2008,126,1327381440,19,11,19,1327382220,780,0,496560,496560,19
2009,133,1327381680,17,12,1,1327393860,12180,590880,6181200,5590320,17_17_17_17_17_17_17_17_17_17_17_17_17_17_17_17_17_17_17_17_17_17_17_17_17_17_17_17_17_17_1_1_17_17_17_17
2010,108,1327382040,17,10,17,1327410600,28560,666180,3191940,2525760,1_1_1_17_1_17_17_17_17_17_17
2011,126,1327382220,19,11,19,1327382280,60,780,496560,495780,19_19
2012,126,1327382280,19,11,19,1327382400,120,840,496560,495720,19_19_19
2013,102,1327382400,16,20,1,1327383240,840,86640,3198240,3111600,43_43_43_43_16_16_8_1_16
2014,126,1327382400,19,9,19,1327390500,8100,960,496560,495600,19_19_19_19
2015,135,1327382400,1,9,19,1327578900,196500,1308000,5649480,4341480,19_19_19_19_19_19_19_19_19_19_19_19_1_19_1_19_19_19_1_1_1_1
2016,147,1327382880,7,8,7,1327401000,18120,0,1479360,1479360,7
2017,102,1327383240,1,6,8,1327384800,1560,87480,3198240,3110760,43_43_43_43_16_16_8_1_16_1
2018,102,1327384800,8,6,16,1327396980,12180,89040,3198240,3109200,43_43_43_43_16_16_8_1_16_1_8
2019,96,1327384980,10,16,10,1327413840,28860,75180,2123400,2048220,10_1_10_10_10_10_1_10_10_10_10
2020,83,1327385640,18,23,18,1327394580,8940,1325640,1818000,492360,19_19_19_19_19_19_19_19_19_19_19_19_19_19_19_19_19_19_19_19_19_19_19_19_19_19_19_19_7_19_7_19_1_1_1_1_1_1_1_1_7_7_1_1_3_3_2_2_3_3_2_2_3_3_18
2021,72,1327385640,3,3,5,1327388400,2760,1202400,2385960,1183560,17_17_17_1_17_1_17_1_1_17_17_17_17_1_1_17_17_17_38_38_17_17_1_24_24_24_24_1_24_1_1_24_24_24_24_24_8_8_2_2_3_3_3
2022,115,1327387200,1,18,2,1327400700,13500,722400,954000,231600,19_19_19_19_19_19_1_19_1_19_19_19_1_1
2023,86,1327387200,4,22,4,1327394400,7200,1041180,3519180,2478000,0_0_0_0_1_0_0_0_0_1_0_0_0_0_1_1_0_0_1_1_1_1_1_1_2_2_4_4_4_4_4
2024,63,1327387200,1,2,1,1327388400,1200,535740,6232860,5697120,16_16_16_16_16_16_16_16_16_0_0_16_16_0_16_16_0_16_16_0_0_16_16_16_0_0_16_0_0_16_0_16_0_0_0_16_1_1_1_16_16_16_0_1_1_1_16_0_0_16_16_0_16_0_16_0_0_2_2_1_1_0_0_0_0_2_2_2_2_2_2_0_1_0_1
2025,72,1327388400,5,18,3,1327396980,8580,1205160,2385960,1180800,17_17_17_1_17_1_17_1_1_17_17_17_17_1_1_17_17_17_38_38_17_17_1_24_24_24_24_1_24_1_1_24_24_24_24_24_8_8_2_2_3_3_3_5
2026,142,1327388400,27,26,27,1327417200,28800,1629960,7299960,5670000,0_0_0_0_0_0_0_1_1_0_0_0_0_0_0_0_0_1_1_0_0_0_0_0_0_1_1_0_0_0_0_0_0_1_1_0_0_0_0_0_0_0_1_0_1_0_0_0_1_1_1_1_27_27_27_27_1_27_27_1_27_27_27
2027,63,1327388400,1,2,0,1327395060,6660,536940,6232860,5695920,16_16_16_16_16_16_16_16_16_0_0_16_16_0_16_16_0_16_16_0_0_16_16_16_0_0_16_0_0_16_0_16_0_0_0_16_1_1_1_16_16_16_0_1_1_1_16_0_0_16_16_0_16_0_16_0_0_2_2_1_1_0_0_0_0_2_2_2_2_2_2_0_1_0_1_1
2028,126,1327390500,19,11,19,1327391280,780,9060,496560,487500,19_19_19_19_19
2029,145,1327391280,5,9,5,1327402800,11520,496260,586680,90420,10_10_10_10_10_10_10_10_10_10_10_10_10_10_1_1_3_3_14_14_14_14_2_2_5
2030,126,1327391280,19,9,1,1327467000,75720,9840,496560,486720,19_19_19_19_19_19
2031,66,1327391460,5,6,5,1327413120,21660,1911060,4817700,2906640,3_3_4_4_4_4_4_4_4_4_4_4_4_4_4_4_4_4_4_4_4_3_3_4_4_4_4_4_4_4_4_4_5_5_5_5_5_5_5
2032,133,1327393860,1,9,1,1327393920,60,603060,6181200,5578140,17_17_17_17_17_17_17_17_17_17_17_17_17_17_17_17_17_17_17_17_17_17_17_17_17_17_17_17_17_17_1_1_17_17_17_17_1
2033,133,1327393920,1,9,1,1327394100,180,603120,6181200,5578080,17_17_17_17_17_17_17_17_17_17_17_17_17_17_17_17_17_17_17_17_17_17_17_17_17_17_17_17_17_17_1_1_17_17_17_17_1_1
2034,133,1327394100,1,9,1,1327398600,4500,603300,6181200,5577900,17_17_17_17_17_17_17_17_17_17_17_17_17_17_17_17_17_17_17_17_17_17_17_17_17_17_17_17_17_17_1_1_17_17_17_17_1_1_1
2035,86,1327394400,4,22,4,1327409400,15000,1048380,3519180,2470800,0_0_0_0_1_0_0_0_0_1_0_0_0_0_1_1_0_0_1_1_1_1_1_1_2_2_4_4_4_4_4_4
2036,83,1327394580,18,23,18,1327398420,3840,1334580,1818000,483420,19_19_19_19_19_19_19_19_19_19_19_19_19_19_19_19_19_19_19_19_19_19_19_19_19_19_19_19_7_19_7_19_1_1_1_1_1_1_1_1_7_7_1_1_3_3_2_2_3_3_2_2_3_3_18_18
2037,63,1327395060,0,0,0,1327395120,60,543600,6232860,5689260,16_16_16_16_16_16_16_16_16_0_0_16_16_0_16_16_0_16_16_0_0_16_16_16_0_0_16_0_0_16_0_16_0_0_0_16_1_1_1_16_16_16_0_1_1_1_16_0_0_16_16_0_16_0_16_0_0_2_2_1_1_0_0_0_0_2_2_2_2_2_2_0_1_0_1_1_0_0
2038,63,1327395060,0,0,0,1327395060,0,543600,6232860,5689260,16_16_16_16_16_16_16_16_16_0_0_16_16_0_16_16_0_16_16_0_0_16_16_16_0_0_16_0_0_16_0_16_0_0_0_16_1_1_1_16_16_16_0_1_1_1_16_0_0_16_16_0_16_0_16_0_0_2_2_1_1_0_0_0_0_2_2_2_2_2_2_0_1_0_1_1_0
2039,63,1327395120,0,0,1,1327402200,7080,543660,6232860,5689200,16_16_16_16_16_16_16_16_16_0_0_16_16_0_16_16_0_16_16_0_0_16_16_16_0_0_16_0_0_16_0_16_0_0_0_16_1_1_1_16_16_16_0_1_1_1_16_0_0_16_16_0_16_0_16_0_0_2_2_1_1_0_0_0_0_2_2_2_2_2_2_0_1_0_1_1_0_0_0
2040,72,1327396980,3,3,5,1327402200,5220,1213740,2385960,1172220,17_17_17_1_17_1_17_1_1_17_17_17_17_1_1_17_17_17_38_38_17_17_1_24_24_24_24_1_24_1_1_24_24_24_24_24_8_8_2_2_3_3_3_5_3
2041,102,1327396980,16,20,16,1327397460,480,101220,3198240,3097020,43_43_43_43_16_16_8_1_16_1_8_16
2042,144,1327397040,2,3,3,1327397040,0,1292040,1807260,515220,10_10_10_1_10_10_1_10_10_10_1_10_10_1_10_1_1_10_1_1_2
2043,144,1327397040,3,3,3,1327397040,0,1292040,1807260,515220,10_10_10_1_10_10_1_10_10_10_1_10_10_1_10_1_1_10_1_1_2_3
2044,144,1327397040,3,3,2,1327401540,4500,1292040,1807260,515220,10_10_10_1_10_10_1_10_10_10_1_10_10_1_10_1_1_10_1_1_2_3_3
2045,102,1327397460,16,20,16,1327417740,20280,101700,3198240,3096540,43_43_43_43_16_16_8_1_16_1_8_16_16
2046,83,1327398420,18,23,18,1327401780,3360,1338420,1818000,479580,19_19_19_19_19_19_19_19_19_19_19_19_19_19_19_19_19_19_19_19_19_19_19_19_19_19_19_19_7_19_7_19_1_1_1_1_1_1_1_1_7_7_1_1_3_3_2_2_3_3_2_2_3_3_18_18_18
2047,133,1327398600,1,9,17,1327440420,41820,607800,6181200,5573400,17_17_17_17_17_17_17_17_17_17_17_17_17_17_17_17_17_17_17_17_17_17_17_17_17_17_17_17_17_17_1_1_17_17_17_17_1_1_1_1
2048,156,1327398720,16,11,16,1327412700,13980,0,2639280,2639280,16
2049,123,1327400520,16,20,16,1327417740,17220,445740,3545820,3100080,16_16_16_16_16
2050,115,1327400700,2,3,2,1327405020,4320,735900,954000,218100,19_19_19_19_19_19_1_19_1_19_19_19_1_1_2
2051,147,1327401000,7,8,7,1327431480,30480,18120,1479360,1461240,7_7
2052,144,1327401540,2,3,18,1327498200,96660,1296540,1807260,510720,10_10_10_1_10_10_1_10_10_10_1_10_10_1_10_1_1_10_1_1_2_3_3_2
2053,83,1327401780,18,23,18,1327409460,7680,1341780,1818000,476220,19_19_19_19_19_19_19_19_19_19_19_19_19_19_19_19_19_19_19_19_19_19_19_19_19_19_19_19_7_19_7_19_1_1_1_1_1_1_1_1_7_7_1_1_3_3_2_2_3_3_2_2_3_3_18_18_18_18_18
2054,83,1327401780,18,23,18,1327401780,0,1341780,1818000,476220,19_19_19_19_19_19_19_19_19_19_19_19_19_19_19_19_19_19_19_19_19_19_19_19_19_19_19_19_7_19_7_19_1_1_1_1_1_1_1_1_7_7_1_1_3_3_2_2_3_3_2_2_3_3_18_18_18_18
2055,63,1327402200,1,2,1,1327404000,1800,550740,6232860,5682120,16_16_16_16_16_16_16_16_16_0_0_16_16_0_16_16_0_16_16_0_0_16_16_16_0_0_16_0_0_16_0_16_0_0_0_16_1_1_1_16_16_16_0_1_1_1_16_0_0_16_16_0_16_0_16_0_0_2_2_1_1_0_0_0_0_2_2_2_2_2_2_0_1_0_1_1_0_0_0_1
2056,72,1327402200,5,18,5,1327405200,3000,1218960,2385960,1167000,17_17_17_1_17_1_17_1_1_17_17_17_17_1_1_17_17_17_38_38_17_17_1_24_24_24_24_1_24_1_1_24_24_24_24_24_8_8_2_2_3_3_3_5_3_5
2057,145,1327402800,5,9,6,1327442400,39600,507780,586680,78900,10_10_10_10_10_10_10_10_10_10_10_10_10_10_1_1_3_3_14_14_14_14_2_2_5_5
2058,63,1327404000,1,2,0,1327407900,3900,552540,6232860,5680320,16_16_16_16_16_16_16_16_16_0_0_16_16_0_16_16_0_16_16_0_0_16_16_16_0_0_16_0_0_16_0_16_0_0_0_16_1_1_1_16_16_16_0_1_1_1_16_0_0_16_16_0_16_0_16_0_0_2_2_1_1_0_0_0_0_2_2_2_2_2_2_0_1_0_1_1_0_0_0_1_1
2059,56,1327404600,5,18,5,1327409100,4500,1344600,6361440,5016840,6_6_5_5_8_8_8_8_26_26_5_5_6_6_5_5_5
2060,115,1327405020,2,3,9,1327569900,164880,740220,954000,213780,19_19_19_19_19_19_1_19_1_19_19_19_1_1_2_2
2061,117,1327405080,2,3,2,1327408320,3240,730800,1144740,413940,19_19_19_1_19_19_1_19_1_1_2
2062,72,1327405200,5,18,5,1327420920,15720,1221960,2385960,1164000,17_17_17_1_17_1_17_1_1_17_17_17_17_1_1_17_17_17_38_38_17_17_1_24_24_24_24_1_24_1_1_24_24_24_24_24_8_8_2_2_3_3_3_5_3_5_5
2063,63,1327407900,0,0,0,1327409280,1380,556440,6232860,5676420,16_16_16_16_16_16_16_16_16_0_0_16_16_0_16_16_0_16_16_0_0_16_16_16_0_0_16_0_0_16_0_16_0_0_0_16_1_1_1_16_16_16_0_1_1_1_16_0_0_16_16_0_16_0_16_0_0_2_2_1_1_0_0_0_0_2_2_2_2_2_2_0_1_0_1_1_0_0_0_1_1_0
2064,117,1327408320,2,3,3,1327408320,0,734040,1144740,410700,19_19_19_1_19_19_1_19_1_1_2_2
2065,117,1327408320,3,3,3,1327416120,7800,734040,1144740,410700,19_19_19_1_19_19_1_19_1_1_2_2_3
2066,12,1327408860,2,4,2,1327413960,5100,765420,850020,84600,17_17_17_1_17_17_1_17_17_17_17_17_17_17_1_17_17_1_17_17_17_1_1_17_7_7_17_17_17_17_2_2_1_1_2
2067,56,1327409100,5,18,5,1327411800,2700,1349100,6361440,5012340,6_6_5_5_8_8_8_8_26_26_5_5_6_6_5_5_5_5
2068,63,1327409280,0,1,1,1327410000,720,557820,6232860,5675040,16_16_16_16_16_16_16_16_16_0_0_16_16_0_16_16_0_16_16_0_0_16_16_16_0_0_16_0_0_16_0_16_0_0_0_16_1_1_1_16_16_16_0_1_1_1_16_0_0_16_16_0_16_0_16_0_0_2_2_1_1_0_0_0_0_2_2_2_2_2_2_0_1_0_1_1_0_0_0_1_1_0_0
2069,86,1327409400,4,22,4,1327428000,18600,1063380,3519180,2455800,0_0_0_0_1_0_0_0_0_1_0_0_0_0_1_1_0_0_1_1_1_1_1_1_2_2_4_4_4_4_4_4_4
2070,83,1327409460,18,23,18,1327409580,120,1349460,1818000,468540,19_19_19_19_19_19_19_19_19_19_19_19_19_19_19_19_19_19_19_19_19_19_19_19_19_19_19_19_7_19_7_19_1_1_1_1_1_1_1_1_7_7_1_1_3_3_2_2_3_3_2_2_3_3_18_18_18_18_18_18
2071,83,1327409580,18,22,18,1327420020,10440,1349580,1818000,468420,19_19_19_19_19_19_19_19_19_19_19_19_19_19_19_19_19_19_19_19_19_19_19_19_19_19_19_19_7_19_7_19_1_1_1_1_1_1_1_1_7_7_1_1_3_3_2_2_3_3_2_2_3_3_18_18_18_18_18_18_18
2072,63,1327410000,1,2,1,1327411200,1200,558540,6232860,5674320,16_16_16_16_16_16_16_16_16_0_0_16_16_0_16_16_0_16_16_0_0_16_16_16_0_0_16_0_0_16_0_16_0_0_0_16_1_1_1_16_16_16_0_1_1_1_16_0_0_16_16_0_16_0_16_0_0_2_2_1_1_0_0_0_0_2_2_2_2_2_2_0_1_0_1_1_0_0_0_1_1_0_0_1_1
2073,63,1327410000,1,2,1,1327410000,0,558540,6232860,5674320,16_16_16_16_16_16_16_16_16_0_0_16_16_0_16_16_0_16_16_0_0_16_16_16_0_0_16_0_0_16_0_16_0_0_0_16_1_1_1_16_16_16_0_1_1_1_16_0_0_16_16_0_16_0_16_0_0_2_2_1_1_0_0_0_0_2_2_2_2_2_2_0_1_0_1_1_0_0_0_1_1_0_0_1
2074,108,1327410600,17,10,1,1327411200,600,694740,3191940,2497200,1_1_1_17_1_17_17_17_17_17_17_17
2075,108,1327411200,1,2,1,1327420980,9780,695340,3191940,2496600,1_1_1_17_1_17_17_17_17_17_17_17_1
2076,63,1327411200,1,2,0,1327413480,2280,559740,6232860,5673120,16_16_16_16_16_16_16_16_16_0_0_16_16_0_16_16_0_16_16_0_0_16_16_16_0_0_16_0_0_16_0_16_0_0_0_16_1_1_1_16_16_16_0_1_1_1_16_0_0_16_16_0_16_0_16_0_0_2_2_1_1_0_0_0_0_2_2_2_2_2_2_0_1_0_1_1_0_0_0_1_1_0_0_1_1_1
2077,56,1327411800,5,18,5,1327413600,1800,1351800,6361440,5009640,6_6_5_5_8_8_8_8_26_26_5_5_6_6_5_5_5_5_5
2078,156,1327412700,16,11,16,1327476060,63360,13980,2639280,2625300,16_16
2079,66,1327413120,5,6,6,1327442400,29280,1932720,4817700,2884980,3_3_4_4_4_4_4_4_4_4_4_4_4_4_4_4_4_4_4_4_4_3_3_4_4_4_4_4_4_4_4_4_5_5_5_5_5_5_5_5
2080,63,1327413480,0,0,0,1327430880,17400,562020,6232860,5670840,16_16_16_16_16_16_16_16_16_0_0_16_16_0_16_16_0_16_16_0_0_16_16_16_0_0_16_0_0_16_0_16_0_0_0_16_1_1_1_16_16_16_0_1_1_1_16_0_0_16_16_0_16_0_16_0_0_2_2_1_1_0_0_0_0_2_2_2_2_2_2_0_1_0_1_1_0_0_0_1_1_0_0_1_1_1_0
2081,56,1327413600,5,18,6,1330552800,3139200,1353600,6361440,5007840,6_6_5_5_8_8_8_8_26_26_5_5_6_6_5_5_5_5_5_5
2082,96,1327413840,10,16,1,1327467600,53760,104040,2123400,2019360,10_1_10_10_10_10_1_10_10_10_10_10
2083,12,1327413960,2,4,6,1327442400,28440,770520,850020,79500,17_17_17_1_17_17_1_17_17_17_17_17_17_17_1_17_17_1_17_17_17_1_1_17_7_7_17_17_17_17_2_2_1_1_2_2
2084,61,1327413960,34,15,34,1327421220,7260,1958760,6225300,4266540,4_4_18_18_34_34_34_3_3_34_3_3_34_35_34_35_35_35_36_36_35_35_35_35_34_34_34_34_34
2085,117,1327416120,3,3,18,1327486140,70020,741840,1144740,402900,19_19_19_1_19_19_1_19_1_1_2_2_3_3
2086,142,1327417200,27,26,27,1327471200,54000,1658760,7299960,5641200,0_0_0_0_0_0_0_1_1_0_0_0_0_0_0_0_0_1_1_0_0_0_0_0_0_1_1_0_0_0_0_0_0_1_1_0_0_0_0_0_0_0_1_0_1_0_0_0_1_1_1_1_27_27_27_27_1_27_27_1_27_27_27_27
2087,112,1327417260,2,3,2,1327418040,780,842700,1303440,460740,19_19_19_19_19_1_1_19_19_19_1_1_47_47_2
2088,102,1327417740,16,20,2,1327472220,54480,121980,3198240,3076260,43_43_43_43_16_16_8_1_16_1_8_16_16_16
2089,123,1327417740,16,20,16,1327428480,10740,462960,3545820,3082860,16_16_16_16_16_16
2090,112,1327418040,2,3,3,1327482660,64620,843480,1303440,459960,19_19_19_19_19_1_1_19_19_19_1_1_47_47_2_2
2091,119,1327418100,2,3,2,1327418580,480,468480,2742780,2274300,7_7_7_1_1_7_7_7_7_7_7_7_7_7_1_1_2
2092,119,1327418580,2,3,3,1328997600,1579020,468960,2742780,2273820,7_7_7_1_1_7_7_7_7_7_7_7_7_7_1_1_2_2
2093,134,1327419360,13,17,13,1327468020,48660,605940,3656580,3050640,0_0_0_0_0_0_0_0_0_0_1_1_2_2_3_3_13_13_13_13_13_13
2094,83,1327420020,18,22,18,1327421280,1260,1360020,1818000,457980,19_19_19_19_19_19_19_19_19_19_19_19_19_19_19_19_19_19_19_19_19_19_19_19_19_19_19_19_7_19_7_19_1_1_1_1_1_1_1_1_7_7_1_1_3_3_2_2_3_3_2_2_3_3_18_18_18_18_18_18_18_18
2095,72,1327420920,5,18,5,1327474800,53880,1237680,2385960,1148280,17_17_17_1_17_1_17_1_1_17_17_17_17_1_1_17_17_17_38_38_17_17_1_24_24_24_24_1_24_1_1_24_24_24_24_24_8_8_2_2_3_3_3_5_3_5_5_5
2096,108,1327420980,1,2,17,1327475220,54240,705120,3191940,2486820,1_1_1_17_1_17_17_17_17_17_17_17_1_1
2097,61,1327421220,34,15,34,1327500600,79380,1966020,6225300,4259280,4_4_18_18_34_34_34_3_3_34_3_3_34_35_34_35_35_35_36_36_35_35_35_35_34_34_34_34_34_34
2098,83,1327421280,18,15,18,1327437660,16380,1361280,1818000,456720,19_19_19_19_19_19_19_19_19_19_19_19_19_19_19_19_19_19_19_19_19_19_19_19_19_19_19_19_7_19_7_19_1_1_1_1_1_1_1_1_7_7_1_1_3_3_2_2_3_3_2_2_3_3_18_18_18_18_18_18_18_18_18
2099,86,1327428000,4,5,4,1327433400,5400,1081980,3519180,2437200,0_0_0_0_1_0_0_0_0_1_0_0_0_0_1_1_0_0_1_1_1_1_1_1_2_2_4_4_4_4_4_4_4_4
2100,123,1327428480,16,14,16,1327459500,31020,473700,3545820,3072120,16_16_16_16_16_16_16
2101,63,1327430880,0,1,0,1327442040,11160,579420,6232860,5653440,16_16_16_16_16_16_16_16_16_0_0_16_16_0_16_16_0_16_16_0_0_16_16_16_0_0_16_0_0_16_0_16_0_0_0_16_1_1_1_16_16_16_0_1_1_1_16_0_0_16_16_0_16_0_16_0_0_2_2_1_1_0_0_0_0_2_2_2_2_2_2_0_1_0_1_1_0_0_0_1_1_0_0_1_1_1_0_0
2102,147,1327431480,7,12,7,1327440360,8880,48600,1479360,1430760,7_7_7
2103,77,1327433400,4,5,4,1327435200,1800,825240,3257040,2431800,0_0_1_0_0_1_0_0_0_0_0_0_0_0_0_0_0_0_1_0_1_0_2_2_4
2104,86,1327433400,4,5,4,1327437000,3600,1087380,3519180,2431800,0_0_0_0_1_0_0_0_0_1_0_0_0_0_1_1_0_0_1_1_1_1_1_1_2_2_4_4_4_4_4_4_4_4_4
2105,77,1327435200,4,5,4,1327439700,4500,827040,3257040,2430000,0_0_1_0_0_1_0_0_0_0_0_0_0_0_0_0_0_0_1_0_1_0_2_2_4_4_4
2106,77,1327435200,4,5,4,1327435200,0,827040,3257040,2430000,0_0_1_0_0_1_0_0_0_0_0_0_0_0_0_0_0_0_1_0_1_0_2_2_4_4
2107,86,1327437000,4,5,18,1328665800,1228800,1090980,3519180,2428200,0_0_0_0_1_0_0_0_0_1_0_0_0_0_1_1_0_0_1_1_1_1_1_1_2_2_4_4_4_4_4_4_4_4_4_4
2108,83,1327437660,18,15,18,1327468200,30540,1377660,1818000,440340,19_19_19_19_19_19_19_19_19_19_19_19_19_19_19_19_19_19_19_19_19_19_19_19_19_19_19_19_7_19_7_19_1_1_1_1_1_1_1_1_7_7_1_1_3_3_2_2_3_3_2_2_3_3_18_18_18_18_18_18_18_18_18_18
2109,77,1327439700,4,5,4,1327467600,27900,831540,3257040,2425500,0_0_1_0_0_1_0_0_0_0_0_0_0_0_0_0_0_0_1_0_1_0_2_2_4_4_4_4
2110,147,1327440360,7,12,7,1327440420,60,57480,1479360,1421880,7_7_7_7
2111,133,1327440420,17,12,17,1327450260,9840,649620,6181200,5531580,17_17_17_17_17_17_17_17_17_17_17_17_17_17_17_17_17_17_17_17_17_17_17_17_17_17_17_17_17_17_1_1_17_17_17_17_1_1_1_1_17
2112,147,1327440420,7,12,7,1327465620,25200,57540,1479360,1421820,7_7_7_7_7
2113,63,1327442040,0,14,0,1327465620,23580,590580,6232860,5642280,16_16_16_16_16_16_16_16_16_0_0_16_16_0_16_16_0_16_16_0_0_16_16_16_0_0_16_0_0_16_0_16_0_0_0_16_1_1_1_16_16_16_0_1_1_1_16_0_0_16_16_0_16_0_16_0_0_2_2_1_1_0_0_0_0_2_2_2_2_2_2_0_1_0_1_1_0_0_0_1_1_0_0_1_1_1_0_0_0
2114,145,1327442400,6,7,6,1327446000,3600,547380,586680,39300,10_10_10_10_10_10_10_10_10_10_10_10_10_10_1_1_3_3_14_14_14_14_2_2_5_5_6
2115,66,1327442400,6,7,6,1327446000,3600,1962000,4817700,2855700,3_3_4_4_4_4_4_4_4_4_4_4_4_4_4_4_4_4_4_4_4_3_3_4_4_4_4_4_4_4_4_4_5_5_5_5_5_5_5_5_6
2116,12,1327442400,6,7,6,1327446000,3600,798960,850020,51060,17_17_17_1_17_17_1_17_17_17_17_17_17_17_1_17_17_1_17_17_17_1_1_17_7_7_17_17_17_17_2_2_1_1_2_2_6
2117,12,1327446000,6,7,5,1327482660,36660,802560,850020,47460,17_17_17_1_17_17_1_17_17_17_17_17_17_17_1_17_17_1_17_17_17_1_1_17_7_7_17_17_17_17_2_2_1_1_2_2_6_6
2118,145,1327446000,6,7,5,1327472220,26220,550980,586680,35700,10_10_10_10_10_10_10_10_10_10_10_10_10_10_1_1_3_3_14_14_14_14_2_2_5_5_6_6
2119,66,1327446000,6,7,5,1327478460,32460,1965600,4817700,2852100,3_3_4_4_4_4_4_4_4_4_4_4_4_4_4_4_4_4_4_4_4_3_3_4_4_4_4_4_4_4_4_4_5_5_5_5_5_5_5_5_6_6
2120,133,1327450260,17,12,17,1327450260,0,659460,6181200,5521740,17_17_17_17_17_17_17_17_17_17_17_17_17_17_17_17_17_17_17_17_17_17_17_17_17_17_17_17_17_17_1_1_17_17_17_17_1_1_1_1_17_17
2121,133,1327450260,17,12,17,1327465680,15420,659460,6181200,5521740,17_17_17_17_17_17_17_17_17_17_17_17_17_17_17_17_17_17_17_17_17_17_17_17_17_17_17_17_17_17_1_1_17_17_17_17_1_1_1_1_17_17_17
2122,123,1327459500,16,14,16,1327459560,60,504720,3545820,3041100,16_16_16_16_16_16_16_16
2123,123,1327459560,16,14,16,1327465620,6060,504780,3545820,3041040,16_16_16_16_16_16_16_16_16
2124,123,1327465620,16,14,16,1327467300,1680,510840,3545820,3034980,16_16_16_16_16_16_16_16_16_16
2125,63,1327465620,0,14,0,1327467780,2160,614160,6232860,5618700,16_16_16_16_16_16_16_16_16_0_0_16_16_0_16_16_0_16_16_0_0_16_16_16_0_0_16_0_0_16_0_16_0_0_0_16_1_1_1_16_16_16_0_1_1_1_16_0_0_16_16_0_16_0_16_0_0_2_2_1_1_0_0_0_0_2_2_2_2_2_2_0_1_0_1_1_0_0_0_1_1_0_0_1_1_1_0_0_0_0
2126,147,1327465620,7,12,7,1327468140,2520,82740,1479360,1396620,7_7_7_7_7_7
2127,133,1327465680,17,12,17,1327468260,2580,674880,6181200,5506320,17_17_17_17_17_17_17_17_17_17_17_17_17_17_17_17_17_17_17_17_17_17_17_17_17_17_17_17_17_17_1_1_17_17_17_17_1_1_1_1_17_17_17_17
2128,126,1327467000,1,9,1,1327468620,1620,85560,496560,411000,19_19_19_19_19_19_1
2129,123,1327467300,16,20,16,1327476000,8700,512520,3545820,3033300,16_16_16_16_16_16_16_16_16_16_16
2130,96,1327467600,1,18,1,1327473600,6000,157800,2123400,1965600,10_1_10_10_10_10_1_10_10_10_10_10_1
2131,77,1327467600,4,22,4,1327476600,9000,859440,3257040,2397600,0_0_1_0_0_1_0_0_0_0_0_0_0_0_0_0_0_0_1_0_1_0_2_2_4_4_4_4_4
2132,94,1327467600,1,6,1,1327468560,960,180000,534480,354480,7_7_7_7_7_7_7_7_7_7_1
2133,63,1327467780,0,0,2,1327495740,27960,616320,6232860,5616540,16_16_16_16_16_16_16_16_16_0_0_16_16_0_16_16_0_16_16_0_0_16_16_16_0_0_16_0_0_16_0_16_0_0_0_16_1_1_1_16_16_16_0_1_1_1_16_0_0_16_16_0_16_0_16_0_0_2_2_1_1_0_0_0_0_2_2_2_2_2_2_0_1_0_1_1_0_0_0_1_1_0_0_1_1_1_0_0_0_0_0
2134,134,1327468020,13,17,13,1327485900,17880,654600,3656580,3001980,0_0_0_0_0_0_0_0_0_0_1_1_2_2_3_3_13_13_13_13_13_13_13
2135,147,1327468140,7,8,1,1327468620,480,85260,1479360,1394100,7_7_7_7_7_7_7
2136,83,1327468200,18,23,18,1327473540,5340,1408200,1818000,409800,19_19_19_19_19_19_19_19_19_19_19_19_19_19_19_19_19_19_19_19_19_19_19_19_19_19_19_19_7_19_7_19_1_1_1_1_1_1_1_1_7_7_1_1_3_3_2_2_3_3_2_2_3_3_18_18_18_18_18_18_18_18_18_18_18
2137,133,1327468260,17,10,17,1327475160,6900,677460,6181200,5503740,17_17_17_17_17_17_17_17_17_17_17_17_17_17_17_17_17_17_17_17_17_17_17_17_17_17_17_17_17_17_1_1_17_17_17_17_1_1_1_1_17_17_17_17_17
2138,94,1327468560,1,6,2,1327472280,3720,180960,534480,353520,7_7_7_7_7_7_7_7_7_7_1_1
2139,126,1327468620,1,9,19,1327554120,85500,87180,496560,409380,19_19_19_19_19_19_1_1
2140,147,1327468620,1,9,7,1327469340,720,85740,1479360,1393620,7_7_7_7_7_7_7_1
2141,147,1327469340,7,8,1,1327471500,2160,86460,1479360,1392900,7_7_7_7_7_7_7_1_7
2142,166,1327469400,7,8,7,1327482900,13500,0,1666080,1666080,7
2143,143,1327471080,10,16,10,1327502880,31800,0,1898460,1898460,10
2144,142,1327471200,27,26,27,1327496400,25200,1712760,7299960,5587200,0_0_0_0_0_0_0_1_1_0_0_0_0_0_0_0_0_1_1_0_0_0_0_0_0_1_1_0_0_0_0_0_0_1_1_0_0_0_0_0_0_0_1_0_1_0_0_0_1_1_1_1_27_27_27_27_1_27_27_1_27_27_27_27_27
2145,147,1327471500,1,9,9,1327582200,110700,88620,1479360,1390740,7_7_7_7_7_7_7_1_7_1
2146,102,1327472220,2,3,2,1327475820,3600,176460,3198240,3021780,43_43_43_43_16_16_8_1_16_1_8_16_16_16_2
2147,145,1327472220,5,9,5,1327481700,9480,577200,586680,9480,10_10_10_10_10_10_10_10_10_10_10_10_10_10_1_1_3_3_14_14_14_14_2_2_5_5_6_6_5
2148,94,1327472280,2,3,2,1327475820,3540,184680,534480,349800,7_7_7_7_7_7_7_7_7_7_1_1_2
2149,83,1327473540,18,23,5,1327554000,80460,1413540,1818000,404460,19_19_19_19_19_19_19_19_19_19_19_19_19_19_19_19_19_19_19_19_19_19_19_19_19_19_19_19_7_19_7_19_1_1_1_1_1_1_1_1_7_7_1_1_3_3_2_2_3_3_2_2_3_3_18_18_18_18_18_18_18_18_18_18_18_18
2150,96,1327473600,1,18,2,1327932660,459060,163800,2123400,1959600,10_1_10_10_10_10_1_10_10_10_10_10_1_1
2151,72,1327474800,5,18,5,1327500060,25260,1291560,2385960,1094400,17_17_17_1_17_1_17_1_1_17_17_17_17_1_1_17_17_17_38_38_17_17_1_24_24_24_24_1_24_1_1_24_24_24_24_24_8_8_2_2_3_3_3_5_3_5_5_5_5
2152,133,1327475160,17,10,17,1327930260,455100,684360,6181200,5496840,17_17_17_17_17_17_17_17_17_17_17_17_17_17_17_17_17_17_17_17_17_17_17_17_17_17_17_17_17_17_1_1_17_17_17_17_1_1_1_1_17_17_17_17_17_17
2153,108,1327475220,17,10,17,1327499040,23820,759360,3191940,2432580,1_1_1_17_1_17_17_17_17_17_17_17_1_1_17
2154,94,1327475820,2,3,3,1327475880,60,188220,534480,346260,7_7_7_7_7_7_7_7_7_7_1_1_2_2
2155,102,1327475820,2,3,3,1327564260,88440,180060,3198240,3018180,43_43_43_43_16_16_8_1_16_1_8_16_16_16_2_2
2156,94,1327475880,3,3,3,1327482660,6780,188280,534480,346200,7_7_7_7_7_7_7_7_7_7_1_1_2_2_3
2157,123,1327476000,16,20,1,1327640400,164400,521220,3545820,3024600,16_16_16_16_16_16_16_16_16_16_16_16
2158,156,1327476060,16,20,16,1327507200,31140,77340,2639280,2561940,16_16_16
2159,77,1327476600,4,22,4,1327558860,82260,868440,3257040,2388600,0_0_1_0_0_1_0_0_0_0_0_0_0_0_0_0_0_0_1_0_1_0_2_2_4_4_4_4_4_4
2160,1,1327476660,2,11,2,1327481820,5160,700200,1447140,746940,7_8_7_8_7_7_7_7_7_7_7_7_7_7_7_7_7_7_7_7_7_7_7_7_7_7_7_7_7_7_8_8_2
2161,66,1327478460,5,6,5,1327485660,7200,1998060,4817700,2819640,3_3_4_4_4_4_4_4_4_4_4_4_4_4_4_4_4_4_4_4_4_3_3_4_4_4_4_4_4_4_4_4_5_5_5_5_5_5_5_5_6_6_5
2162,145,1327481700,5,9,99,1327481700,0,586680,586680,0,10_10_10_10_10_10_10_10_10_10_10_10_10_10_1_1_3_3_14_14_14_14_2_2_5_5_6_6_5_5
2163,1,1327481820,2,11,2,1327482000,180,705360,1447140,741780,7_8_7_8_7_7_7_7_7_7_7_7_7_7_7_7_7_7_7_7_7_7_7_7_7_7_7_7_7_7_8_8_2_2
2164,1,1327482000,2,4,2,1327488840,6840,705540,1447140,741600,7_8_7_8_7_7_7_7_7_7_7_7_7_7_7_7_7_7_7_7_7_7_7_7_7_7_7_7_7_7_8_8_2_2_2
2165,94,1327482660,3,3,13,1327486200,3540,195060,534480,339420,7_7_7_7_7_7_7_7_7_7_1_1_2_2_3_3
2166,112,1327482660,3,3,3,1327486320,3660,908100,1303440,395340,19_19_19_19_19_1_1_19_19_19_1_1_47_47_2_2_3
2167,12,1327482660,5,9,5,1327493340,10680,839220,850020,10800,17_17_17_1_17_17_1_17_17_17_17_17_17_17_1_17_17_1_17_17_17_1_1_17_7_7_17_17_17_17_2_2_1_1_2_2_6_6_5
2168,166,1327482900,7,8,7,1327482960,60,13500,1666080,1652580,7_7
2169,166,1327482960,7,8,1,1327483020,60,13560,1666080,1652520,7_7_7
2170,166,1327483020,1,9,7,1327486800,3780,13620,1666080,1652460,7_7_7_1
2171,66,1327485660,5,6,5,1327639740,154080,2005260,4817700,2812440,3_3_4_4_4_4_4_4_4_4_4_4_4_4_4_4_4_4_4_4_4_3_3_4_4_4_4_4_4_4_4_4_5_5_5_5_5_5_5_5_6_6_5_5
2172,134,1327485900,13,17,15,1327571340,85440,672480,3656580,2984100,0_0_0_0_0_0_0_0_0_0_1_1_2_2_3_3_13_13_13_13_13_13_13_13
2173,117,1327486140,18,23,18,1327494960,8820,811860,1144740,332880,19_19_19_1_19_19_1_19_1_1_2_2_3_3_18
2174,94,1327486200,13,17,13,1327488600,2400,198600,534480,335880,7_7_7_7_7_7_7_7_7_7_1_1_2_2_3_3_13
2175,112,1327486320,3,3,5,1327494060,7740,911760,1303440,391680,19_19_19_19_19_1_1_19_19_19_1_1_47_47_2_2_3_3
2176,101,1327486380,2,3,2,1327487880,1500,263400,655020,391620,10_8_8_10_10_10_10_10_8_8_2
2177,166,1327486800,7,8,7,1327486860,60,17400,1666080,1648680,7_7_7_1_7
2178,166,1327486860,7,8,1,1327494000,7140,17460,1666080,1648620,7_7_7_1_7_7
2179,101,1327487880,2,3,9,1327487940,60,264900,655020,390120,10_8_8_10_10_10_10_10_8_8_2_2
2180,101,1327487940,9,3,2,1327495440,7500,264960,655020,390060,10_8_8_10_10_10_10_10_8_8_2_2_9
2181,94,1327488600,13,17,13,1327490400,1800,201000,534480,333480,7_7_7_7_7_7_7_7_7_7_1_1_2_2_3_3_13_13
2182,1,1327488840,2,4,2,1327490520,1680,712380,1447140,734760,7_8_7_8_7_7_7_7_7_7_7_7_7_7_7_7_7_7_7_7_7_7_7_7_7_7_7_7_7_7_8_8_2_2_2_2
2183,94,1327490400,13,17,13,1327496400,6000,202800,534480,331680,7_7_7_7_7_7_7_7_7_7_1_1_2_2_3_3_13_13_13
2184,1,1327490520,2,4,2,1327493340,2820,714060,1447140,733080,7_8_7_8_7_7_7_7_7_7_7_7_7_7_7_7_7_7_7_7_7_7_7_7_7_7_7_7_7_7_8_8_2_2_2_2_2
2185,12,1327493340,5,9,1,1327493400,60,849900,850020,120,17_17_17_1_17_17_1_17_17_17_17_17_17_17_1_17_17_1_17_17_17_1_1_17_7_7_17_17_17_17_2_2_1_1_2_2_6_6_5_5
2186,1,1327493340,2,4,9,1327653000,159660,716880,1447140,730260,7_8_7_8_7_7_7_7_7_7_7_7_7_7_7_7_7_7_7_7_7_7_7_7_7_7_7_7_7_7_8_8_2_2_2_2_2_2
2187,12,1327493400,1,9,1,1327493460,60,849960,850020,60,17_17_17_1_17_17_1_17_17_17_17_17_17_17_1_17_17_1_17_17_17_1_1_17_7_7_17_17_17_17_2_2_1_1_2_2_6_6_5_5_1
2188,12,1327493460,1,9,99,1327493460,0,850020,850020,0,17_17_17_1_17_17_1_17_17_17_17_17_17_17_1_17_17_1_17_17_17_1_1_17_7_7_17_17_17_17_2_2_1_1_2_2_6_6_5_5_1_1
2189,166,1327494000,1,9,7,1327499700,5700,24600,1666080,1641480,7_7_7_1_7_7_1
2190,112,1327494060,5,9,5,1327507320,13260,919500,1303440,383940,19_19_19_19_19_1_1_19_19_19_1_1_47_47_2_2_3_3_5
2191,117,1327494960,18,23,18,1327494960,0,820680,1144740,324060,19_19_19_1_19_19_1_19_1_1_2_2_3_3_18_18
2192,117,1327494960,18,23,18,1327499640,4680,820680,1144740,324060,19_19_19_1_19_19_1_19_1_1_2_2_3_3_18_18_18
2193,101,1327495440,2,4,9,1327495800,360,272460,655020,382560,10_8_8_10_10_10_10_10_8_8_2_2_9_2
2194,63,1327495740,2,3,2,1327495800,60,644280,6232860,5588580,16_16_16_16_16_16_16_16_16_0_0_16_16_0_16_16_0_16_16_0_0_16_16_16_0_0_16_0_0_16_0_16_0_0_0_16_1_1_1_16_16_16_0_1_1_1_16_0_0_16_16_0_16_0_16_0_0_2_2_1_1_0_0_0_0_2_2_2_2_2_2_0_1_0_1_1_0_0_0_1_1_0_0_1_1_1_0_0_0_0_0_2
2195,63,1327495800,2,3,2,1327497660,1860,644340,6232860,5588520,16_16_16_16_16_16_16_16_16_0_0_16_16_0_16_16_0_16_16_0_0_16_16_16_0_0_16_0_0_16_0_16_0_0_0_16_1_1_1_16_16_16_0_1_1_1_16_0_0_16_16_0_16_0_16_0_0_2_2_1_1_0_0_0_0_2_2_2_2_2_2_0_1_0_1_1_0_0_0_1_1_0_0_1_1_1_0_0_0_0_0_2_2
2196,84,1327495800,3,3,3,1327504260,8460,1836900,3714840,1877940,17_17_17_17_17_17_17_17_17_17_17_17_17_17_17_17_1_1_2_2_3
2197,101,1327495800,9,3,2,1327497720,1920,272820,655020,382200,10_8_8_10_10_10_10_10_8_8_2_2_9_2_9
2198,142,1327496400,27,26,27,1327557600,61200,1737960,7299960,5562000,0_0_0_0_0_0_0_1_1_0_0_0_0_0_0_0_0_1_1_0_0_0_0_0_0_1_1_0_0_0_0_0_0_1_1_0_0_0_0_0_0_0_1_0_1_0_0_0_1_1_1_1_27_27_27_27_1_27_27_1_27_27_27_27_27_27
2199,82,1327496400,13,17,13,1327500000,3600,1468680,2195880,727200,1_1_2_2_3_3_14_14_14_14_5_5_5_5_6_6_13
2200,94,1327496400,13,17,5,1327655520,159120,208800,534480,325680,7_7_7_7_7_7_7_7_7_7_1_1_2_2_3_3_13_13_13_13
2201,63,1327497660,2,4,2,1327499220,1560,646200,6232860,5586660,16_16_16_16_16_16_16_16_16_0_0_16_16_0_16_16_0_16_16_0_0_16_16_16_0_0_16_0_0_16_0_16_0_0_0_16_1_1_1_16_16_16_0_1_1_1_16_0_0_16_16_0_16_0_16_0_0_2_2_1_1_0_0_0_0_2_2_2_2_2_2_0_1_0_1_1_0_0_0_1_1_0_0_1_1_1_0_0_0_0_0_2_2_2
2202,101,1327497720,2,4,5,1327651200,153480,274740,655020,380280,10_8_8_10_10_10_10_10_8_8_2_2_9_2_9_2
2203,144,1327498200,18,23,18,1327506600,8400,1393200,1807260,414060,10_10_10_1_10_10_1_10_10_10_1_10_10_1_10_1_1_10_1_1_2_3_3_2_18
2204,108,1327499040,17,10,7,1327524360,25320,783180,3191940,2408760,1_1_1_17_1_17_17_17_17_17_17_17_1_1_17_17
2205,63,1327499220,2,4,0,1327500000,780,647760,6232860,5585100,16_16_16_16_16_16_16_16_16_0_0_16_16_0_16_16_0_16_16_0_0_16_16_16_0_0_16_0_0_16_0_16_0_0_0_16_1_1_1_16_16_16_0_1_1_1_16_0_0_16_16_0_16_0_16_0_0_2_2_1_1_0_0_0_0_2_2_2_2_2_2_0_1_0_1_1_0_0_0_1_1_0_0_1_1_1_0_0_0_0_0_2_2_2_2
2206,117,1327499640,18,23,5,1327562460,62820,825360,1144740,319380,19_19_19_1_19_19_1_19_1_1_2_2_3_3_18_18_18_18
2207,166,1327499700,7,8,7,1327513800,14100,30300,1666080,1635780,7_7_7_1_7_7_1_7
2208,82,1327500000,13,17,13,1327506300,6300,1472280,2195880,723600,1_1_2_2_3_3_14_14_14_14_5_5_5_5_6_6_13_13_13
2209,82,1327500000,13,17,13,1327500000,0,1472280,2195880,723600,1_1_2_2_3_3_14_14_14_14_5_5_5_5_6_6_13_13
2210,63,1327500000,0,1,0,1327500300,300,648540,6232860,5584320,16_16_16_16_16_16_16_16_16_0_0_16_16_0_16_16_0_16_16_0_0_16_16_16_0_0_16_0_0_16_0_16_0_0_0_16_1_1_1_16_16_16_0_1_1_1_16_0_0_16_16_0_16_0_16_0_0_2_2_1_1_0_0_0_0_2_2_2_2_2_2_0_1_0_1_1_0_0_0_1_1_0_0_1_1_1_0_0_0_0_0_2_2_2_2_0
2211,72,1327500060,5,18,5,1327554360,54300,1316820,2385960,1069140,17_17_17_1_17_1_17_1_1_17_17_17_17_1_1_17_17_17_38_38_17_17_1_24_24_24_24_1_24_1_1_24_24_24_24_24_8_8_2_2_3_3_3_5_3_5_5_5_5_5
2212,63,1327500300,0,0,0,1327515720,15420,648840,6232860,5584020,16_16_16_16_16_16_16_16_16_0_0_16_16_0_16_16_0_16_16_0_0_16_16_16_0_0_16_0_0_16_0_16_0_0_0_16_1_1_1_16_16_16_0_1_1_1_16_0_0_16_16_0_16_0_16_0_0_2_2_1_1_0_0_0_0_2_2_2_2_2_2_0_1_0_1_1_0_0_0_1_1_0_0_1_1_1_0_0_0_0_0_2_2_2_2_0_0
2213,61,1327500600,34,15,34,1327519620,19020,2045400,6225300,4179900,4_4_18_18_34_34_34_3_3_34_3_3_34_35_34_35_35_35_36_36_35_35_35_35_34_34_34_34_34_34_34
2214,143,1327502880,10,16,1,1327503720,840,31800,1898460,1866660,10_10_10
2215,143,1327502880,10,16,10,1327502880,0,31800,1898460,1866660,10_10
2216,143,1327503720,1,9,10,1327507200,3480,32640,1898460,1865820,10_10_10_1
2217,84,1327504260,3,3,18,1328126880,622620,1845360,3714840,1869480,17_17_17_17_17_17_17_17_17_17_17_17_17_17_17_17_1_1_2_2_3_3
2218,82,1327506300,13,17,13,1327553400,47100,1478580,2195880,717300,1_1_2_2_3_3_14_14_14_14_5_5_5_5_6_6_13_13_13_13
2219,144,1327506600,18,19,18,1327507200,600,1401600,1807260,405660,10_10_10_1_10_10_1_10_10_10_1_10_10_1_10_1_1_10_1_1_2_3_3_2_18_18
2220,144,1327507200,18,23,18,1327528080,20880,1402200,1807260,405060,10_10_10_1_10_10_1_10_10_10_1_10_10_1_10_1_1_10_1_1_2_3_3_2_18_18_18
2221,143,1327507200,10,16,1,1327507320,120,36120,1898460,1862340,10_10_10_1_10
2222,156,1327507200,16,20,16,1327514280,7080,108480,2639280,2530800,16_16_16_16
2223,112,1327507320,5,9,5,1327658400,151080,932760,1303440,370680,19_19_19_19_19_1_1_19_19_19_1_1_47_47_2_2_3_3_5_5
2224,143,1327507320,1,9,10,1327555560,48240,36240,1898460,1862220,10_10_10_1_10_1
2225,166,1327513800,7,12,7,1327529040,15240,44400,1666080,1621680,7_7_7_1_7_7_1_7_7
2226,156,1327514280,16,14,16,1327553040,38760,115560,2639280,2523720,16_16_16_16_16
2227,63,1327515720,0,1,0,1327515840,120,664260,6232860,5568600,16_16_16_16_16_16_16_16_16_0_0_16_16_0_16_16_0_16_16_0_0_16_16_16_0_0_16_0_0_16_0_16_0_0_0_16_1_1_1_16_16_16_0_1_1_1_16_0_0_16_16_0_16_0_16_0_0_2_2_1_1_0_0_0_0_2_2_2_2_2_2_0_1_0_1_1_0_0_0_1_1_0_0_1_1_1_0_0_0_0_0_2_2_2_2_0_0_0
2228,63,1327515840,0,14,0,1327552980,37140,664380,6232860,5568480,16_16_16_16_16_16_16_16_16_0_0_16_16_0_16_16_0_16_16_0_0_16_16_16_0_0_16_0_0_16_0_16_0_0_0_16_1_1_1_16_16_16_0_1_1_1_16_0_0_16_16_0_16_0_16_0_0_2_2_1_1_0_0_0_0_2_2_2_2_2_2_0_1_0_1_1_0_0_0_1_1_0_0_1_1_1_0_0_0_0_0_2_2_2_2_0_0_0_0
2229,61,1327519620,34,15,34,1327818060,298440,2064420,6225300,4160880,4_4_18_18_34_34_34_3_3_34_3_3_34_35_34_35_35_35_36_36_35_35_35_35_34_34_34_34_34_34_34_34
2230,108,1327524360,7,12,7,1327528980,4620,808500,3191940,2383440,1_1_1_17_1_17_17_17_17_17_17_17_1_1_17_17_7
2231,144,1327528080,18,19,13,1327559700,31620,1423080,1807260,384180,10_10_10_1_10_10_1_10_10_10_1_10_10_1_10_1_1_10_1_1_2_3_3_2_18_18_18_18
2232,108,1327528980,7,12,17,1327529040,60,813120,3191940,2378820,1_1_1_17_1_17_17_17_17_17_17_17_1_1_17_17_7_7
2233,108,1327529040,17,12,17,1327552320,23280,813180,3191940,2378760,1_1_1_17_1_17_17_17_17_17_17_17_1_1_17_17_7_7_17
2234,166,1327529040,7,12,21,1327651200,122160,59640,1666080,1606440,7_7_7_1_7_7_1_7_7_7
2235,23,1327538280,24,12,24,1327554000,15720,0,1894920,1894920,24
2236,108,1327552320,17,12,1,1327554000,1680,836460,3191940,2355480,1_1_1_17_1_17_17_17_17_17_17_17_1_1_17_17_7_7_17_17
2237,63,1327552980,0,14,0,1327553040,60,701520,6232860,5531340,16_16_16_16_16_16_16_16_16_0_0_16_16_0_16_16_0_16_16_0_0_16_16_16_0_0_16_0_0_16_0_16_0_0_0_16_1_1_1_16_16_16_0_1_1_1_16_0_0_16_16_0_16_0_16_0_0_2_2_1_1_0_0_0_0_2_2_2_2_2_2_0_1_0_1_1_0_0_0_1_1_0_0_1_1_1_0_0_0_0_0_2_2_2_2_0_0_0_0_0
2238,156,1327553040,16,14,16,1327555440,2400,154320,2639280,2484960,16_16_16_16_16_16
2239,63,1327553040,0,0,1,1327564800,11760,701580,6232860,5531280,16_16_16_16_16_16_16_16_16_0_0_16_16_0_16_16_0_16_16_0_0_16_16_16_0_0_16_0_0_16_0_16_0_0_0_16_1_1_1_16_16_16_0_1_1_1_16_0_0_16_16_0_16_0_16_0_0_2_2_1_1_0_0_0_0_2_2_2_2_2_2_0_1_0_1_1_0_0_0_1_1_0_0_1_1_1_0_0_0_0_0_2_2_2_2_0_0_0_0_0_0
2240,82,1327553400,13,17,13,1327559400,6000,1525680,2195880,670200,1_1_2_2_3_3_14_14_14_14_5_5_5_5_6_6_13_13_13_13_13
2241,83,1327554000,5,2,5,1327555800,1800,1494000,1818000,324000,19_19_19_19_19_19_19_19_19_19_19_19_19_19_19_19_19_19_19_19_19_19_19_19_19_19_19_19_7_19_7_19_1_1_1_1_1_1_1_1_7_7_1_1_3_3_2_2_3_3_2_2_3_3_18_18_18_18_18_18_18_18_18_18_18_18_5
2242,23,1327554000,24,12,24,1327558620,4620,15720,1894920,1879200,24_24
2243,108,1327554000,1,2,1,1327560000,6000,838140,3191940,2353800,1_1_1_17_1_17_17_17_17_17_17_17_1_1_17_17_7_7_17_17_1
2244,126,1327554120,19,11,19,1327578900,24780,172680,496560,323880,19_19_19_19_19_19_1_1_19
2245,72,1327554360,5,18,5,1327565220,10860,1371120,2385960,1014840,17_17_17_1_17_1_17_1_1_17_17_17_17_1_1_17_17_17_38_38_17_17_1_24_24_24_24_1_24_1_1_24_24_24_24_24_8_8_2_2_3_3_3_5_3_5_5_5_5_5_5
2246,156,1327555440,16,20,16,1327587360,31920,156720,2639280,2482560,16_16_16_16_16_16_16
2247,143,1327555560,10,16,1,1327558500,2940,84480,1898460,1813980,10_10_10_1_10_1_10
2248,83,1327555800,5,2,5,1327561200,5400,1495800,1818000,322200,19_19_19_19_19_19_19_19_19_19_19_19_19_19_19_19_19_19_19_19_19_19_19_19_19_19_19_19_7_19_7_19_1_1_1_1_1_1_1_1_7_7_1_1_3_3_2_2_3_3_2_2_3_3_18_18_18_18_18_18_18_18_18_18_18_18_5_5
2249,142,1327557600,27,27,27,1327584600,27000,1799160,7299960,5500800,0_0_0_0_0_0_0_1_1_0_0_0_0_0_0_0_0_1_1_0_0_0_0_0_0_1_1_0_0_0_0_0_0_1_1_0_0_0_0_0_0_0_1_0_1_0_0_0_1_1_1_1_27_27_27_27_1_27_27_1_27_27_27_27_27_27_27
2250,65,1327557600,3,3,3,1327564800,7200,2016000,7544400,5528400,17_17_34_34_6_6_6_6_5_5_1_1_1_1_2_2_3
2251,143,1327558500,1,9,1,1327562400,3900,87420,1898460,1811040,10_10_10_1_10_1_10_1
2252,23,1327558620,24,10,24,1327565340,6720,20340,1894920,1874580,24_24_24
2253,77,1327558860,4,22,4,1327586160,27300,950700,3257040,2306340,0_0_1_0_0_1_0_0_0_0_0_0_0_0_0_0_0_0_1_0_1_0_2_2_4_4_4_4_4_4_4
2254,82,1327559400,13,17,5,1328170680,611280,1531680,2195880,664200,1_1_2_2_3_3_14_14_14_14_5_5_5_5_6_6_13_13_13_13_13_13
2255,144,1327559700,13,17,13,1327563060,3360,1454700,1807260,352560,10_10_10_1_10_10_1_10_10_10_1_10_10_1_10_1_1_10_1_1_2_3_3_2_18_18_18_18_13
2256,108,1327560000,1,2,1,1327561200,1200,844140,3191940,2347800,1_1_1_17_1_17_17_17_17_17_17_17_1_1_17_17_7_7_17_17_1_1
2257,83,1327561200,5,2,5,1327564800,3600,1501200,1818000,316800,19_19_19_19_19_19_19_19_19_19_19_19_19_19_19_19_19_19_19_19_19_19_19_19_19_19_19_19_7_19_7_19_1_1_1_1_1_1_1_1_7_7_1_1_3_3_2_2_3_3_2_2_3_3_18_18_18_18_18_18_18_18_18_18_18_18_5_5_5
2258,75,1327561200,39,37,39,1327566600,5400,1452660,6135000,4682340,16_16_16_16_16_16_1_16_16_1_16_16_16_16_16_16_16_16_1_1_2_2_39
2259,108,1327561200,1,2,1,1327564800,3600,845340,3191940,2346600,1_1_1_17_1_17_17_17_17_17_17_17_1_1_17_17_7_7_17_17_1_1_1
2260,143,1327562400,1,9,10,1327570440,8040,91320,1898460,1807140,10_10_10_1_10_1_10_1_1
2261,117,1327562460,5,9,5,1327583880,21420,888180,1144740,256560,19_19_19_1_19_19_1_19_1_1_2_2_3_3_18_18_18_18_5
2262,144,1327563060,13,17,13,1327563120,60,1458060,1807260,349200,10_10_10_1_10_10_1_10_10_10_1_10_10_1_10_1_1_10_1_1_2_3_3_2_18_18_18_18_13_13
2263,144,1327563120,13,17,13,1327567860,4740,1458120,1807260,349140,10_10_10_1_10_10_1_10_10_10_1_10_10_1_10_1_1_10_1_1_2_3_3_2_18_18_18_18_13_13_13
2264,102,1327564260,3,3,3,1327567860,3600,268500,3198240,2929740,43_43_43_43_16_16_8_1_16_1_8_16_16_16_2_2_3
2265,63,1327564800,1,2,1,1327575000,10200,713340,6232860,5519520,16_16_16_16_16_16_16_16_16_0_0_16_16_0_16_16_0_16_16_0_0_16_16_16_0_0_16_0_0_16_0_16_0_0_0_16_1_1_1_16_16_16_0_1_1_1_16_0_0_16_16_0_16_0_16_0_0_2_2_1_1_0_0_0_0_2_2_2_2_2_2_0_1_0_1_1_0_0_0_1_1_0_0_1_1_1_0_0_0_0_0_2_2_2_2_0_0_0_0_0_0_1
2266,108,1327564800,1,2,17,1327565400,600,848940,3191940,2343000,1_1_1_17_1_17_17_17_17_17_17_17_1_1_17_17_7_7_17_17_1_1_1_1
2267,65,1327564800,3,3,5,1327914000,349200,2023200,7544400,5521200,17_17_34_34_6_6_6_6_5_5_1_1_1_1_2_2_3_3
2268,83,1327564800,5,2,5,1327568400,3600,1504800,1818000,313200,19_19_19_19_19_19_19_19_19_19_19_19_19_19_19_19_19_19_19_19_19_19_19_19_19_19_19_19_7_19_7_19_1_1_1_1_1_1_1_1_7_7_1_1_3_3_2_2_3_3_2_2_3_3_18_18_18_18_18_18_18_18_18_18_18_18_5_5_5_5
2269,72,1327565220,5,18,34,1327587720,22500,1381980,2385960,1003980,17_17_17_1_17_1_17_1_1_17_17_17_17_1_1_17_17_17_38_38_17_17_1_24_24_24_24_1_24_1_1_24_24_24_24_24_8_8_2_2_3_3_3_5_3_5_5_5_5_5_5_5
2270,23,1327565340,24,10,8,1327569060,3720,27060,1894920,1867860,24_24_24_24
2271,108,1327565400,17,10,17,1327585560,20160,849540,3191940,2342400,1_1_1_17_1_17_17_17_17_17_17_17_1_1_17_17_7_7_17_17_1_1_1_1_17
2272,98,1327566600,39,37,3,1327567920,1320,1827180,7319880,5492700,34_34_2_2_35_35_34_34_2_2_3_3_3_3_3_3_18_18_3_3_3_18_3_3_3_18_18_18_18_3_3_18_18_18_18_18_18_18_18_3_3_18_39
2273,75,1327566600,39,37,1,1327651860,85260,1458060,6135000,4676940,16_16_16_16_16_16_1_16_16_1_16_16_16_16_16_16_16_16_1_1_2_2_39_39
2274,144,1327567860,13,17,5,1327813200,245340,1462860,1807260,344400,10_10_10_1_10_10_1_10_10_10_1_10_10_1_10_1_1_10_1_1_2_3_3_2_18_18_18_18_13_13_13_13
2275,102,1327567860,3,3,13,1327567920,60,272100,3198240,2926140,43_43_43_43_16_16_8_1_16_1_8_16_16_16_2_2_3_3
2276,98,1327567920,3,3,3,1327582200,14280,1828500,7319880,5491380,34_34_2_2_35_35_34_34_2_2_3_3_3_3_3_3_18_18_3_3_3_18_3_3_3_18_18_18_18_3_3_18_18_18_18_18_18_18_18_3_3_18_39_3
2277,102,1327567920,13,17,13,1327592160,24240,272160,3198240,2926080,43_43_43_43_16_16_8_1_16_1_8_16_16_16_2_2_3_3_13
2278,83,1327568400,5,2,5,1327575000,6600,1508400,1818000,309600,19_19_19_19_19_19_19_19_19_19_19_19_19_19_19_19_19_19_19_19_19_19_19_19_19_19_19_19_7_19_7_19_1_1_1_1_1_1_1_1_7_7_1_1_3_3_2_2_3_3_2_2_3_3_18_18_18_18_18_18_18_18_18_18_18_18_5_5_5_5_5
2279,23,1327569060,8,9,8,1327571820,2760,30780,1894920,1864140,24_24_24_24_8
2280,115,1327569900,9,3,3,1327569900,0,905100,954000,48900,19_19_19_19_19_19_1_19_1_19_19_19_1_1_2_2_9
2281,115,1327569900,3,3,5,1327570200,300,905100,954000,48900,19_19_19_19_19_19_1_19_1_19_19_19_1_1_2_2_9_3
2282,115,1327570200,5,18,9,1327574400,4200,905400,954000,48600,19_19_19_19_19_19_1_19_1_19_19_19_1_1_2_2_9_3_5
2283,143,1327570440,10,16,10,1327570500,60,99360,1898460,1799100,10_10_10_1_10_1_10_1_1_10
2284,143,1327570500,10,16,10,1327586460,15960,99420,1898460,1799040,10_10_10_1_10_1_10_1_1_10_10
2285,134,1327571340,15,6,15,1327571580,240,757920,3656580,2898660,0_0_0_0_0_0_0_0_0_0_1_1_2_2_3_3_13_13_13_13_13_13_13_13_15
2286,134,1327571580,15,6,3,1330004760,2433180,758160,3656580,2898420,0_0_0_0_0_0_0_0_0_0_1_1_2_2_3_3_13_13_13_13_13_13_13_13_15_15
2287,23,1327571820,8,9,24,1327572000,180,33540,1894920,1861380,24_24_24_24_8_8
2288,23,1327572000,24,10,24,1327602540,30540,33720,1894920,1861200,24_24_24_24_8_8_24
2289,115,1327574400,9,3,3,1327574400,0,909600,954000,44400,19_19_19_19_19_19_1_19_1_19_19_19_1_1_2_2_9_3_5_9
2290,115,1327574400,3,3,5,1327582380,7980,909600,954000,44400,19_19_19_19_19_19_1_19_1_19_19_19_1_1_2_2_9_3_5_9_3
2291,83,1327575000,5,2,5,1327576800,1800,1515000,1818000,303000,19_19_19_19_19_19_19_19_19_19_19_19_19_19_19_19_19_19_19_19_19_19_19_19_19_19_19_19_7_19_7_19_1_1_1_1_1_1_1_1_7_7_1_1_3_3_2_2_3_3_2_2_3_3_18_18_18_18_18_18_18_18_18_18_18_18_5_5_5_5_5_5
2292,63,1327575000,1,2,1,1327576800,1800,723540,6232860,5509320,16_16_16_16_16_16_16_16_16_0_0_16_16_0_16_16_0_16_16_0_0_16_16_16_0_0_16_0_0_16_0_16_0_0_0_16_1_1_1_16_16_16_0_1_1_1_16_0_0_16_16_0_16_0_16_0_0_2_2_1_1_0_0_0_0_2_2_2_2_2_2_0_1_0_1_1_0_0_0_1_1_0_0_1_1_1_0_0_0_0_0_2_2_2_2_0_0_0_0_0_0_1_1
2293,63,1327576800,1,2,1,1327579200,2400,725340,6232860,5507520,16_16_16_16_16_16_16_16_16_0_0_16_16_0_16_16_0_16_16_0_0_16_16_16_0_0_16_0_0_16_0_16_0_0_0_16_1_1_1_16_16_16_0_1_1_1_16_0_0_16_16_0_16_0_16_0_0_2_2_1_1_0_0_0_0_2_2_2_2_2_2_0_1_0_1_1_0_0_0_1_1_0_0_1_1_1_0_0_0_0_0_2_2_2_2_0_0_0_0_0_0_1_1_1
2294,83,1327576800,5,2,5,1327579200,2400,1516800,1818000,301200,19_19_19_19_19_19_19_19_19_19_19_19_19_19_19_19_19_19_19_19_19_19_19_19_19_19_19_19_7_19_7_19_1_1_1_1_1_1_1_1_7_7_1_1_3_3_2_2_3_3_2_2_3_3_18_18_18_18_18_18_18_18_18_18_18_18_5_5_5_5_5_5_5
2295,135,1327578900,19,11,19,1327586580,7680,1504500,5649480,4144980,19_19_19_19_19_19_19_19_19_19_19_19_1_19_1_19_19_19_1_1_1_1_19
2296,126,1327578900,19,11,1,1327583880,4980,197460,496560,299100,19_19_19_19_19_19_1_1_19_19
2297,63,1327579200,1,2,0,1327585080,5880,727740,6232860,5505120,16_16_16_16_16_16_16_16_16_0_0_16_16_0_16_16_0_16_16_0_0_16_16_16_0_0_16_0_0_16_0_16_0_0_0_16_1_1_1_16_16_16_0_1_1_1_16_0_0_16_16_0_16_0_16_0_0_2_2_1_1_0_0_0_0_2_2_2_2_2_2_0_1_0_1_1_0_0_0_1_1_0_0_1_1_1_0_0_0_0_0_2_2_2_2_0_0_0_0_0_0_1_1_1_1
2298,83,1327579200,5,2,5,1327587060,7860,1519200,1818000,298800,19_19_19_19_19_19_19_19_19_19_19_19_19_19_19_19_19_19_19_19_19_19_19_19_19_19_19_19_7_19_7_19_1_1_1_1_1_1_1_1_7_7_1_1_3_3_2_2_3_3_2_2_3_3_18_18_18_18_18_18_18_18_18_18_18_18_5_5_5_5_5_5_5_5
2299,98,1327582200,3,3,39,1327584600,2400,1842780,7319880,5477100,34_34_2_2_35_35_34_34_2_2_3_3_3_3_3_3_18_18_3_3_3_18_3_3_3_18_18_18_18_3_3_18_18_18_18_18_18_18_18_3_3_18_39_3_3
2300,147,1327582200,9,3,9,1327588200,6000,199320,1479360,1280040,7_7_7_7_7_7_7_1_7_1_9
2301,115,1327582380,5,18,6,1327615200,32820,917580,954000,36420,19_19_19_19_19_19_1_19_1_19_19_19_1_1_2_2_9_3_5_9_3_5
2302,117,1327583880,5,9,5,1327642680,58800,909600,1144740,235140,19_19_19_1_19_19_1_19_1_1_2_2_3_3_18_18_18_18_5_5
2303,126,1327583880,1,9,1,1327584000,120,202440,496560,294120,19_19_19_19_19_19_1_1_19_19_1
2304,126,1327584000,1,9,2,1327644000,60000,202560,496560,294000,19_19_19_19_19_19_1_1_19_19_1_1
2305,98,1327584600,39,37,3,1327837980,253380,1845180,7319880,5474700,34_34_2_2_35_35_34_34_2_2_3_3_3_3_3_3_18_18_3_3_3_18_3_3_3_18_18_18_18_3_3_18_18_18_18_18_18_18_18_3_3_18_39_3_3_39
2306,142,1327584600,27,27,27,1327586400,1800,1826160,7299960,5473800,0_0_0_0_0_0_0_1_1_0_0_0_0_0_0_0_0_1_1_0_0_0_0_0_0_1_1_0_0_0_0_0_0_1_1_0_0_0_0_0_0_0_1_0_1_0_0_0_1_1_1_1_27_27_27_27_1_27_27_1_27_27_27_27_27_27_27_27
2307,63,1327585080,0,1,0,1327586460,1380,733620,6232860,5499240,16_16_16_16_16_16_16_16_16_0_0_16_16_0_16_16_0_16_16_0_0_16_16_16_0_0_16_0_0_16_0_16_0_0_0_16_1_1_1_16_16_16_0_1_1_1_16_0_0_16_16_0_16_0_16_0_0_2_2_1_1_0_0_0_0_2_2_2_2_2_2_0_1_0_1_1_0_0_0_1_1_0_0_1_1_1_0_0_0_0_0_2_2_2_2_0_0_0_0_0_0_1_1_1_1_0
2308,108,1327585560,17,10,1,1327588200,2640,869700,3191940,2322240,1_1_1_17_1_17_17_17_17_17_17_17_1_1_17_17_7_7_17_17_1_1_1_1_17_17
2309,77,1327586160,4,22,4,1327586760,600,978000,3257040,2279040,0_0_1_0_0_1_0_0_0_0_0_0_0_0_0_0_0_0_1_0_1_0_2_2_4_4_4_4_4_4_4_4
2310,142,1327586400,27,26,27,1327615200,28800,1827960,7299960,5472000,0_0_0_0_0_0_0_1_1_0_0_0_0_0_0_0_0_1_1_0_0_0_0_0_0_1_1_0_0_0_0_0_0_1_1_0_0_0_0_0_0_0_1_0_1_0_0_0_1_1_1_1_27_27_27_27_1_27_27_1_27_27_27_27_27_27_27_27_27
2311,143,1327586460,10,16,10,1327594680,8220,115380,1898460,1783080,10_10_10_1_10_1_10_1_1_10_10_10
2312,63,1327586460,0,0,16,1327588620,2160,735000,6232860,5497860,16_16_16_16_16_16_16_16_16_0_0_16_16_0_16_16_0_16_16_0_0_16_16_16_0_0_16_0_0_16_0_16_0_0_0_16_1_1_1_16_16_16_0_1_1_1_16_0_0_16_16_0_16_0_16_0_0_2_2_1_1_0_0_0_0_2_2_2_2_2_2_0_1_0_1_1_0_0_0_1_1_0_0_1_1_1_0_0_0_0_0_2_2_2_2_0_0_0_0_0_0_1_1_1_1_0_0
2313,135,1327586580,19,11,19,1327602000,15420,1512180,5649480,4137300,19_19_19_19_19_19_19_19_19_19_19_19_1_19_1_19_19_19_1_1_1_1_19_19
2314,77,1327586760,4,19,4,1327613040,26280,978600,3257040,2278440,0_0_1_0_0_1_0_0_0_0_0_0_0_0_0_0_0_0_1_0_1_0_2_2_4_4_4_4_4_4_4_4_4
2315,83,1327587060,5,2,5,1327588200,1140,1527060,1818000,290940,19_19_19_19_19_19_19_19_19_19_19_19_19_19_19_19_19_19_19_19_19_19_19_19_19_19_19_19_7_19_7_19_1_1_1_1_1_1_1_1_7_7_1_1_3_3_2_2_3_3_2_2_3_3_18_18_18_18_18_18_18_18_18_18_18_18_5_5_5_5_5_5_5_5_5
2316,156,1327587360,16,20,16,1327588800,1440,188640,2639280,2450640,16_16_16_16_16_16_16_16
2317,72,1327587720,34,15,34,1327594560,6840,1404480,2385960,981480,17_17_17_1_17_1_17_1_1_17_17_17_17_1_1_17_17_17_38_38_17_17_1_24_24_24_24_1_24_1_1_24_24_24_24_24_8_8_2_2_3_3_3_5_3_5_5_5_5_5_5_5_34
2318,108,1327588200,1,2,1,1327593600,5400,872340,3191940,2319600,1_1_1_17_1_17_17_17_17_17_17_17_1_1_17_17_7_7_17_17_1_1_1_1_17_17_1
2319,83,1327588200,5,2,5,1327813200,225000,1528200,1818000,289800,19_19_19_19_19_19_19_19_19_19_19_19_19_19_19_19_19_19_19_19_19_19_19_19_19_19_19_19_7_19_7_19_1_1_1_1_1_1_1_1_7_7_1_1_3_3_2_2_3_3_2_2_3_3_18_18_18_18_18_18_18_18_18_18_18_18_5_5_5_5_5_5_5_5_5_5
2320,147,1327588200,9,3,1,1328516460,928260,205320,1479360,1274040,7_7_7_7_7_7_7_1_7_1_9_9
2321,63,1327588620,16,1,0,1327588680,60,737160,6232860,5495700,16_16_16_16_16_16_16_16_16_0_0_16_16_0_16_16_0_16_16_0_0_16_16_16_0_0_16_0_0_16_0_16_0_0_0_16_1_1_1_16_16_16_0_1_1_1_16_0_0_16_16_0_16_0_16_0_0_2_2_1_1_0_0_0_0_2_2_2_2_2_2_0_1_0_1_1_0_0_0_1_1_0_0_1_1_1_0_0_0_0_0_2_2_2_2_0_0_0_0_0_0_1_1_1_1_0_0_16
2322,63,1327588680,0,1,16,1327588680,0,737220,6232860,5495640,16_16_16_16_16_16_16_16_16_0_0_16_16_0_16_16_0_16_16_0_0_16_16_16_0_0_16_0_0_16_0_16_0_0_0_16_1_1_1_16_16_16_0_1_1_1_16_0_0_16_16_0_16_0_16_0_0_2_2_1_1_0_0_0_0_2_2_2_2_2_2_0_1_0_1_1_0_0_0_1_1_0_0_1_1_1_0_0_0_0_0_2_2_2_2_0_0_0_0_0_0_1_1_1_1_0_0_16_0
2323,63,1327588680,16,1,16,1327588740,60,737220,6232860,5495640,16_16_16_16_16_16_16_16_16_0_0_16_16_0_16_16_0_16_16_0_0_16_16_16_0_0_16_0_0_16_0_16_0_0_0_16_1_1_1_16_16_16_0_1_1_1_16_0_0_16_16_0_16_0_16_0_0_2_2_1_1_0_0_0_0_2_2_2_2_2_2_0_1_0_1_1_0_0_0_1_1_0_0_1_1_1_0_0_0_0_0_2_2_2_2_0_0_0_0_0_0_1_1_1_1_0_0_16_0_16
2324,63,1327588740,16,1,16,1327614240,25500,737280,6232860,5495580,16_16_16_16_16_16_16_16_16_0_0_16_16_0_16_16_0_16_16_0_0_16_16_16_0_0_16_0_0_16_0_16_0_0_0_16_1_1_1_16_16_16_0_1_1_1_16_0_0_16_16_0_16_0_16_0_0_2_2_1_1_0_0_0_0_2_2_2_2_2_2_0_1_0_1_1_0_0_0_1_1_0_0_1_1_1_0_0_0_0_0_2_2_2_2_0_0_0_0_0_0_1_1_1_1_0_0_16_0_16_16
2325,156,1327588800,16,1,16,1327614300,25500,190080,2639280,2449200,16_16_16_16_16_16_16_16_16
2326,102,1327592160,13,17,13,1327845600,253440,296400,3198240,2901840,43_43_43_43_16_16_8_1_16_1_8_16_16_16_2_2_3_3_13_13
2327,108,1327593600,1,2,17,1327602780,9180,877740,3191940,2314200,1_1_1_17_1_17_17_17_17_17_17_17_1_1_17_17_7_7_17_17_1_1_1_1_17_17_1_1
2328,72,1327594560,34,15,5,1327647600,53040,1411320,2385960,974640,17_17_17_1_17_1_17_1_1_17_17_17_17_1_1_17_17_17_38_38_17_17_1_24_24_24_24_1_24_1_1_24_24_24_24_24_8_8_2_2_3_3_3_5_3_5_5_5_5_5_5_5_34_34
2329,143,1327594680,10,15,10,1327613700,19020,123600,1898460,1774860,10_10_10_1_10_1_10_1_1_10_10_10_10
2330,135,1327602000,19,14,19,1327621380,19380,1527600,5649480,4121880,19_19_19_19_19_19_19_19_19_19_19_19_1_19_1_19_19_19_1_1_1_1_19_19_19
2331,23,1327602540,24,10,24,1327602660,120,64260,1894920,1830660,24_24_24_24_8_8_24_24
2332,23,1327602660,24,12,24,1327637880,35220,64380,1894920,1830540,24_24_24_24_8_8_24_24_24
2333,108,1327602780,17,12,17,1327635360,32580,886920,3191940,2305020,1_1_1_17_1_17_17_17_17_17_17_17_1_1_17_17_7_7_17_17_1_1_1_1_17_17_1_1_17
2334,77,1327613040,4,19,4,1327639920,26880,1004880,3257040,2252160,0_0_1_0_0_1_0_0_0_0_0_0_0_0_0_0_0_0_1_0_1_0_2_2_4_4_4_4_4_4_4_4_4_4
2335,143,1327613700,10,15,1,1327788000,174300,142620,1898460,1755840,10_10_10_1_10_1_10_1_1_10_10_10_10_10
2336,63,1327614240,16,1,16,1327621440,7200,762780,6232860,5470080,16_16_16_16_16_16_16_16_16_0_0_16_16_0_16_16_0_16_16_0_0_16_16_16_0_0_16_0_0_16_0_16_0_0_0_16_1_1_1_16_16_16_0_1_1_1_16_0_0_16_16_0_16_0_16_0_0_2_2_1_1_0_0_0_0_2_2_2_2_2_2_0_1_0_1_1_0_0_0_1_1_0_0_1_1_1_0_0_0_0_0_2_2_2_2_0_0_0_0_0_0_1_1_1_1_0_0_16_0_16_16_16
2337,156,1327614300,16,1,16,1327639740,25440,215580,2639280,2423700,16_16_16_16_16_16_16_16_16_16
2338,115,1327615200,6,7,6,1327618800,3600,950400,954000,3600,19_19_19_19_19_19_1_19_1_19_19_19_1_1_2_2_9_3_5_9_3_5_6
2339,142,1327615200,27,26,27,1327640400,25200,1856760,7299960,5443200,0_0_0_0_0_0_0_1_1_0_0_0_0_0_0_0_0_1_1_0_0_0_0_0_0_1_1_0_0_0_0_0_0_1_1_0_0_0_0_0_0_0_1_0_1_0_0_0_1_1_1_1_27_27_27_27_1_27_27_1_27_27_27_27_27_27_27_27_27_27
2340,115,1327618800,6,7,99,1327618800,0,954000,954000,0,19_19_19_19_19_19_1_19_1_19_19_19_1_1_2_2_9_3_5_9_3_5_6_6
2341,135,1327621380,19,14,19,1327621440,60,1546980,5649480,4102500,19_19_19_19_19_19_19_19_19_19_19_19_1_19_1_19_19_19_1_1_1_1_19_19_19_19
2342,135,1327621440,19,14,19,1327638060,16620,1547040,5649480,4102440,19_19_19_19_19_19_19_19_19_19_19_19_1_19_1_19_19_19_1_1_1_1_19_19_19_19_19
2343,63,1327621440,16,14,16,1327621500,60,769980,6232860,5462880,16_16_16_16_16_16_16_16_16_0_0_16_16_0_16_16_0_16_16_0_0_16_16_16_0_0_16_0_0_16_0_16_0_0_0_16_1_1_1_16_16_16_0_1_1_1_16_0_0_16_16_0_16_0_16_0_0_2_2_1_1_0_0_0_0_2_2_2_2_2_2_0_1_0_1_1_0_0_0_1_1_0_0_1_1_1_0_0_0_0_0_2_2_2_2_0_0_0_0_0_0_1_1_1_1_0_0_16_0_16_16_16_16
2344,63,1327621500,0,14,0,1327638060,16560,770040,6232860,5462820,16_16_16_16_16_16_16_16_16_0_0_16_16_0_16_16_0_16_16_0_0_16_16_16_0_0_16_0_0_16_0_16_0_0_0_16_1_1_1_16_16_16_0_1_1_1_16_0_0_16_16_0_16_0_16_0_0_2_2_1_1_0_0_0_0_2_2_2_2_2_2_0_1_0_1_1_0_0_0_1_1_0_0_1_1_1_0_0_0_0_0_2_2_2_2_0_0_0_0_0_0_1_1_1_1_0_0_16_0_16_16_16_16_16_0
2345,63,1327621500,16,14,0,1327621500,0,770040,6232860,5462820,16_16_16_16_16_16_16_16_16_0_0_16_16_0_16_16_0_16_16_0_0_16_16_16_0_0_16_0_0_16_0_16_0_0_0_16_1_1_1_16_16_16_0_1_1_1_16_0_0_16_16_0_16_0_16_0_0_2_2_1_1_0_0_0_0_2_2_2_2_2_2_0_1_0_1_1_0_0_0_1_1_0_0_1_1_1_0_0_0_0_0_2_2_2_2_0_0_0_0_0_0_1_1_1_1_0_0_16_0_16_16_16_16_16
2346,108,1327635360,17,12,41,1327640400,5040,919500,3191940,2272440,1_1_1_17_1_17_17_17_17_17_17_17_1_1_17_17_7_7_17_17_1_1_1_1_17_17_1_1_17_17
2347,23,1327637880,24,12,24,1327640640,2760,99600,1894920,1795320,24_24_24_24_8_8_24_24_24_24
2348,63,1327638060,0,14,1,1327647600,9540,786600,6232860,5446260,16_16_16_16_16_16_16_16_16_0_0_16_16_0_16_16_0_16_16_0_0_16_16_16_0_0_16_0_0_16_0_16_0_0_0_16_1_1_1_16_16_16_0_1_1_1_16_0_0_16_16_0_16_0_16_0_0_2_2_1_1_0_0_0_0_2_2_2_2_2_2_0_1_0_1_1_0_0_0_1_1_0_0_1_1_1_0_0_0_0_0_2_2_2_2_0_0_0_0_0_0_1_1_1_1_0_0_16_0_16_16_16_16_16_0_0
2349,135,1327638060,19,14,1,1327639800,1740,1563660,5649480,4085820,19_19_19_19_19_19_19_19_19_19_19_19_1_19_1_19_19_19_1_1_1_1_19_19_19_19_19_19
2350,66,1327639740,5,6,5,1327644000,4260,2159340,4817700,2658360,3_3_4_4_4_4_4_4_4_4_4_4_4_4_4_4_4_4_4_4_4_3_3_4_4_4_4_4_4_4_4_4_5_5_5_5_5_5_5_5_6_6_5_5_5
2351,156,1327639740,16,20,1,1327644060,4320,241020,2639280,2398260,16_16_16_16_16_16_16_16_16_16_16
2352,135,1327639800,1,9,1,1327641660,1860,1565400,5649480,4084080,19_19_19_19_19_19_19_19_19_19_19_19_1_19_1_19_19_19_1_1_1_1_19_19_19_19_19_19_1
2353,77,1327639920,4,22,4,1327651200,11280,1031760,3257040,2225280,0_0_1_0_0_1_0_0_0_0_0_0_0_0_0_0_0_0_1_0_1_0_2_2_4_4_4_4_4_4_4_4_4_4_4
2354,142,1327640400,27,26,27,1327660200,19800,1881960,7299960,5418000,0_0_0_0_0_0_0_1_1_0_0_0_0_0_0_0_0_1_1_0_0_0_0_0_0_1_1_0_0_0_0_0_0_1_1_0_0_0_0_0_0_0_1_0_1_0_0_0_1_1_1_1_27_27_27_27_1_27_27_1_27_27_27_27_27_27_27_27_27_27_27
2355,108,1327640400,41,38,41,1327660200,19800,924540,3191940,2267400,1_1_1_17_1_17_17_17_17_17_17_17_1_1_17_17_7_7_17_17_1_1_1_1_17_17_1_1_17_17_41
2356,123,1327640400,1,2,1,1327646400,6000,685620,3545820,2860200,16_16_16_16_16_16_16_16_16_16_16_16_1
2357,23,1327640640,24,8,24,1327661460,20820,102360,1894920,1792560,24_24_24_24_8_8_24_24_24_24_24
2358,135,1327641660,1,9,1,1327641720,60,1567260,5649480,4082220,19_19_19_19_19_19_19_19_19_19_19_19_1_19_1_19_19_19_1_1_1_1_19_19_19_19_19_19_1_1
2359,135,1327641720,1,9,1,1327642620,900,1567320,5649480,4082160,19_19_19_19_19_19_19_19_19_19_19_19_1_19_1_19_19_19_1_1_1_1_19_19_19_19_19_19_1_1_1
2360,135,1327642620,1,9,19,1327744800,102180,1568220,5649480,4081260,19_19_19_19_19_19_19_19_19_19_19_19_1_19_1_19_19_19_1_1_1_1_19_19_19_19_19_19_1_1_1_1
2361,117,1327642680,5,9,5,1327658400,15720,968400,1144740,176340,19_19_19_1_19_19_1_19_1_1_2_2_3_3_18_18_18_18_5_5_5
2362,126,1327644000,2,3,2,1327645200,1200,262560,496560,234000,19_19_19_19_19_19_1_1_19_19_1_1_2
2363,66,1327644000,5,6,4,1327788000,144000,2163600,4817700,2654100,3_3_4_4_4_4_4_4_4_4_4_4_4_4_4_4_4_4_4_4_4_3_3_4_4_4_4_4_4_4_4_4_5_5_5_5_5_5_5_5_6_6_5_5_5_5
2364,156,1327644060,1,6,1,1327651320,7260,245340,2639280,2393940,16_16_16_16_16_16_16_16_16_16_16_1
2365,126,1327645200,2,3,3,1327645200,0,263760,496560,232800,19_19_19_19_19_19_1_1_19_19_1_1_2_2
2366,126,1327645200,3,3,3,1327651200,6000,263760,496560,232800,19_19_19_19_19_19_1_1_19_19_1_1_2_2_3
2367,123,1327646400,1,2,2,1327820520,174120,691620,3545820,2854200,16_16_16_16_16_16_16_16_16_16_16_16_1_1
2368,63,1327647600,1,2,1,1327661040,13440,796140,6232860,5436720,16_16_16_16_16_16_16_16_16_0_0_16_16_0_16_16_0_16_16_0_0_16_16_16_0_0_16_0_0_16_0_16_0_0_0_16_1_1_1_16_16_16_0_1_1_1_16_0_0_16_16_0_16_0_16_0_0_2_2_1_1_0_0_0_0_2_2_2_2_2_2_0_1_0_1_1_0_0_0_1_1_0_0_1_1_1_0_0_0_0_0_2_2_2_2_0_0_0_0_0_0_1_1_1_1_0_0_16_0_16_16_16_16_16_0_0_1
2369,72,1327647600,5,18,5,1327651200,3600,1464360,2385960,921600,17_17_17_1_17_1_17_1_1_17_17_17_17_1_1_17_17_17_38_38_17_17_1_24_24_24_24_1_24_1_1_24_24_24_24_24_8_8_2_2_3_3_3_5_3_5_5_5_5_5_5_5_34_34_5
2370,101,1327651200,5,18,5,1327661160,9960,428220,655020,226800,10_8_8_10_10_10_10_10_8_8_2_2_9_2_9_2_5
2371,166,1327651200,21,3,21,1327653000,1800,181800,1666080,1484280,7_7_7_1_7_7_1_7_7_7_21
2372,72,1327651200,5,18,5,1328245200,594000,1467960,2385960,918000,17_17_17_1_17_1_17_1_1_17_17_17_17_1_1_17_17_17_38_38_17_17_1_24_24_24_24_1_24_1_1_24_24_24_24_24_8_8_2_2_3_3_3_5_3_5_5_5_5_5_5_5_34_34_5_5
2373,77,1327651200,4,22,4,1328478960,827760,1043040,3257040,2214000,0_0_1_0_0_1_0_0_0_0_0_0_0_0_0_0_0_0_1_0_1_0_2_2_4_4_4_4_4_4_4_4_4_4_4_4
2374,126,1327651200,3,3,5,1327659600,8400,269760,496560,226800,19_19_19_19_19_19_1_1_19_19_1_1_2_2_3_3
2375,156,1327651320,1,6,1,1327659180,7860,252600,2639280,2386680,16_16_16_16_16_16_16_16_16_16_16_1_1
2376,75,1327651860,1,6,1,1327655520,3660,1543320,6135000,4591680,16_16_16_16_16_16_1_16_16_1_16_16_16_16_16_16_16_16_1_1_2_2_39_39_1
2377,1,1327653000,9,3,9,1327662000,9000,876540,1447140,570600,7_8_7_8_7_7_7_7_7_7_7_7_7_7_7_7_7_7_7_7_7_7_7_7_7_7_7_7_7_7_8_8_2_2_2_2_2_2_9
2378,166,1327653000,21,3,1,1327814400,161400,183600,1666080,1482480,7_7_7_1_7_7_1_7_7_7_21_21
2379,94,1327655520,5,6,5,1327659180,3660,367920,534480,166560,7_7_7_7_7_7_7_7_7_7_1_1_2_2_3_3_13_13_13_13_5
2380,75,1327655520,1,6,3,1330981200,3325680,1546980,6135000,4588020,16_16_16_16_16_16_1_16_16_1_16_16_16_16_16_16_16_16_1_1_2_2_39_39_1_1
2381,112,1327658400,5,9,5,1327662900,4500,1083840,1303440,219600,19_19_19_19_19_1_1_19_19_19_1_1_47_47_2_2_3_3_5_5_5
2382,117,1327658400,5,9,6,1327788000,129600,984120,1144740,160620,19_19_19_1_19_19_1_19_1_1_2_2_3_3_18_18_18_18_5_5_5_5
2383,94,1327659180,5,6,6,1327788000,128820,371580,534480,162900,7_7_7_7_7_7_7_7_7_7_1_1_2_2_3_3_13_13_13_13_5_5
2384,156,1327659180,1,6,16,1327661700,2520,260460,2639280,2378820,16_16_16_16_16_16_16_16_16_16_16_1_1_1
2385,126,1327659600,5,9,5,1327661820,2220,278160,496560,218400,19_19_19_19_19_19_1_1_19_19_1_1_2_2_3_3_5
2386,108,1327660200,41,38,1,1327814100,153900,944340,3191940,2247600,1_1_1_17_1_17_17_17_17_17_17_17_1_1_17_17_7_7_17_17_1_1_1_1_17_17_1_1_17_17_41_41
2387,142,1327660200,27,26,27,1327834800,174600,1901760,7299960,5398200,0_0_0_0_0_0_0_1_1_0_0_0_0_0_0_0_0_1_1_0_0_0_0_0_0_1_1_0_0_0_0_0_0_1_1_0_0_0_0_0_0_0_1_0_1_0_0_0_1_1_1_1_27_27_27_27_1_27_27_1_27_27_27_27_27_27_27_27_27_27_27_27
2388,113,1327660860,15,6,15,1327665360,4500,837600,3646740,2809140,16_16_16_16_1_1_2_2_48_3_3_48_15
2389,63,1327661040,1,2,2,1327826580,165540,809580,6232860,5423280,16_16_16_16_16_16_16_16_16_0_0_16_16_0_16_16_0_16_16_0_0_16_16_16_0_0_16_0_0_16_0_16_0_0_0_16_1_1_1_16_16_16_0_1_1_1_16_0_0_16_16_0_16_0_16_0_0_2_2_1_1_0_0_0_0_2_2_2_2_2_2_0_1_0_1_1_0_0_0_1_1_0_0_1_1_1_0_0_0_0_0_2_2_2_2_0_0_0_0_0_0_1_1_1_1_0_0_16_0_16_16_16_16_16_0_0_1_1
2390,101,1327661160,5,18,5,1327820400,159240,438180,655020,216840,10_8_8_10_10_10_10_10_8_8_2_2_9_2_9_2_5_5
2391,23,1327661460,24,8,24,1327820760,159300,123180,1894920,1771740,24_24_24_24_8_8_24_24_24_24_24_24
2392,156,1327661700,16,20,1,1327680000,18300,262980,2639280,2376300,16_16_16_16_16_16_16_16_16_16_16_1_1_1_16
2393,126,1327661820,5,9,5,1327814460,152640,280380,496560,216180,19_19_19_19_19_19_1_1_19_19_1_1_2_2_3_3_5_5
2394,1,1327662000,9,3,9,1327817340,155340,885540,1447140,561600,7_8_7_8_7_7_7_7_7_7_7_7_7_7_7_7_7_7_7_7_7_7_7_7_7_7_7_7_7_7_8_8_2_2_2_2_2_2_9_9
2395,112,1327662900,5,9,6,1327874400,211500,1088340,1303440,215100,19_19_19_19_19_1_1_19_19_19_1_1_47_47_2_2_3_3_5_5_5_5
2396,113,1327665360,15,6,4,1329992820,2327460,842100,3646740,2804640,16_16_16_16_1_1_2_2_48_3_3_48_15_15
2397,156,1327680000,1,6,16,1327745400,65400,281280,2639280,2358000,16_16_16_16_16_16_16_16_16_16_16_1_1_1_16_1
2398,110,1327737600,4,22,4,1327746000,8400,2196000,5579400,3383400,1_1_0_0_1_1_1_1_2_2_2_2_4_4_4_4_4_4_4_4_4_4_4_4_4_4_4_4_4_4_4_4_4_4_4_4_4_4_4_4_4
2399,135,1327744800,19,11,19,1327748400,3600,1670400,5649480,3979080,19_19_19_19_19_19_19_19_19_19_19_19_1_19_1_19_19_19_1_1_1_1_19_19_19_19_19_19_1_1_1_1_19
2400,156,1327745400,16,11,16,1327748400,3000,346680,2639280,2292600,16_16_16_16_16_16_16_16_16_16_16_1_1_1_16_1_16
2401,110,1327746000,4,22,4,1327786200,40200,2204400,5579400,3375000,1_1_0_0_1_1_1_1_2_2_2_2_4_4_4_4_4_4_4_4_4_4_4_4_4_4_4_4_4_4_4_4_4_4_4_4_4_4_4_4_4_4
2402,135,1327748400,19,0,19,1327766400,18000,1674000,5649480,3975480,19_19_19_19_19_19_19_19_19_19_19_19_1_19_1_19_19_19_1_1_1_1_19_19_19_19_19_19_1_1_1_1_19_19
2403,156,1327748400,16,0,16,1327781460,33060,349680,2639280,2289600,16_16_16_16_16_16_16_16_16_16_16_1_1_1_16_1_16_16
2404,135,1327766400,19,11,19,1327781820,15420,1692000,5649480,3957480,19_19_19_19_19_19_19_19_19_19_19_19_1_19_1_19_19_19_1_1_1_1_19_19_19_19_19_19_1_1_1_1_19_19_19
2405,156,1327781460,16,11,16,1327781880,420,382740,2639280,2256540,16_16_16_16_16_16_16_16_16_16_16_1_1_1_16_1_16_16_16
2406,135,1327781820,19,11,19,1327812720,30900,1707420,5649480,3942060,19_19_19_19_19_19_19_19_19_19_19_19_1_19_1_19_19_19_1_1_1_1_19_19_19_19_19_19_1_1_1_1_19_19_19_19
2407,156,1327781880,16,11,16,1327812720,30840,383160,2639280,2256120,16_16_16_16_16_16_16_16_16_16_16_1_1_1_16_1_16_16_16_16
2408,110,1327786200,4,17,4,1327812000,25800,2244600,5579400,3334800,1_1_0_0_1_1_1_1_2_2_2_2_4_4_4_4_4_4_4_4_4_4_4_4_4_4_4_4_4_4_4_4_4_4_4_4_4_4_4_4_4_4_4
2409,94,1327788000,6,7,6,1327791600,3600,500400,534480,34080,7_7_7_7_7_7_7_7_7_7_1_1_2_2_3_3_13_13_13_13_5_5_6
2410,171,1327788000,19,20,19,1327792500,4500,0,435600,435600,19
2411,66,1327788000,4,23,4,1327792500,4500,2307600,4817700,2510100,3_3_4_4_4_4_4_4_4_4_4_4_4_4_4_4_4_4_4_4_4_3_3_4_4_4_4_4_4_4_4_4_5_5_5_5_5_5_5_5_6_6_5_5_5_5_4
2412,143,1327788000,1,18,1,1327792500,4500,316920,1898460,1581540,10_10_10_1_10_1_10_1_1_10_10_10_10_10_1
2413,117,1327788000,6,7,6,1327791600,3600,1113720,1144740,31020,19_19_19_1_19_19_1_19_1_1_2_2_3_3_18_18_18_18_5_5_5_5_6
2414,117,1327791600,6,7,5,1327814520,22920,1117320,1144740,27420,19_19_19_1_19_19_1_19_1_1_2_2_3_3_18_18_18_18_5_5_5_5_6_6
2415,94,1327791600,6,7,5,1327818420,26820,504000,534480,30480,7_7_7_7_7_7_7_7_7_7_1_1_2_2_3_3_13_13_13_13_5_5_6_6
2416,66,1327792500,4,23,5,1327812600,20100,2312100,4817700,2505600,3_3_4_4_4_4_4_4_4_4_4_4_4_4_4_4_4_4_4_4_4_3_3_4_4_4_4_4_4_4_4_4_5_5_5_5_5_5_5_5_6_6_5_5_5_5_4_4
2417,143,1327792500,1,18,10,1327829460,36960,321420,1898460,1577040,10_10_10_1_10_1_10_1_1_10_10_10_10_10_1_1
2418,171,1327792500,19,20,19,1327995000,202500,4500,435600,431100,19_19
2419,110,1327812000,4,17,4,1327813320,1320,2270400,5579400,3309000,1_1_0_0_1_1_1_1_2_2_2_2_4_4_4_4_4_4_4_4_4_4_4_4_4_4_4_4_4_4_4_4_4_4_4_4_4_4_4_4_4_4_4_4
2420,66,1327812600,5,6,5,1327813500,900,2332200,4817700,2485500,3_3_4_4_4_4_4_4_4_4_4_4_4_4_4_4_4_4_4_4_4_3_3_4_4_4_4_4_4_4_4_4_5_5_5_5_5_5_5_5_6_6_5_5_5_5_4_4_5
2421,135,1327812720,19,11,19,1327828920,16200,1738320,5649480,3911160,19_19_19_19_19_19_19_19_19_19_19_19_1_19_1_19_19_19_1_1_1_1_19_19_19_19_19_19_1_1_1_1_19_19_19_19_19
2422,156,1327812720,16,11,16,1327822500,9780,414000,2639280,2225280,16_16_16_16_16_16_16_16_16_16_16_1_1_1_16_1_16_16_16_16_16
2423,67,1327813200,27,26,27,1327834800,21600,2313900,3120480,806580,2_3_3_3_2_3_3_3_1_1_27
2424,83,1327813200,5,2,5,1327814100,900,1753200,1818000,64800,19_19_19_19_19_19_19_19_19_19_19_19_19_19_19_19_19_19_19_19_19_19_19_19_19_19_19_19_7_19_7_19_1_1_1_1_1_1_1_1_7_7_1_1_3_3_2_2_3_3_2_2_3_3_18_18_18_18_18_18_18_18_18_18_18_18_5_5_5_5_5_5_5_5_5_5_5
2425,144,1327813200,5,18,5,1327819200,6000,1708200,1807260,99060,10_10_10_1_10_10_1_10_10_10_1_10_10_1_10_1_1_10_1_1_2_3_3_2_18_18_18_18_13_13_13_13_5
2426,110,1327813320,4,19,4,1327813680,360,2271720,5579400,3307680,1_1_0_0_1_1_1_1_2_2_2_2_4_4_4_4_4_4_4_4_4_4_4_4_4_4_4_4_4_4_4_4_4_4_4_4_4_4_4_4_4_4_4_4_4
2427,66,1327813500,5,6,5,1327814040,540,2333100,4817700,2484600,3_3_4_4_4_4_4_4_4_4_4_4_4_4_4_4_4_4_4_4_4_3_3_4_4_4_4_4_4_4_4_4_5_5_5_5_5_5_5_5_6_6_5_5_5_5_4_4_5_5_5
2428,66,1327813500,5,6,5,1327813500,0,2333100,4817700,2484600,3_3_4_4_4_4_4_4_4_4_4_4_4_4_4_4_4_4_4_4_4_3_3_4_4_4_4_4_4_4_4_4_5_5_5_5_5_5_5_5_6_6_5_5_5_5_4_4_5_5
2429,110,1327813680,4,19,4,1327817520,3840,2272080,5579400,3307320,1_1_0_0_1_1_1_1_2_2_2_2_4_4_4_4_4_4_4_4_4_4_4_4_4_4_4_4_4_4_4_4_4_4_4_4_4_4_4_4_4_4_4_4_4_4
2430,66,1327814040,5,6,5,1327822500,8460,2333640,4817700,2484060,3_3_4_4_4_4_4_4_4_4_4_4_4_4_4_4_4_4_4_4_4_3_3_4_4_4_4_4_4_4_4_4_5_5_5_5_5_5_5_5_6_6_5_5_5_5_4_4_5_5_5_5
2431,108,1327814100,1,2,1,1327819200,5100,1098240,3191940,2093700,1_1_1_17_1_17_17_17_17_17_17_17_1_1_17_17_7_7_17_17_1_1_1_1_17_17_1_1_17_17_41_41_1
2432,83,1327814100,5,2,6,1327874400,60300,1754100,1818000,63900,19_19_19_19_19_19_19_19_19_19_19_19_19_19_19_19_19_19_19_19_19_19_19_19_19_19_19_19_7_19_7_19_1_1_1_1_1_1_1_1_7_7_1_1_3_3_2_2_3_3_2_2_3_3_18_18_18_18_18_18_18_18_18_18_18_18_5_5_5_5_5_5_5_5_5_5_5_5
2433,166,1327814400,1,6,1,1327818900,4500,345000,1666080,1321080,7_7_7_1_7_7_1_7_7_7_21_21_1
2434,126,1327814460,5,6,5,1327814520,60,433020,496560,63540,19_19_19_19_19_19_1_1_19_19_1_1_2_2_3_3_5_5_5
2435,117,1327814520,5,6,5,1327819020,4500,1140240,1144740,4500,19_19_19_1_19_19_1_19_1_1_2_2_3_3_18_18_18_18_5_5_5_5_6_6_5
2436,126,1327814520,5,6,6,1327874400,59880,433080,496560,63480,19_19_19_19_19_19_1_1_19_19_1_1_2_2_3_3_5_5_5_5
2437,153,1327814640,16,1,1,1327848720,34080,0,1618560,1618560,16
2438,1,1327817340,9,3,9,1327842360,25020,1040880,1447140,406260,7_8_7_8_7_7_7_7_7_7_7_7_7_7_7_7_7_7_7_7_7_7_7_7_7_7_7_7_7_7_8_8_2_2_2_2_2_2_9_9_9
2439,110,1327817520,4,19,4,1327822320,4800,2275920,5579400,3303480,1_1_0_0_1_1_1_1_2_2_2_2_4_4_4_4_4_4_4_4_4_4_4_4_4_4_4_4_4_4_4_4_4_4_4_4_4_4_4_4_4_4_4_4_4_4_4
2440,61,1327818060,34,15,34,1327822140,4080,2362860,6225300,3862440,4_4_18_18_34_34_34_3_3_34_3_3_34_35_34_35_35_35_36_36_35_35_35_35_34_34_34_34_34_34_34_34_34
2441,94,1327818420,5,6,5,1327822080,3660,530820,534480,3660,7_7_7_7_7_7_7_7_7_7_1_1_2_2_3_3_13_13_13_13_5_5_6_6_5
2442,166,1327818900,1,6,2,1328516460,697560,349500,1666080,1316580,7_7_7_1_7_7_1_7_7_7_21_21_1_1
2443,117,1327819020,5,6,99,1327819020,0,1144740,1144740,0,19_19_19_1_19_19_1_19_1_1_2_2_3_3_18_18_18_18_5_5_5_5_6_6_5_5
2444,108,1327819200,1,2,1,1327820400,1200,1103340,3191940,2088600,1_1_1_17_1_17_17_17_17_17_17_17_1_1_17_17_7_7_17_17_1_1_1_1_17_17_1_1_17_17_41_41_1_1
2445,144,1327819200,5,18,5,1327824360,5160,1714200,1807260,93060,10_10_10_1_10_10_1_10_10_10_1_10_10_1_10_1_1_10_1_1_2_3_3_2_18_18_18_18_13_13_13_13_5_5
2446,108,1327820400,1,2,1,1327834200,13800,1104540,3191940,2087400,1_1_1_17_1_17_17_17_17_17_17_17_1_1_17_17_7_7_17_17_1_1_1_1_17_17_1_1_17_17_41_41_1_1_1
2447,101,1327820400,5,18,5,1327822200,1800,597420,655020,57600,10_8_8_10_10_10_10_10_8_8_2_2_9_2_9_2_5_5_5
2448,123,1327820520,2,3,2,1327821960,1440,865740,3545820,2680080,16_16_16_16_16_16_16_16_16_16_16_16_1_1_2
2449,158,1327820520,17,10,17,1327851780,31260,0,2044680,2044680,17
2450,23,1327820760,24,12,24,1327845480,24720,282480,1894920,1612440,24_24_24_24_8_8_24_24_24_24_24_24_24
2451,123,1327821960,2,3,3,1327874400,52440,867180,3545820,2678640,16_16_16_16_16_16_16_16_16_16_16_16_1_1_2_2
2452,94,1327822080,5,6,99,1327822080,0,534480,534480,0,7_7_7_7_7_7_7_7_7_7_1_1_2_2_3_3_13_13_13_13_5_5_6_6_5_5
2453,103,1327822140,14,15,14,1327845360,23220,2021160,4719960,2698800,19_19_19_19_19_19_19_1_1_19_19_19_19_1_1_19_19_19_19_19_1_1_2_2_9_2_2_9_9_9_9_9_14
2454,61,1327822140,34,15,34,1327900320,78180,2366940,6225300,3858360,4_4_18_18_34_34_34_3_3_34_3_3_34_35_34_35_35_35_36_36_35_35_35_35_34_34_34_34_34_34_34_34_34_34
2455,101,1327822200,5,18,6,1327874400,52200,599220,655020,55800,10_8_8_10_10_10_10_10_8_8_2_2_9_2_9_2_5_5_5_5
2456,110,1327822320,4,19,4,1327836660,14340,2280720,5579400,3298680,1_1_0_0_1_1_1_1_2_2_2_2_4_4_4_4_4_4_4_4_4_4_4_4_4_4_4_4_4_4_4_4_4_4_4_4_4_4_4_4_4_4_4_4_4_4_4_4
2457,156,1327822500,16,14,1,1327822560,60,423780,2639280,2215500,16_16_16_16_16_16_16_16_16_16_16_1_1_1_16_1_16_16_16_16_16_16
2458,66,1327822500,5,6,5,1327825440,2940,2342100,4817700,2475600,3_3_4_4_4_4_4_4_4_4_4_4_4_4_4_4_4_4_4_4_4_3_3_4_4_4_4_4_4_4_4_4_5_5_5_5_5_5_5_5_6_6_5_5_5_5_4_4_5_5_5_5_5
2459,156,1327822560,1,6,1,1327822800,240,423840,2639280,2215440,16_16_16_16_16_16_16_16_16_16_16_1_1_1_16_1_16_16_16_16_16_16_1
2460,156,1327822800,1,6,1,1327826220,3420,424080,2639280,2215200,16_16_16_16_16_16_16_16_16_16_16_1_1_1_16_1_16_16_16_16_16_16_1_1
2461,144,1327824360,5,18,5,1327831200,6840,1719360,1807260,87900,10_10_10_1_10_10_1_10_10_10_1_10_10_1_10_1_1_10_1_1_2_3_3_2_18_18_18_18_13_13_13_13_5_5_5
2462,66,1327825440,5,6,5,1327826160,720,2345040,4817700,2472660,3_3_4_4_4_4_4_4_4_4_4_4_4_4_4_4_4_4_4_4_4_3_3_4_4_4_4_4_4_4_4_4_5_5_5_5_5_5_5_5_6_6_5_5_5_5_4_4_5_5_5_5_5_5
2463,66,1327826160,5,6,5,1327832340,6180,2345760,4817700,2471940,3_3_4_4_4_4_4_4_4_4_4_4_4_4_4_4_4_4_4_4_4_3_3_4_4_4_4_4_4_4_4_4_5_5_5_5_5_5_5_5_6_6_5_5_5_5_4_4_5_5_5_5_5_5_5
2464,156,1327826220,1,6,1,1327826400,180,427500,2639280,2211780,16_16_16_16_16_16_16_16_16_16_16_1_1_1_16_1_16_16_16_16_16_16_1_1_1
2465,156,1327826400,1,6,16,1327828980,2580,427680,2639280,2211600,16_16_16_16_16_16_16_16_16_16_16_1_1_1_16_1_16_16_16_16_16_16_1_1_1_1
2466,63,1327826580,2,4,2,1327834440,7860,975120,6232860,5257740,16_16_16_16_16_16_16_16_16_0_0_16_16_0_16_16_0_16_16_0_0_16_16_16_0_0_16_0_0_16_0_16_0_0_0_16_1_1_1_16_16_16_0_1_1_1_16_0_0_16_16_0_16_0_16_0_0_2_2_1_1_0_0_0_0_2_2_2_2_2_2_0_1_0_1_1_0_0_0_1_1_0_0_1_1_1_0_0_0_0_0_2_2_2_2_0_0_0_0_0_0_1_1_1_1_0_0_16_0_16_16_16_16_16_0_0_1_1_2
2467,70,1327828740,1,6,1,1327837320,8580,1682340,3064200,1381860,6_6_5_5_1
2468,135,1327828920,19,0,19,1327830240,1320,1754520,5649480,3894960,19_19_19_19_19_19_19_19_19_19_19_19_1_19_1_19_19_19_1_1_1_1_19_19_19_19_19_19_1_1_1_1_19_19_19_19_19_19
2469,156,1327828980,16,0,16,1327844700,15720,430260,2639280,2209020,16_16_16_16_16_16_16_16_16_16_16_1_1_1_16_1_16_16_16_16_16_16_1_1_1_1_16
2470,143,1327829460,10,16,1,1327831200,1740,358380,1898460,1540080,10_10_10_1_10_1_10_1_1_10_10_10_10_10_1_1_10
2471,135,1327830240,19,14,19,1327844700,14460,1755840,5649480,3893640,19_19_19_19_19_19_19_19_19_19_19_19_1_19_1_19_19_19_1_1_1_1_19_19_19_19_19_19_1_1_1_1_19_19_19_19_19_19_19
2472,143,1327831200,1,18,10,1327837200,6000,360120,1898460,1538340,10_10_10_1_10_1_10_1_1_10_10_10_10_10_1_1_10_1
2473,144,1327831200,5,18,5,1327836000,4800,1726200,1807260,81060,10_10_10_1_10_10_1_10_10_10_1_10_10_1_10_1_1_10_1_1_2_3_3_2_18_18_18_18_13_13_13_13_5_5_5_5
2474,66,1327832340,5,6,5,1327837320,4980,2351940,4817700,2465760,3_3_4_4_4_4_4_4_4_4_4_4_4_4_4_4_4_4_4_4_4_3_3_4_4_4_4_4_4_4_4_4_5_5_5_5_5_5_5_5_6_6_5_5_5_5_4_4_5_5_5_5_5_5_5_5
2475,108,1327834200,1,2,25,1327848180,13980,1118340,3191940,2073600,1_1_1_17_1_17_17_17_17_17_17_17_1_1_17_17_7_7_17_17_1_1_1_1_17_17_1_1_17_17_41_41_1_1_1_1
2476,63,1327834440,2,4,1,1327836000,1560,982980,6232860,5249880,16_16_16_16_16_16_16_16_16_0_0_16_16_0_16_16_0_16_16_0_0_16_16_16_0_0_16_0_0_16_0_16_0_0_0_16_1_1_1_16_16_16_0_1_1_1_16_0_0_16_16_0_16_0_16_0_0_2_2_1_1_0_0_0_0_2_2_2_2_2_2_0_1_0_1_1_0_0_0_1_1_0_0_1_1_1_0_0_0_0_0_2_2_2_2_0_0_0_0_0_0_1_1_1_1_0_0_16_0_16_16_16_16_16_0_0_1_1_2_2
2477,67,1327834800,27,26,4,1328091840,257040,2335500,3120480,784980,2_3_3_3_2_3_3_3_1_1_27_27
2478,142,1327834800,27,26,27,1327849200,14400,2076360,7299960,5223600,0_0_0_0_0_0_0_1_1_0_0_0_0_0_0_0_0_1_1_0_0_0_0_0_0_1_1_0_0_0_0_0_0_1_1_0_0_0_0_0_0_0_1_0_1_0_0_0_1_1_1_1_27_27_27_27_1_27_27_1_27_27_27_27_27_27_27_27_27_27_27_27_27
2479,144,1327836000,5,18,5,1327845300,9300,1731000,1807260,76260,10_10_10_1_10_10_1_10_10_10_1_10_10_1_10_1_1_10_1_1_2_3_3_2_18_18_18_18_13_13_13_13_5_5_5_5_5
2480,63,1327836000,1,2,1,1327848720,12720,984540,6232860,5248320,16_16_16_16_16_16_16_16_16_0_0_16_16_0_16_16_0_16_16_0_0_16_16_16_0_0_16_0_0_16_0_16_0_0_0_16_1_1_1_16_16_16_0_1_1_1_16_0_0_16_16_0_16_0_16_0_0_2_2_1_1_0_0_0_0_2_2_2_2_2_2_0_1_0_1_1_0_0_0_1_1_0_0_1_1_1_0_0_0_0_0_2_2_2_2_0_0_0_0_0_0_1_1_1_1_0_0_16_0_16_16_16_16_16_0_0_1_1_2_2_1
2481,110,1327836660,4,19,4,1327849800,13140,2295060,5579400,3284340,1_1_0_0_1_1_1_1_2_2_2_2_4_4_4_4_4_4_4_4_4_4_4_4_4_4_4_4_4_4_4_4_4_4_4_4_4_4_4_4_4_4_4_4_4_4_4_4_4
2482,143,1327837200,10,16,1,1327837380,180,366120,1898460,1532340,10_10_10_1_10_1_10_1_1_10_10_10_10_10_1_1_10_1_10
2483,70,1327837320,1,6,5,1329084000,1246680,1690920,3064200,1373280,6_6_5_5_1_1
2484,66,1327837320,5,6,5,1327837440,120,2356920,4817700,2460780,3_3_4_4_4_4_4_4_4_4_4_4_4_4_4_4_4_4_4_4_4_3_3_4_4_4_4_4_4_4_4_4_5_5_5_5_5_5_5_5_6_6_5_5_5_5_4_4_5_5_5_5_5_5_5_5_5
2485,143,1327837380,1,18,10,1327837560,180,366300,1898460,1532160,10_10_10_1_10_1_10_1_1_10_10_10_10_10_1_1_10_1_10_1
2486,66,1327837440,5,6,6,1327874400,36960,2357040,4817700,2460660,3_3_4_4_4_4_4_4_4_4_4_4_4_4_4_4_4_4_4_4_4_3_3_4_4_4_4_4_4_4_4_4_5_5_5_5_5_5_5_5_6_6_5_5_5_5_4_4_5_5_5_5_5_5_5_5_5_5
2487,143,1327837560,10,16,10,1327845360,7800,366480,1898460,1531980,10_10_10_1_10_1_10_1_1_10_10_10_10_10_1_1_10_1_10_1_10
2488,98,1327837980,3,3,3,1327838040,60,2098560,7319880,5221320,34_34_2_2_35_35_34_34_2_2_3_3_3_3_3_3_18_18_3_3_3_18_3_3_3_18_18_18_18_3_3_18_18_18_18_18_18_18_18_3_3_18_39_3_3_39_3
2489,98,1327838040,3,4,3,1327842360,4320,2098620,7319880,5221260,34_34_2_2_35_35_34_34_2_2_3_3_3_3_3_3_18_18_3_3_3_18_3_3_3_18_18_18_18_3_3_18_18_18_18_18_18_18_18_3_3_18_39_3_3_39_3_3
2490,98,1327842360,3,3,3,1327844460,2100,2102940,7319880,5216940,34_34_2_2_35_35_34_34_2_2_3_3_3_3_3_3_18_18_3_3_3_18_3_3_3_18_18_18_18_3_3_18_18_18_18_18_18_18_18_3_3_18_39_3_3_39_3_3_3
2491,1,1327842360,9,3,9,1327929540,87180,1065900,1447140,381240,7_8_7_8_7_7_7_7_7_7_7_7_7_7_7_7_7_7_7_7_7_7_7_7_7_7_7_7_7_7_8_8_2_2_2_2_2_2_9_9_9_9
2492,98,1327844460,3,4,4,1327872000,27540,2105040,7319880,5214840,34_34_2_2_35_35_34_34_2_2_3_3_3_3_3_3_18_18_3_3_3_18_3_3_3_18_18_18_18_3_3_18_18_18_18_18_18_18_18_3_3_18_39_3_3_39_3_3_3_3
2493,135,1327844700,19,14,19,1327846740,2040,1770300,5649480,3879180,19_19_19_19_19_19_19_19_19_19_19_19_1_19_1_19_19_19_1_1_1_1_19_19_19_19_19_19_1_1_1_1_19_19_19_19_19_19_19_19
2494,156,1327844700,16,14,16,1327845720,1020,445980,2639280,2193300,16_16_16_16_16_16_16_16_16_16_16_1_1_1_16_1_16_16_16_16_16_16_1_1_1_1_16_16
2495,144,1327845300,5,18,6,1327874400,29100,1740300,1807260,66960,10_10_10_1_10_10_1_10_10_10_1_10_10_1_10_1_1_10_1_1_2_3_3_2_18_18_18_18_13_13_13_13_5_5_5_5_5_5
2496,143,1327845360,10,16,10,1327860540,15180,374280,1898460,1524180,10_10_10_1_10_1_10_1_1_10_10_10_10_10_1_1_10_1_10_1_10_10
2497,103,1327845360,14,15,14,1327901400,56040,2044380,4719960,2675580,19_19_19_19_19_19_19_1_1_19_19_19_19_1_1_19_19_19_19_19_1_1_2_2_9_2_2_9_9_9_9_9_14_14
2498,23,1327845480,24,12,24,1327846260,780,307200,1894920,1587720,24_24_24_24_8_8_24_24_24_24_24_24_24_24
2499,102,1327845600,13,17,13,1327872600,27000,549840,3198240,2648400,43_43_43_43_16_16_8_1_16_1_8_16_16_16_2_2_3_3_13_13_13
2500,156,1327845720,16,20,16,1327873440,27720,447000,2639280,2192280,16_16_16_16_16_16_16_16_16_16_16_1_1_1_16_1_16_16_16_16_16_16_1_1_1_1_16_16_16
2501,23,1327846260,24,8,24,1327867140,20880,307980,1894920,1586940,24_24_24_24_8_8_24_24_24_24_24_24_24_24_24
2502,135,1327846740,19,20,19,1327859820,13080,1772340,5649480,3877140,19_19_19_19_19_19_19_19_19_19_19_19_1_19_1_19_19_19_1_1_1_1_19_19_19_19_19_19_1_1_1_1_19_19_19_19_19_19_19_19_19
2503,108,1327848180,25,3,2,1327848240,60,1132320,3191940,2059620,1_1_1_17_1_17_17_17_17_17_17_17_1_1_17_17_7_7_17_17_1_1_1_1_17_17_1_1_17_17_41_41_1_1_1_1_25
2504,108,1327848240,9,3,9,1327848240,0,1132380,3191940,2059560,1_1_1_17_1_17_17_17_17_17_17_17_1_1_17_17_7_7_17_17_1_1_1_1_17_17_1_1_17_17_41_41_1_1_1_1_25_2_9
2505,108,1327848240,2,3,9,1327848240,0,1132380,3191940,2059560,1_1_1_17_1_17_17_17_17_17_17_17_1_1_17_17_7_7_17_17_1_1_1_1_17_17_1_1_17_17_41_41_1_1_1_1_25_2
2506,108,1327848240,9,3,3,1327848300,60,1132380,3191940,2059560,1_1_1_17_1_17_17_17_17_17_17_17_1_1_17_17_7_7_17_17_1_1_1_1_17_17_1_1_17_17_41_41_1_1_1_1_25_2_9_9
2507,108,1327848300,3,3,25,1327852680,4380,1132440,3191940,2059500,1_1_1_17_1_17_17_17_17_17_17_17_1_1_17_17_7_7_17_17_1_1_1_1_17_17_1_1_17_17_41_41_1_1_1_1_25_2_9_9_3
2508,63,1327848720,1,2,16,1327901580,52860,997260,6232860,5235600,16_16_16_16_16_16_16_16_16_0_0_16_16_0_16_16_0_16_16_0_0_16_16_16_0_0_16_0_0_16_0_16_0_0_0_16_1_1_1_16_16_16_0_1_1_1_16_0_0_16_16_0_16_0_16_0_0_2_2_1_1_0_0_0_0_2_2_2_2_2_2_0_1_0_1_1_0_0_0_1_1_0_0_1_1_1_0_0_0_0_0_2_2_2_2_0_0_0_0_0_0_1_1_1_1_0_0_16_0_16_16_16_16_16_0_0_1_1_2_2_1_1
2509,153,1327848720,1,2,16,1327852740,4020,34080,1618560,1584480,16_1
2510,142,1327849200,27,27,27,1327852800,3600,2090760,7299960,5209200,0_0_0_0_0_0_0_1_1_0_0_0_0_0_0_0_0_1_1_0_0_0_0_0_0_1_1_0_0_0_0_0_0_1_1_0_0_0_0_0_0_0_1_0_1_0_0_0_1_1_1_1_27_27_27_27_1_27_27_1_27_27_27_27_27_27_27_27_27_27_27_27_27_27
2511,110,1327849800,4,19,4,1327859820,10020,2308200,5579400,3271200,1_1_0_0_1_1_1_1_2_2_2_2_4_4_4_4_4_4_4_4_4_4_4_4_4_4_4_4_4_4_4_4_4_4_4_4_4_4_4_4_4_4_4_4_4_4_4_4_4_4
2512,158,1327851780,17,10,17,1327852740,960,31260,2044680,2013420,17_17
2513,108,1327852680,25,3,2,1327852740,60,1136820,3191940,2055120,1_1_1_17_1_17_17_17_17_17_17_17_1_1_17_17_7_7_17_17_1_1_1_1_17_17_1_1_17_17_41_41_1_1_1_1_25_2_9_9_3_25
2514,108,1327852740,2,3,3,1327852800,60,1136880,3191940,2055060,1_1_1_17_1_17_17_17_17_17_17_17_1_1_17_17_7_7_17_17_1_1_1_1_17_17_1_1_17_17_41_41_1_1_1_1_25_2_9_9_3_25_2
2515,158,1327852740,17,8,17,1327859640,6900,32220,2044680,2012460,17_17_17
2516,153,1327852740,16,1,1,1327852860,120,38100,1618560,1580460,16_1_16
2517,142,1327852800,27,26,27,1327870800,18000,2094360,7299960,5205600,0_0_0_0_0_0_0_1_1_0_0_0_0_0_0_0_0_1_1_0_0_0_0_0_0_1_1_0_0_0_0_0_0_1_1_0_0_0_0_0_0_0_1_0_1_0_0_0_1_1_1_1_27_27_27_27_1_27_27_1_27_27_27_27_27_27_27_27_27_27_27_27_27_27_27
2518,108,1327852800,3,3,18,1327862700,9900,1136940,3191940,2055000,1_1_1_17_1_17_17_17_17_17_17_17_1_1_17_17_7_7_17_17_1_1_1_1_17_17_1_1_17_17_41_41_1_1_1_1_25_2_9_9_3_25_2_3
2519,153,1327852860,1,2,0,1327860540,7680,38220,1618560,1580340,16_1_16_1
2520,158,1327859640,17,8,17,1327859640,0,39120,2044680,2005560,17_17_17_17
2521,158,1327859640,17,8,17,1327873500,13860,39120,2044680,2005560,17_17_17_17_17
2522,110,1327859820,4,22,4,1327871640,11820,2318220,5579400,3261180,1_1_0_0_1_1_1_1_2_2_2_2_4_4_4_4_4_4_4_4_4_4_4_4_4_4_4_4_4_4_4_4_4_4_4_4_4_4_4_4_4_4_4_4_4_4_4_4_4_4_4
2523,135,1327859820,19,20,19,1327859940,120,1785420,5649480,3864060,19_19_19_19_19_19_19_19_19_19_19_19_1_19_1_19_19_19_1_1_1_1_19_19_19_19_19_19_1_1_1_1_19_19_19_19_19_19_19_19_19_19
2524,135,1327859940,19,11,19,1327898340,38400,1785540,5649480,3863940,19_19_19_19_19_19_19_19_19_19_19_19_1_19_1_19_19_19_1_1_1_1_19_19_19_19_19_19_1_1_1_1_19_19_19_19_19_19_19_19_19_19_19
2525,143,1327860540,10,11,10,1327873560,13020,389460,1898460,1509000,10_10_10_1_10_1_10_1_1_10_10_10_10_10_1_1_10_1_10_1_10_10_10
2526,153,1327860540,0,0,0,1327872180,11640,45900,1618560,1572660,16_1_16_1_0
2527,108,1327862700,18,23,18,1327871460,8760,1146840,3191940,2045100,1_1_1_17_1_17_17_17_17_17_17_17_1_1_17_17_7_7_17_17_1_1_1_1_17_17_1_1_17_17_41_41_1_1_1_1_25_2_9_9_3_25_2_3_18
2528,23,1327867140,24,8,24,1327867200,60,328860,1894920,1566060,24_24_24_24_8_8_24_24_24_24_24_24_24_24_24_24
2529,23,1327867200,24,8,24,1327873500,6300,328920,1894920,1566000,24_24_24_24_8_8_24_24_24_24_24_24_24_24_24_24_24
2530,142,1327870800,27,27,2,1328086920,216120,2112360,7299960,5187600,0_0_0_0_0_0_0_1_1_0_0_0_0_0_0_0_0_1_1_0_0_0_0_0_0_1_1_0_0_0_0_0_0_1_1_0_0_0_0_0_0_0_1_0_1_0_0_0_1_1_1_1_27_27_27_27_1_27_27_1_27_27_27_27_27_27_27_27_27_27_27_27_27_27_27_27
2531,108,1327871460,18,23,4,1327960800,89340,1155600,3191940,2036340,1_1_1_17_1_17_17_17_17_17_17_17_1_1_17_17_7_7_17_17_1_1_1_1_17_17_1_1_17_17_41_41_1_1_1_1_25_2_9_9_3_25_2_3_18_18
2532,110,1327871640,4,22,5,1327924440,52800,2330040,5579400,3249360,1_1_0_0_1_1_1_1_2_2_2_2_4_4_4_4_4_4_4_4_4_4_4_4_4_4_4_4_4_4_4_4_4_4_4_4_4_4_4_4_4_4_4_4_4_4_4_4_4_4_4_4
2533,98,1327872000,4,23,4,1327886400,14400,2132580,7319880,5187300,34_34_2_2_35_35_34_34_2_2_3_3_3_3_3_3_18_18_3_3_3_18_3_3_3_18_18_18_18_3_3_18_18_18_18_18_18_18_18_3_3_18_39_3_3_39_3_3_3_3_4
2534,153,1327872180,0,0,1,1327899600,27420,57540,1618560,1561020,16_1_16_1_0_0
2535,0,1327872240,0,0,0,1327894980,22740,0,1560960,1560960,0
2536,102,1327872600,13,17,15,1328015340,142740,576840,3198240,2621400,43_43_43_43_16_16_8_1_16_1_8_16_16_16_2_2_3_3_13_13_13_13
2537,156,1327873440,16,20,16,1327873620,180,474720,2639280,2164560,16_16_16_16_16_16_16_16_16_16_16_1_1_1_16_1_16_16_16_16_16_16_1_1_1_1_16_16_16_16
2538,158,1327873500,17,8,17,1327873560,60,52980,2044680,1991700,17_17_17_17_17_17
2539,23,1327873500,24,8,24,1327899420,25920,335220,1894920,1559700,24_24_24_24_8_8_24_24_24_24_24_24_24_24_24_24_24_24
2540,158,1327873560,17,0,17,1327898640,25080,53040,2044680,1991640,17_17_17_17_17_17_17
2541,143,1327873560,10,11,1,1327899540,25980,402480,1898460,1495980,10_10_10_1_10_1_10_1_1_10_10_10_10_10_1_1_10_1_10_1_10_10_10_10
2542,156,1327873620,16,11,16,1327898340,24720,474900,2639280,2164380,16_16_16_16_16_16_16_16_16_16_16_1_1_1_16_1_16_16_16_16_16_16_1_1_1_1_16_16_16_16_16
2543,66,1327874400,6,7,6,1327878000,3600,2394000,4817700,2423700,3_3_4_4_4_4_4_4_4_4_4_4_4_4_4_4_4_4_4_4_4_3_3_4_4_4_4_4_4_4_4_4_5_5_5_5_5_5_5_5_6_6_5_5_5_5_4_4_5_5_5_5_5_5_5_5_5_5_6
2544,78,1327874400,4,19,3,1327878900,4500,1814400,1818900,4500,40_40_34_34_5_5_5_5_6_6_3_4
2545,78,1327874400,3,19,4,1327874400,0,1814400,1818900,4500,40_40_34_34_5_5_5_5_6_6_3
2546,112,1327874400,6,7,6,1327878000,3600,1299840,1303440,3600,19_19_19_19_19_1_1_19_19_19_1_1_47_47_2_2_3_3_5_5_5_5_6
2547,126,1327874400,6,7,6,1327878000,3600,492960,496560,3600,19_19_19_19_19_19_1_1_19_19_1_1_2_2_3_3_5_5_5_5_6
2548,123,1327874400,3,4,3,1327878900,4500,919620,3545820,2626200,16_16_16_16_16_16_16_16_16_16_16_16_1_1_2_2_3
2549,83,1327874400,6,7,6,1327878000,3600,1814400,1818000,3600,19_19_19_19_19_19_19_19_19_19_19_19_19_19_19_19_19_19_19_19_19_19_19_19_19_19_19_19_7_19_7_19_1_1_1_1_1_1_1_1_7_7_1_1_3_3_2_2_3_3_2_2_3_3_18_18_18_18_18_18_18_18_18_18_18_18_5_5_5_5_5_5_5_5_5_5_5_5_6_6
2550,101,1327874400,6,7,6,1327878000,3600,651420,655020,3600,10_8_8_10_10_10_10_10_8_8_2_2_9_2_9_2_5_5_5_5_6
2551,83,1327874400,6,7,6,1327874400,0,1814400,1818000,3600,19_19_19_19_19_19_19_19_19_19_19_19_19_19_19_19_19_19_19_19_19_19_19_19_19_19_19_19_7_19_7_19_1_1_1_1_1_1_1_1_7_7_1_1_3_3_2_2_3_3_2_2_3_3_18_18_18_18_18_18_18_18_18_18_18_18_5_5_5_5_5_5_5_5_5_5_5_5_6
2552,144,1327874400,6,7,6,1327878000,3600,1769400,1807260,37860,10_10_10_1_10_10_1_10_10_10_1_10_10_1_10_1_1_10_1_1_2_3_3_2_18_18_18_18_13_13_13_13_5_5_5_5_5_5_6
2553,126,1327878000,6,7,99,1327878000,0,496560,496560,0,19_19_19_19_19_19_1_1_19_19_1_1_2_2_3_3_5_5_5_5_6_6
2554,83,1327878000,6,7,6,1327878000,0,1818000,1818000,0,19_19_19_19_19_19_19_19_19_19_19_19_19_19_19_19_19_19_19_19_19_19_19_19_19_19_19_19_7_19_7_19_1_1_1_1_1_1_1_1_7_7_1_1_3_3_2_2_3_3_2_2_3_3_18_18_18_18_18_18_18_18_18_18_18_18_5_5_5_5_5_5_5_5_5_5_5_5_6_6_6
2555,83,1327878000,6,7,99,1327878000,0,1818000,1818000,0,19_19_19_19_19_19_19_19_19_19_19_19_19_19_19_19_19_19_19_19_19_19_19_19_19_19_19_19_7_19_7_19_1_1_1_1_1_1_1_1_7_7_1_1_3_3_2_2_3_3_2_2_3_3_18_18_18_18_18_18_18_18_18_18_18_18_5_5_5_5_5_5_5_5_5_5_5_5_6_6_6_6
2556,101,1327878000,6,7,99,1327878000,0,655020,655020,0,10_8_8_10_10_10_10_10_8_8_2_2_9_2_9_2_5_5_5_5_6_6
2557,66,1327878000,6,7,6,1327960800,82800,2397600,4817700,2420100,3_3_4_4_4_4_4_4_4_4_4_4_4_4_4_4_4_4_4_4_4_3_3_4_4_4_4_4_4_4_4_4_5_5_5_5_5_5_5_5_6_6_5_5_5_5_4_4_5_5_5_5_5_5_5_5_5_5_6_6
2558,112,1327878000,6,7,99,1327878000,0,1303440,1303440,0,19_19_19_19_19_1_1_19_19_19_1_1_47_47_2_2_3_3_5_5_5_5_6_6
2559,144,1327878000,6,7,5,1327910400,32400,1773000,1807260,34260,10_10_10_1_10_10_1_10_10_10_1_10_10_1_10_1_1_10_1_1_2_3_3_2_18_18_18_18_13_13_13_13_5_5_5_5_5_5_6_6
2560,78,1327878900,4,19,99,1327878900,0,1818900,1818900,0,40_40_34_34_5_5_5_5_6_6_3_4_3_4
2561,78,1327878900,3,19,4,1327878900,0,1818900,1818900,0,40_40_34_34_5_5_5_5_6_6_3_4_3
2562,123,1327878900,3,4,3,1327906920,28020,924120,3545820,2621700,16_16_16_16_16_16_16_16_16_16_16_16_1_1_2_2_3_3
2563,98,1327886400,4,23,5,1327902000,15600,2146980,7319880,5172900,34_34_2_2_35_35_34_34_2_2_3_3_3_3_3_3_18_18_3_3_3_18_3_3_3_18_18_18_18_3_3_18_18_18_18_18_18_18_18_3_3_18_39_3_3_39_3_3_3_3_4_4
2564,0,1327894980,0,0,0,1327895040,60,22740,1560960,1538220,0_0
2565,0,1327895040,0,0,0,1327898520,3480,22800,1560960,1538160,0_0_0
2566,156,1327898340,16,11,16,1327899600,1260,499620,2639280,2139660,16_16_16_16_16_16_16_16_16_16_16_1_1_1_16_1_16_16_16_16_16_16_1_1_1_1_16_16_16_16_16_16
2567,135,1327898340,19,11,1,1327899480,1140,1823940,5649480,3825540,19_19_19_19_19_19_19_19_19_19_19_19_1_19_1_19_19_19_1_1_1_1_19_19_19_19_19_19_1_1_1_1_19_19_19_19_19_19_19_19_19_19_19_19
2568,0,1327898520,0,0,0,1327899540,1020,26280,1560960,1534680,0_0_0_0
2569,158,1327898640,17,0,17,1327899720,1080,78120,2044680,1966560,17_17_17_17_17_17_17_17
2570,23,1327899420,24,12,24,1327909260,9840,361140,1894920,1533780,24_24_24_24_8_8_24_24_24_24_24_24_24_24_24_24_24_24_24
2571,135,1327899480,1,9,19,1327899840,360,1825080,5649480,3824400,19_19_19_19_19_19_19_19_19_19_19_19_1_19_1_19_19_19_1_1_1_1_19_19_19_19_19_19_1_1_1_1_19_19_19_19_19_19_19_19_19_19_19_19_1
2572,143,1327899540,1,9,1,1327901340,1800,428460,1898460,1470000,10_10_10_1_10_1_10_1_1_10_10_10_10_10_1_1_10_1_10_1_10_10_10_10_1
2573,0,1327899540,0,1,0,1327900860,1320,27300,1560960,1533660,0_0_0_0_0
2574,156,1327899600,16,14,16,1327931340,31740,500880,2639280,2138400,16_16_16_16_16_16_16_16_16_16_16_1_1_1_16_1_16_16_16_16_16_16_1_1_1_1_16_16_16_16_16_16_16
2575,153,1327899600,1,2,1,1327902000,2400,84960,1618560,1533600,16_1_16_1_0_0_1
2576,158,1327899720,17,10,1,1327899840,120,79200,2044680,1965480,17_17_17_17_17_17_17_17_17
2577,158,1327899840,1,18,17,1327903560,3720,79320,2044680,1965360,17_17_17_17_17_17_17_17_17_1
2578,135,1327899840,19,14,1,1327912140,12300,1825440,5649480,3824040,19_19_19_19_19_19_19_19_19_19_19_19_1_19_1_19_19_19_1_1_1_1_19_19_19_19_19_19_1_1_1_1_19_19_19_19_19_19_19_19_19_19_19_19_1_19
2579,61,1327900320,34,15,34,1327901400,1080,2445120,6225300,3780180,4_4_18_18_34_34_34_3_3_34_3_3_34_35_34_35_35_35_36_36_35_35_35_35_34_34_34_34_34_34_34_34_34_34_34
2580,0,1327900860,0,1,0,1327913880,13020,28620,1560960,1532340,0_0_0_0_0_0_0
2581,0,1327900860,0,1,0,1327900860,0,28620,1560960,1532340,0_0_0_0_0_0
2582,143,1327901340,1,9,1,1327903800,2460,430260,1898460,1468200,10_10_10_1_10_1_10_1_1_10_10_10_10_10_1_1_10_1_10_1_10_10_10_10_1_1
2583,103,1327901400,14,15,14,1327907040,5640,2100420,4719960,2619540,19_19_19_19_19_19_19_1_1_19_19_19_19_1_1_19_19_19_19_19_1_1_2_2_9_2_2_9_9_9_9_9_14_14_14
2584,61,1327901400,34,15,34,1328774520,873120,2446200,6225300,3779100,4_4_18_18_34_34_34_3_3_34_3_3_34_35_34_35_35_35_36_36_35_35_35_35_34_34_34_34_34_34_34_34_34_34_34_34
2585,63,1327901580,16,1,0,1327901820,240,1050120,6232860,5182740,16_16_16_16_16_16_16_16_16_0_0_16_16_0_16_16_0_16_16_0_0_16_16_16_0_0_16_0_0_16_0_16_0_0_0_16_1_1_1_16_16_16_0_1_1_1_16_0_0_16_16_0_16_0_16_0_0_2_2_1_1_0_0_0_0_2_2_2_2_2_2_0_1_0_1_1_0_0_0_1_1_0_0_1_1_1_0_0_0_0_0_2_2_2_2_0_0_0_0_0_0_1_1_1_1_0_0_16_0_16_16_16_16_16_0_0_1_1_2_2_1_1_16
2586,63,1327901820,0,1,2,1327904880,3060,1050360,6232860,5182500,16_16_16_16_16_16_16_16_16_0_0_16_16_0_16_16_0_16_16_0_0_16_16_16_0_0_16_0_0_16_0_16_0_0_0_16_1_1_1_16_16_16_0_1_1_1_16_0_0_16_16_0_16_0_16_0_0_2_2_1_1_0_0_0_0_2_2_2_2_2_2_0_1_0_1_1_0_0_0_1_1_0_0_1_1_1_0_0_0_0_0_2_2_2_2_0_0_0_0_0_0_1_1_1_1_0_0_16_0_16_16_16_16_16_0_0_1_1_2_2_1_1_16_0
2587,98,1327902000,5,2,5,1327905600,3600,2162580,7319880,5157300,34_34_2_2_35_35_34_34_2_2_3_3_3_3_3_3_18_18_3_3_3_18_3_3_3_18_18_18_18_3_3_18_18_18_18_18_18_18_18_3_3_18_39_3_3_39_3_3_3_3_4_4_5
2588,153,1327902000,1,2,2,1327903680,1680,87360,1618560,1531200,16_1_16_1_0_0_1_1
2589,130,1327903560,17,10,17,1327929660,26100,1179900,3083940,1904040,26_26_26_26_26_26_8_8_26_26_26_26_26_26_26_26_26_26_26_8_26_8_17
2590,158,1327903560,17,10,1,1327910400,6840,83040,2044680,1961640,17_17_17_17_17_17_17_17_17_1_17
2591,153,1327903680,2,3,2,1327904880,1200,89040,1618560,1529520,16_1_16_1_0_0_1_1_2
2592,143,1327903800,1,9,1,1327908300,4500,432720,1898460,1465740,10_10_10_1_10_1_10_1_1_10_10_10_10_10_1_1_10_1_10_1_10_10_10_10_1_1_1
2593,153,1327904880,2,3,3,1329216120,1311240,90240,1618560,1528320,16_1_16_1_0_0_1_1_2_2
2594,63,1327904880,2,3,16,1327905300,420,1053420,6232860,5179440,16_16_16_16_16_16_16_16_16_0_0_16_16_0_16_16_0_16_16_0_0_16_16_16_0_0_16_0_0_16_0_16_0_0_0_16_1_1_1_16_16_16_0_1_1_1_16_0_0_16_16_0_16_0_16_0_0_2_2_1_1_0_0_0_0_2_2_2_2_2_2_0_1_0_1_1_0_0_0_1_1_0_0_1_1_1_0_0_0_0_0_2_2_2_2_0_0_0_0_0_0_1_1_1_1_0_0_16_0_16_16_16_16_16_0_0_1_1_2_2_1_1_16_0_2
2595,63,1327905300,16,1,2,1327908840,3540,1053840,6232860,5179020,16_16_16_16_16_16_16_16_16_0_0_16_16_0_16_16_0_16_16_0_0_16_16_16_0_0_16_0_0_16_0_16_0_0_0_16_1_1_1_16_16_16_0_1_1_1_16_0_0_16_16_0_16_0_16_0_0_2_2_1_1_0_0_0_0_2_2_2_2_2_2_0_1_0_1_1_0_0_0_1_1_0_0_1_1_1_0_0_0_0_0_2_2_2_2_0_0_0_0_0_0_1_1_1_1_0_0_16_0_16_16_16_16_16_0_0_1_1_2_2_1_1_16_0_2_16
2596,98,1327905600,5,2,5,1327906800,1200,2166180,7319880,5153700,34_34_2_2_35_35_34_34_2_2_3_3_3_3_3_3_18_18_3_3_3_18_3_3_3_18_18_18_18_3_3_18_18_18_18_18_18_18_18_3_3_18_39_3_3_39_3_3_3_3_4_4_5_5
2597,98,1327906800,5,2,5,1327920600,13800,2167380,7319880,5152500,34_34_2_2_35_35_34_34_2_2_3_3_3_3_3_3_18_18_3_3_3_18_3_3_3_18_18_18_18_3_3_18_18_18_18_18_18_18_18_3_3_18_39_3_3_39_3_3_3_3_4_4_5_5_5
2598,123,1327906920,3,4,14,1327907100,180,952140,3545820,2593680,16_16_16_16_16_16_16_16_16_16_16_16_1_1_2_2_3_3_3
2599,103,1327907040,14,15,13,1329661440,1754400,2106060,4719960,2613900,19_19_19_19_19_19_19_1_1_19_19_19_19_1_1_19_19_19_19_19_1_1_2_2_9_2_2_9_9_9_9_9_14_14_14_14
2600,123,1327907100,14,15,14,1327907160,60,952320,3545820,2593500,16_16_16_16_16_16_16_16_16_16_16_16_1_1_2_2_3_3_3_14
2601,123,1327907160,14,15,3,1327907220,60,952380,3545820,2593440,16_16_16_16_16_16_16_16_16_16_16_16_1_1_2_2_3_3_3_14_14
2602,123,1327907220,3,4,3,1327907340,120,952440,3545820,2593380,16_16_16_16_16_16_16_16_16_16_16_16_1_1_2_2_3_3_3_14_14_3
2603,123,1327907340,3,4,3,1327910640,3300,952560,3545820,2593260,16_16_16_16_16_16_16_16_16_16_16_16_1_1_2_2_3_3_3_14_14_3_3
2604,143,1327908300,1,9,1,1328511600,603300,437220,1898460,1461240,10_10_10_1_10_1_10_1_1_10_10_10_10_10_1_1_10_1_10_1_10_10_10_10_1_1_1_1
2605,63,1327908840,2,3,2,1327935420,26580,1057380,6232860,5175480,16_16_16_16_16_16_16_16_16_0_0_16_16_0_16_16_0_16_16_0_0_16_16_16_0_0_16_0_0_16_0_16_0_0_0_16_1_1_1_16_16_16_0_1_1_1_16_0_0_16_16_0_16_0_16_0_0_2_2_1_1_0_0_0_0_2_2_2_2_2_2_0_1_0_1_1_0_0_0_1_1_0_0_1_1_1_0_0_0_0_0_2_2_2_2_0_0_0_0_0_0_1_1_1_1_0_0_16_0_16_16_16_16_16_0_0_1_1_2_2_1_1_16_0_2_16_2
2606,23,1327909260,24,12,8,1327912140,2880,370980,1894920,1523940,24_24_24_24_8_8_24_24_24_24_24_24_24_24_24_24_24_24_24_24
2607,161,1327909620,10,16,24,1327911600,1980,0,1955580,1955580,10
2608,132,1327909680,2,3,2,1327912140,2460,1171920,1658640,486720,19_19_19_19_19_19_19_19_19_19_19_19_19_19_1_1_1_1_2
2609,144,1327910400,5,18,5,1327912260,1860,1805400,1807260,1860,10_10_10_1_10_10_1_10_10_10_1_10_10_1_10_1_1_10_1_1_2_3_3_2_18_18_18_18_13_13_13_13_5_5_5_5_5_5_6_6_5
2610,158,1327910400,1,18,2,1328080800,170400,89880,2044680,1954800,17_17_17_17_17_17_17_17_17_1_17_1
2611,123,1327910640,3,4,14,1327911600,960,955860,3545820,2589960,16_16_16_16_16_16_16_16_16_16_16_16_1_1_2_2_3_3_3_14_14_3_3_3
2612,92,1327911540,42,39,42,1327931880,20340,0,613860,613860,42
2613,123,1327911600,14,15,14,1327916160,4560,956820,3545820,2589000,16_16_16_16_16_16_16_16_16_16_16_16_1_1_2_2_3_3_3_14_14_3_3_3_14
2614,161,1327911600,24,12,24,1327925940,14340,1980,1955580,1953600,10_24
2615,23,1327912140,8,9,8,1327916640,4500,373860,1894920,1521060,24_24_24_24_8_8_24_24_24_24_24_24_24_24_24_24_24_24_24_24_8
2616,132,1327912140,3,3,1,1327913100,960,1174380,1658640,484260,19_19_19_19_19_19_19_19_19_19_19_19_19_19_1_1_1_1_2_2_3
2617,132,1327912140,2,3,3,1327912140,0,1174380,1658640,484260,19_19_19_19_19_19_19_19_19_19_19_19_19_19_1_1_1_1_2_2
2618,135,1327912140,1,9,19,1327931340,19200,1837740,5649480,3811740,19_19_19_19_19_19_19_19_19_19_19_19_1_19_1_19_19_19_1_1_1_1_19_19_19_19_19_19_1_1_1_1_19_19_19_19_19_19_19_19_19_19_19_19_1_19_1
2619,144,1327912260,5,18,99,1327912260,0,1807260,1807260,0,10_10_10_1_10_10_1_10_10_10_1_10_10_1_10_1_1_10_1_1_2_3_3_2_18_18_18_18_13_13_13_13_5_5_5_5_5_5_6_6_5_5
2620,132,1327913100,1,9,1,1327914000,900,1175340,1658640,483300,19_19_19_19_19_19_19_19_19_19_19_19_19_19_1_1_1_1_2_2_3_1
2621,0,1327913880,0,1,1,1328008800,94920,41640,1560960,1519320,0_0_0_0_0_0_0_0
2622,69,1327913940,16,1,16,1327932600,18660,0,2073180,2073180,16
2623,132,1327914000,1,9,3,1327929540,15540,1176240,1658640,482400,19_19_19_19_19_19_19_19_19_19_19_19_19_19_1_1_1_1_2_2_3_1_1
2624,65,1327914000,5,18,5,1327918680,4680,2372400,7544400,5172000,17_17_34_34_6_6_6_6_5_5_1_1_1_1_2_2_3_3_5
2625,123,1327916160,14,15,14,1327931580,15420,961380,3545820,2584440,16_16_16_16_16_16_16_16_16_16_16_16_1_1_2_2_3_3_3_14_14_3_3_3_14_14_14
2626,123,1327916160,14,15,14,1327916160,0,961380,3545820,2584440,16_16_16_16_16_16_16_16_16_16_16_16_1_1_2_2_3_3_3_14_14_3_3_3_14_14
2627,23,1327916640,8,9,7,1328392800,476160,378360,1894920,1516560,24_24_24_24_8_8_24_24_24_24_24_24_24_24_24_24_24_24_24_24_8_8
2628,65,1327918680,5,18,5,1332659700,4741020,2377080,7544400,5167320,17_17_34_34_6_6_6_6_5_5_1_1_1_1_2_2_3_3_5_5
2629,98,1327920600,5,2,5,1327922400,1800,2181180,7319880,5138700,34_34_2_2_35_35_34_34_2_2_3_3_3_3_3_3_18_18_3_3_3_18_3_3_3_18_18_18_18_3_3_18_18_18_18_18_18_18_18_3_3_18_39_3_3_39_3_3_3_3_4_4_5_5_5_5
2630,98,1327922400,5,2,5,1327935600,13200,2182980,7319880,5136900,34_34_2_2_35_35_34_34_2_2_3_3_3_3_3_3_18_18_3_3_3_18_3_3_3_18_18_18_18_3_3_18_18_18_18_18_18_18_18_3_3_18_39_3_3_39_3_3_3_3_4_4_5_5_5_5_5
2631,110,1327924440,5,9,5,1327939320,14880,2382840,5579400,3196560,1_1_0_0_1_1_1_1_2_2_2_2_4_4_4_4_4_4_4_4_4_4_4_4_4_4_4_4_4_4_4_4_4_4_4_4_4_4_4_4_4_4_4_4_4_4_4_4_4_4_4_4_5
2632,161,1327925940,24,12,10,1327927560,1620,16320,1955580,1939260,10_24_24
2633,107,1327926600,8,18,8,1327929540,2940,0,4991760,4991760,8
2634,215,1327927080,24,12,24,1327931940,4860,0,1851720,1851720,24
2635,161,1327927560,10,16,10,1327927620,60,17940,1955580,1937640,10_24_24_10
2636,161,1327927620,10,16,10,1327939320,11700,18000,1955580,1937580,10_24_24_10_10
2637,132,1327929540,3,3,5,1328086740,157200,1191780,1658640,466860,19_19_19_19_19_19_19_19_19_19_19_19_19_19_1_1_1_1_2_2_3_1_1_3
2638,1,1327929540,9,3,9,1327935540,6000,1153080,1447140,294060,7_8_7_8_7_7_7_7_7_7_7_7_7_7_7_7_7_7_7_7_7_7_7_7_7_7_7_7_7_7_8_8_2_2_2_2_2_2_9_9_9_9_9
2639,107,1327929540,8,18,8,1328047200,117660,2940,4991760,4988820,8_8
2640,130,1327929660,17,10,1,1327930200,540,1206000,3083940,1877940,26_26_26_26_26_26_8_8_26_26_26_26_26_26_26_26_26_26_26_8_26_8_17_17
2641,130,1327930200,1,18,1,1327938840,8640,1206540,3083940,1877400,26_26_26_26_26_26_8_8_26_26_26_26_26_26_26_26_26_26_26_8_26_8_17_17_1
2642,133,1327930260,17,10,17,1327937340,7080,1139460,6181200,5041740,17_17_17_17_17_17_17_17_17_17_17_17_17_17_17_17_17_17_17_17_17_17_17_17_17_17_17_17_17_17_1_1_17_17_17_17_1_1_1_1_17_17_17_17_17_17_17
2643,156,1327931340,16,14,16,1327931880,540,532620,2639280,2106660,16_16_16_16_16_16_16_16_16_16_16_1_1_1_16_1_16_16_16_16_16_16_1_1_1_1_16_16_16_16_16_16_16_16
2644,135,1327931340,19,14,19,1327932180,840,1856940,5649480,3792540,19_19_19_19_19_19_19_19_19_19_19_19_1_19_1_19_19_19_1_1_1_1_19_19_19_19_19_19_1_1_1_1_19_19_19_19_19_19_19_19_19_19_19_19_1_19_1_19
2645,123,1327931580,14,15,14,1327932540,960,976800,3545820,2569020,16_16_16_16_16_16_16_16_16_16_16_16_1_1_2_2_3_3_3_14_14_3_3_3_14_14_14_14
2646,156,1327931880,16,20,16,1327958940,27060,533160,2639280,2106120,16_16_16_16_16_16_16_16_16_16_16_1_1_1_16_1_16_16_16_16_16_16_1_1_1_1_16_16_16_16_16_16_16_16_16
2647,92,1327931880,42,39,42,1327949820,17940,20340,613860,593520,42_42
2648,215,1327931940,24,12,24,1327932420,480,4860,1851720,1846860,24_24
2649,135,1327932180,19,20,19,1327958880,26700,1857780,5649480,3791700,19_19_19_19_19_19_19_19_19_19_19_19_1_19_1_19_19_19_1_1_1_1_19_19_19_19_19_19_1_1_1_1_19_19_19_19_19_19_19_19_19_19_19_19_1_19_1_19_19
2650,215,1327932420,24,8,24,1327937640,5220,5340,1851720,1846380,24_24_24
2651,123,1327932540,14,17,14,1327960680,28140,977760,3545820,2568060,16_16_16_16_16_16_16_16_16_16_16_16_1_1_2_2_3_3_3_14_14_3_3_3_14_14_14_14_14
2652,69,1327932600,16,1,1,1327935600,3000,18660,2073180,2054520,16_16
2653,96,1327932660,2,3,2,1327935480,2820,622860,2123400,1500540,10_1_10_10_10_10_1_10_10_10_10_10_1_1_2
2654,63,1327935420,2,3,2,1327935480,60,1083960,6232860,5148900,16_16_16_16_16_16_16_16_16_0_0_16_16_0_16_16_0_16_16_0_0_16_16_16_0_0_16_0_0_16_0_16_0_0_0_16_1_1_1_16_16_16_0_1_1_1_16_0_0_16_16_0_16_0_16_0_0_2_2_1_1_0_0_0_0_2_2_2_2_2_2_0_1_0_1_1_0_0_0_1_1_0_0_1_1_1_0_0_0_0_0_2_2_2_2_0_0_0_0_0_0_1_1_1_1_0_0_16_0_16_16_16_16_16_0_0_1_1_2_2_1_1_16_0_2_16_2_2
2655,96,1327935480,2,3,9,1327960800,25320,625680,2123400,1497720,10_1_10_10_10_10_1_10_10_10_10_10_1_1_2_2
2656,63,1327935480,2,3,0,1327959480,24000,1084020,6232860,5148840,16_16_16_16_16_16_16_16_16_0_0_16_16_0_16_16_0_16_16_0_0_16_16_16_0_0_16_0_0_16_0_16_0_0_0_16_1_1_1_16_16_16_0_1_1_1_16_0_0_16_16_0_16_0_16_0_0_2_2_1_1_0_0_0_0_2_2_2_2_2_2_0_1_0_1_1_0_0_0_1_1_0_0_1_1_1_0_0_0_0_0_2_2_2_2_0_0_0_0_0_0_1_1_1_1_0_0_16_0_16_16_16_16_16_0_0_1_1_2_2_1_1_16_0_2_16_2_2_2
2657,1,1327935540,9,3,5,1328179080,243540,1159080,1447140,288060,7_8_7_8_7_7_7_7_7_7_7_7_7_7_7_7_7_7_7_7_7_7_7_7_7_7_7_7_7_7_8_8_2_2_2_2_2_2_9_9_9_9_9_9
2658,98,1327935600,5,2,4,1327948200,12600,2196180,7319880,5123700,34_34_2_2_35_35_34_34_2_2_3_3_3_3_3_3_18_18_3_3_3_18_3_3_3_18_18_18_18_3_3_18_18_18_18_18_18_18_18_3_3_18_39_3_3_39_3_3_3_3_4_4_5_5_5_5_5_5
2659,69,1327935600,1,2,1,1327939500,3900,21660,2073180,2051520,16_16_1
2660,133,1327937340,17,10,17,1327937820,480,1146540,6181200,5034660,17_17_17_17_17_17_17_17_17_17_17_17_17_17_17_17_17_17_17_17_17_17_17_17_17_17_17_17_17_17_1_1_17_17_17_17_1_1_1_1_17_17_17_17_17_17_17_17
2661,215,1327937640,24,8,24,1327937700,60,10560,1851720,1841160,24_24_24_24
2662,215,1327937700,24,8,24,1327950180,12480,10620,1851720,1841100,24_24_24_24_24
2663,133,1327937820,17,8,17,1327956300,18480,1147020,6181200,5034180,17_17_17_17_17_17_17_17_17_17_17_17_17_17_17_17_17_17_17_17_17_17_17_17_17_17_17_17_17_17_1_1_17_17_17_17_1_1_1_1_17_17_17_17_17_17_17_17_17
2664,130,1327938840,1,18,17,1327988820,49980,1215180,3083940,1868760,26_26_26_26_26_26_8_8_26_26_26_26_26_26_26_26_26_26_26_8_26_8_17_17_1_1
2665,110,1327939320,5,9,6,1327960800,21480,2397720,5579400,3181680,1_1_0_0_1_1_1_1_2_2_2_2_4_4_4_4_4_4_4_4_4_4_4_4_4_4_4_4_4_4_4_4_4_4_4_4_4_4_4_4_4_4_4_4_4_4_4_4_4_4_4_4_5_5
2666,161,1327939320,10,16,10,1327946640,7320,29700,1955580,1925880,10_24_24_10_10_10
2667,69,1327939500,1,2,0,1327945800,6300,25560,2073180,2047620,16_16_1_1
2668,69,1327945800,0,0,0,1327984800,39000,31860,2073180,2041320,16_16_1_1_0
2669,161,1327946640,10,11,10,1327985100,38460,37020,1955580,1918560,10_24_24_10_10_10_10
2670,98,1327948200,4,23,4,1327984200,36000,2208780,7319880,5111100,34_34_2_2_35_35_34_34_2_2_3_3_3_3_3_3_18_18_3_3_3_18_3_3_3_18_18_18_18_3_3_18_18_18_18_18_18_18_18_3_3_18_39_3_3_39_3_3_3_3_4_4_5_5_5_5_5_5_4
2671,92,1327949820,42,40,42,1327985460,35640,38280,613860,575580,42_42_42
2672,215,1327950180,24,8,8,1328073780,123600,23100,1851720,1828620,24_24_24_24_24_24
2673,165,1327950300,24,8,24,1327959660,9360,0,1262880,1262880,24
2674,133,1327956300,17,8,17,1327956360,60,1165500,6181200,5015700,17_17_17_17_17_17_17_17_17_17_17_17_17_17_17_17_17_17_17_17_17_17_17_17_17_17_17_17_17_17_1_1_17_17_17_17_1_1_1_1_17_17_17_17_17_17_17_17_17_17
2675,133,1327956360,17,8,17,1327956420,60,1165560,6181200,5015640,17_17_17_17_17_17_17_17_17_17_17_17_17_17_17_17_17_17_17_17_17_17_17_17_17_17_17_17_17_17_1_1_17_17_17_17_1_1_1_1_17_17_17_17_17_17_17_17_17_17_17
2676,133,1327956420,17,8,17,1327959780,3360,1165620,6181200,5015580,17_17_17_17_17_17_17_17_17_17_17_17_17_17_17_17_17_17_17_17_17_17_17_17_17_17_17_17_17_17_1_1_17_17_17_17_1_1_1_1_17_17_17_17_17_17_17_17_17_17_17_17
2677,135,1327958880,19,20,19,1327959240,360,1884480,5649480,3765000,19_19_19_19_19_19_19_19_19_19_19_19_1_19_1_19_19_19_1_1_1_1_19_19_19_19_19_19_1_1_1_1_19_19_19_19_19_19_19_19_19_19_19_19_1_19_1_19_19_19
2678,156,1327958940,16,20,16,1327959180,240,560220,2639280,2079060,16_16_16_16_16_16_16_16_16_16_16_1_1_1_16_1_16_16_16_16_16_16_1_1_1_1_16_16_16_16_16_16_16_16_16_16
2679,156,1327959180,16,11,16,1327985100,25920,560460,2639280,2078820,16_16_16_16_16_16_16_16_16_16_16_1_1_1_16_1_16_16_16_16_16_16_1_1_1_1_16_16_16_16_16_16_16_16_16_16_16
2680,135,1327959240,19,11,19,1327985040,25800,1884840,5649480,3764640,19_19_19_19_19_19_19_19_19_19_19_19_1_19_1_19_19_19_1_1_1_1_19_19_19_19_19_19_1_1_1_1_19_19_19_19_19_19_19_19_19_19_19_19_1_19_1_19_19_19_19
2681,63,1327959480,0,1,1,1327986000,26520,1108020,6232860,5124840,16_16_16_16_16_16_16_16_16_0_0_16_16_0_16_16_0_16_16_0_0_16_16_16_0_0_16_0_0_16_0_16_0_0_0_16_1_1_1_16_16_16_0_1_1_1_16_0_0_16_16_0_16_0_16_0_0_2_2_1_1_0_0_0_0_2_2_2_2_2_2_0_1_0_1_1_0_0_0_1_1_0_0_1_1_1_0_0_0_0_0_2_2_2_2_0_0_0_0_0_0_1_1_1_1_0_0_16_0_16_16_16_16_16_0_0_1_1_2_2_1_1_16_0_2_16_2_2_2_0
2682,165,1327959660,24,8,24,1327987020,27360,9360,1262880,1253520,24_24
2683,133,1327959780,17,0,17,1327984800,25020,1168980,6181200,5012220,17_17_17_17_17_17_17_17_17_17_17_17_17_17_17_17_17_17_17_17_17_17_17_17_17_17_17_17_17_17_1_1_17_17_17_17_1_1_1_1_17_17_17_17_17_17_17_17_17_17_17_17_17
2684,123,1327960680,14,17,14,1328041500,80820,1005900,3545820,2539920,16_16_16_16_16_16_16_16_16_16_16_16_1_1_2_2_3_3_3_14_14_3_3_3_14_14_14_14_14_14
2685,110,1327960800,6,30,6,1327964400,3600,2419200,5579400,3160200,1_1_0_0_1_1_1_1_2_2_2_2_4_4_4_4_4_4_4_4_4_4_4_4_4_4_4_4_4_4_4_4_4_4_4_4_4_4_4_4_4_4_4_4_4_4_4_4_4_4_4_4_5_5_6
2686,200,1327960800,6,7,6,1327964400,3600,0,59160,59160,6
2687,108,1327960800,4,23,4,1327971600,10800,1244940,3191940,1947000,1_1_1_17_1_17_17_17_17_17_17_17_1_1_17_17_7_7_17_17_1_1_1_1_17_17_1_1_17_17_41_41_1_1_1_1_25_2_9_9_3_25_2_3_18_18_4
2688,96,1327960800,9,4,9,1327965300,4500,651000,2123400,1472400,10_1_10_10_10_10_1_10_10_10_10_10_1_1_2_2_9
2689,66,1327960800,6,30,6,1327964400,3600,2480400,4817700,2337300,3_3_4_4_4_4_4_4_4_4_4_4_4_4_4_4_4_4_4_4_4_3_3_4_4_4_4_4_4_4_4_4_5_5_5_5_5_5_5_5_6_6_5_5_5_5_4_4_5_5_5_5_5_5_5_5_5_5_6_6_6
2690,200,1327964400,6,7,5,1327989840,25440,3600,59160,55560,6_6
2691,66,1327964400,6,30,6,1328738400,774000,2484000,4817700,2333700,3_3_4_4_4_4_4_4_4_4_4_4_4_4_4_4_4_4_4_4_4_3_3_4_4_4_4_4_4_4_4_4_5_5_5_5_5_5_5_5_6_6_5_5_5_5_4_4_5_5_5_5_5_5_5_5_5_5_6_6_6_6
2692,110,1327964400,6,30,5,1327986000,21600,2422800,5579400,3156600,1_1_0_0_1_1_1_1_2_2_2_2_4_4_4_4_4_4_4_4_4_4_4_4_4_4_4_4_4_4_4_4_4_4_4_4_4_4_4_4_4_4_4_4_4_4_4_4_4_4_4_4_5_5_6_6
2693,96,1327965300,9,4,9,1328047200,81900,655500,2123400,1467900,10_1_10_10_10_10_1_10_10_10_10_10_1_1_2_2_9_9
2694,108,1327971600,4,23,4,1327971600,0,1255740,3191940,1936200,1_1_1_17_1_17_17_17_17_17_17_17_1_1_17_17_7_7_17_17_1_1_1_1_17_17_1_1_17_17_41_41_1_1_1_1_25_2_9_9_3_25_2_3_18_18_4_4
2695,108,1327971600,4,23,4,1327983300,11700,1255740,3191940,1936200,1_1_1_17_1_17_17_17_17_17_17_17_1_1_17_17_7_7_17_17_1_1_1_1_17_17_1_1_17_17_41_41_1_1_1_1_25_2_9_9_3_25_2_3_18_18_4_4_4
2696,108,1327983300,4,23,4,1327986000,2700,1267440,3191940,1924500,1_1_1_17_1_17_17_17_17_17_17_17_1_1_17_17_7_7_17_17_1_1_1_1_17_17_1_1_17_17_41_41_1_1_1_1_25_2_9_9_3_25_2_3_18_18_4_4_4_4_4
2697,108,1327983300,4,23,4,1327983300,0,1267440,3191940,1924500,1_1_1_17_1_17_17_17_17_17_17_17_1_1_17_17_7_7_17_17_1_1_1_1_17_17_1_1_17_17_41_41_1_1_1_1_25_2_9_9_3_25_2_3_18_18_4_4_4_4
2698,98,1327984200,4,23,4,1327986000,1800,2244780,7319880,5075100,34_34_2_2_35_35_34_34_2_2_3_3_3_3_3_3_18_18_3_3_3_18_3_3_3_18_18_18_18_3_3_18_18_18_18_18_18_18_18_3_3_18_39_3_3_39_3_3_3_3_4_4_5_5_5_5_5_5_4_4
2699,69,1327984800,0,0,1,1328014200,29400,70860,2073180,2002320,16_16_1_1_0_0
2700,133,1327984800,17,0,17,1327986900,2100,1194000,6181200,4987200,17_17_17_17_17_17_17_17_17_17_17_17_17_17_17_17_17_17_17_17_17_17_17_17_17_17_17_17_17_17_1_1_17_17_17_17_1_1_1_1_17_17_17_17_17_17_17_17_17_17_17_17_17_17
2701,135,1327985040,19,11,19,1327986480,1440,1910640,5649480,3738840,19_19_19_19_19_19_19_19_19_19_19_19_1_19_1_19_19_19_1_1_1_1_19_19_19_19_19_19_1_1_1_1_19_19_19_19_19_19_19_19_19_19_19_19_1_19_1_19_19_19_19_19
2702,156,1327985100,16,11,16,1327986540,1440,586380,2639280,2052900,16_16_16_16_16_16_16_16_16_16_16_1_1_1_16_1_16_16_16_16_16_16_1_1_1_1_16_16_16_16_16_16_16_16_16_16_16_16
2703,161,1327985100,10,11,10,1327986000,900,75480,1955580,1880100,10_24_24_10_10_10_10_10
2704,92,1327985460,42,40,42,1328038860,53400,73920,613860,539940,42_42_42_42
2705,63,1327986000,1,2,1,1327986840,840,1134540,6232860,5098320,16_16_16_16_16_16_16_16_16_0_0_16_16_0_16_16_0_16_16_0_0_16_16_16_0_0_16_0_0_16_0_16_0_0_0_16_1_1_1_16_16_16_0_1_1_1_16_0_0_16_16_0_16_0_16_0_0_2_2_1_1_0_0_0_0_2_2_2_2_2_2_0_1_0_1_1_0_0_0_1_1_0_0_1_1_1_0_0_0_0_0_2_2_2_2_0_0_0_0_0_0_1_1_1_1_0_0_16_0_16_16_16_16_16_0_0_1_1_2_2_1_1_16_0_2_16_2_2_2_0_1
2706,110,1327986000,5,9,5,1327988820,2820,2444400,5579400,3135000,1_1_0_0_1_1_1_1_2_2_2_2_4_4_4_4_4_4_4_4_4_4_4_4_4_4_4_4_4_4_4_4_4_4_4_4_4_4_4_4_4_4_4_4_4_4_4_4_4_4_4_4_5_5_6_6_5
2707,161,1327986000,10,45,10,1328025600,39600,76380,1955580,1879200,10_24_24_10_10_10_10_10_10
2708,108,1327986000,4,23,14,1328018400,32400,1270140,3191940,1921800,1_1_1_17_1_17_17_17_17_17_17_17_1_1_17_17_7_7_17_17_1_1_1_1_17_17_1_1_17_17_41_41_1_1_1_1_25_2_9_9_3_25_2_3_18_18_4_4_4_4_4_4
2709,98,1327986000,4,15,5,1327986840,840,2246580,7319880,5073300,34_34_2_2_35_35_34_34_2_2_3_3_3_3_3_3_18_18_3_3_3_18_3_3_3_18_18_18_18_3_3_18_18_18_18_18_18_18_18_3_3_18_39_3_3_39_3_3_3_3_4_4_5_5_5_5_5_5_4_4_4
2710,59,1327986000,15,18,15,1327986180,180,0,1800,1800,15
2711,59,1327986180,15,18,15,1327987800,1620,180,1800,1620,15_15
2712,135,1327986480,19,14,1,1327988880,2400,1912080,5649480,3737400,19_19_19_19_19_19_19_19_19_19_19_19_1_19_1_19_19_19_1_1_1_1_19_19_19_19_19_19_1_1_1_1_19_19_19_19_19_19_19_19_19_19_19_19_1_19_1_19_19_19_19_19_19
2713,156,1327986540,16,14,16,1328018160,31620,587820,2639280,2051460,16_16_16_16_16_16_16_16_16_16_16_1_1_1_16_1_16_16_16_16_16_16_1_1_1_1_16_16_16_16_16_16_16_16_16_16_16_16_16
2714,63,1327986840,1,2,1,1328072400,85560,1135380,6232860,5097480,16_16_16_16_16_16_16_16_16_0_0_16_16_0_16_16_0_16_16_0_0_16_16_16_0_0_16_0_0_16_0_16_0_0_0_16_1_1_1_16_16_16_0_1_1_1_16_0_0_16_16_0_16_0_16_0_0_2_2_1_1_0_0_0_0_2_2_2_2_2_2_0_1_0_1_1_0_0_0_1_1_0_0_1_1_1_0_0_0_0_0_2_2_2_2_0_0_0_0_0_0_1_1_1_1_0_0_16_0_16_16_16_16_16_0_0_1_1_2_2_1_1_16_0_2_16_2_2_2_0_1_1
2715,98,1327986840,5,2,3,1327991400,4560,2247420,7319880,5072460,34_34_2_2_35_35_34_34_2_2_3_3_3_3_3_3_18_18_3_3_3_18_3_3_3_18_18_18_18_3_3_18_18_18_18_18_18_18_18_3_3_18_39_3_3_39_3_3_3_3_4_4_5_5_5_5_5_5_4_4_4_5
2716,133,1327986900,17,10,17,1327988820,1920,1196100,6181200,4985100,17_17_17_17_17_17_17_17_17_17_17_17_17_17_17_17_17_17_17_17_17_17_17_17_17_17_17_17_17_17_1_1_17_17_17_17_1_1_1_1_17_17_17_17_17_17_17_17_17_17_17_17_17_17_17
2717,165,1327987020,24,12,24,1327995240,8220,36720,1262880,1226160,24_24_24
2718,59,1327987800,15,18,15,1327987800,0,1800,1800,0,15_15_15
2719,59,1327987800,15,18,99,1327987800,0,1800,1800,0,15_15_15_15
2720,133,1327988820,17,10,17,1329286380,1297560,1198020,6181200,4983180,17_17_17_17_17_17_17_17_17_17_17_17_17_17_17_17_17_17_17_17_17_17_17_17_17_17_17_17_17_17_1_1_17_17_17_17_1_1_1_1_17_17_17_17_17_17_17_17_17_17_17_17_17_17_17_17
2721,110,1327988820,5,9,5,1327995480,6660,2447220,5579400,3132180,1_1_0_0_1_1_1_1_2_2_2_2_4_4_4_4_4_4_4_4_4_4_4_4_4_4_4_4_4_4_4_4_4_4_4_4_4_4_4_4_4_4_4_4_4_4_4_4_4_4_4_4_5_5_6_6_5_5
2722,130,1327988820,17,10,1,1327993200,4380,1265160,3083940,1818780,26_26_26_26_26_26_8_8_26_26_26_26_26_26_26_26_26_26_26_8_26_8_17_17_1_1_17
2723,135,1327988880,1,9,19,1327994940,6060,1914480,5649480,3735000,19_19_19_19_19_19_19_19_19_19_19_19_1_19_1_19_19_19_1_1_1_1_19_19_19_19_19_19_1_1_1_1_19_19_19_19_19_19_19_19_19_19_19_19_1_19_1_19_19_19_19_19_19_1
2724,200,1327989840,5,18,5,1327992000,2160,29040,59160,30120,6_6_5
2725,173,1327991220,0,1,0,1328018880,27660,0,3215700,3215700,0
2726,98,1327991400,3,3,5,1327992000,600,2251980,7319880,5067900,34_34_2_2_35_35_34_34_2_2_3_3_3_3_3_3_18_18_3_3_3_18_3_3_3_18_18_18_18_3_3_18_18_18_18_18_18_18_18_3_3_18_39_3_3_39_3_3_3_3_4_4_5_5_5_5_5_5_4_4_4_5_3
2727,98,1327992000,5,2,5,1327993200,1200,2252580,7319880,5067300,34_34_2_2_35_35_34_34_2_2_3_3_3_3_3_3_18_18_3_3_3_18_3_3_3_18_18_18_18_3_3_18_18_18_18_18_18_18_18_3_3_18_39_3_3_39_3_3_3_3_4_4_5_5_5_5_5_5_4_4_4_5_3_5
2728,200,1327992000,5,18,5,1328015460,23460,31200,59160,27960,6_6_5_5
2729,98,1327993200,5,2,3,1328004420,11220,2253780,7319880,5066100,34_34_2_2_35_35_34_34_2_2_3_3_3_3_3_3_18_18_3_3_3_18_3_3_3_18_18_18_18_3_3_18_18_18_18_18_18_18_18_3_3_18_39_3_3_39_3_3_3_3_4_4_5_5_5_5_5_5_4_4_4_5_3_5_5
2730,130,1327993200,1,18,17,1328002740,9540,1269540,3083940,1814400,26_26_26_26_26_26_8_8_26_26_26_26_26_26_26_26_26_26_26_8_26_8_17_17_1_1_17_1
2731,135,1327994940,19,14,1,1328002980,8040,1920540,5649480,3728940,19_19_19_19_19_19_19_19_19_19_19_19_1_19_1_19_19_19_1_1_1_1_19_19_19_19_19_19_1_1_1_1_19_19_19_19_19_19_19_19_19_19_19_19_1_19_1_19_19_19_19_19_19_1_19
2732,171,1327995000,19,14,19,1328018220,23220,207000,435600,228600,19_19_19
2733,165,1327995240,24,12,24,1328019180,23940,44940,1262880,1217940,24_24_24_24
2734,203,1327995300,7,12,7,1328018460,23160,0,1897500,1897500,7
2735,110,1327995480,5,9,5,1328002680,7200,2453880,5579400,3125520,1_1_0_0_1_1_1_1_2_2_2_2_4_4_4_4_4_4_4_4_4_4_4_4_4_4_4_4_4_4_4_4_4_4_4_4_4_4_4_4_4_4_4_4_4_4_4_4_4_4_4_4_5_5_6_6_5_5_5
2736,110,1328002680,5,9,18,1328594460,591780,2461080,5579400,3118320,1_1_0_0_1_1_1_1_2_2_2_2_4_4_4_4_4_4_4_4_4_4_4_4_4_4_4_4_4_4_4_4_4_4_4_4_4_4_4_4_4_4_4_4_4_4_4_4_4_4_4_4_5_5_6_6_5_5_5_5
2737,130,1328002740,17,10,17,1328002800,60,1279080,3083940,1804860,26_26_26_26_26_26_8_8_26_26_26_26_26_26_26_26_26_26_26_8_26_8_17_17_1_1_17_1_17
2738,130,1328002800,17,10,1,1328004000,1200,1279140,3083940,1804800,26_26_26_26_26_26_8_8_26_26_26_26_26_26_26_26_26_26_26_8_26_8_17_17_1_1_17_1_17_17
2739,135,1328002980,1,9,1,1328158260,155280,1928580,5649480,3720900,19_19_19_19_19_19_19_19_19_19_19_19_1_19_1_19_19_19_1_1_1_1_19_19_19_19_19_19_1_1_1_1_19_19_19_19_19_19_19_19_19_19_19_19_1_19_1_19_19_19_19_19_19_1_19_1
2740,73,1328004000,1,18,1,1328015100,11100,0,1303500,1303500,1
2741,130,1328004000,1,18,17,1328017860,13860,1280340,3083940,1803600,26_26_26_26_26_26_8_8_26_26_26_26_26_26_26_26_26_26_26_8_26_8_17_17_1_1_17_1_17_17_1
2742,98,1328004420,3,3,5,1328007000,2580,2265000,7319880,5054880,34_34_2_2_35_35_34_34_2_2_3_3_3_3_3_3_18_18_3_3_3_18_3_3_3_18_18_18_18_3_3_18_18_18_18_18_18_18_18_3_3_18_39_3_3_39_3_3_3_3_4_4_5_5_5_5_5_5_4_4_4_5_3_5_5_3
2743,141,1328004480,3,3,3,1328022120,17640,2351280,7406100,5054820,1_1_16_16_16_16_16_1_16_16_1_1_1_16_16_16_16_16_16_16_16_16_16_16_16_16_16_16_1_1_1_1_1_1_1_1_1_1_1_1_16_2_2_16_3
2744,98,1328007000,5,2,4,1328018160,11160,2267580,7319880,5052300,34_34_2_2_35_35_34_34_2_2_3_3_3_3_3_3_18_18_3_3_3_18_3_3_3_18_18_18_18_3_3_18_18_18_18_18_18_18_18_3_3_18_39_3_3_39_3_3_3_3_4_4_5_5_5_5_5_5_4_4_4_5_3_5_5_3_5
2745,0,1328008800,1,2,1,1328014200,5400,136560,1560960,1424400,0_0_0_0_0_0_0_0_1
2746,0,1328014200,1,2,2,1328077080,62880,141960,1560960,1419000,0_0_0_0_0_0_0_0_1_1
2747,69,1328014200,1,2,1,1328019000,4800,100260,2073180,1972920,16_16_1_1_0_0_1
2748,73,1328015100,1,18,9,1328392800,377700,11100,1303500,1292400,1_1
2749,102,1328015340,15,18,15,1328025540,10200,719580,3198240,2478660,43_43_43_43_16_16_8_1_16_1_8_16_16_16_2_2_3_3_13_13_13_13_15
2750,200,1328015460,5,18,5,1328019960,4500,54660,59160,4500,6_6_5_5_5
2751,130,1328017860,17,10,17,1328021280,3420,1294200,3083940,1789740,26_26_26_26_26_26_8_8_26_26_26_26_26_26_26_26_26_26_26_8_26_8_17_17_1_1_17_1_17_17_1_17
2752,156,1328018160,16,14,16,1328019300,1140,619440,2639280,2019840,16_16_16_16_16_16_16_16_16_16_16_1_1_1_16_1_16_16_16_16_16_16_1_1_1_1_16_16_16_16_16_16_16_16_16_16_16_16_16_16
2753,98,1328018160,4,15,4,1328018220,60,2278740,7319880,5041140,34_34_2_2_35_35_34_34_2_2_3_3_3_3_3_3_18_18_3_3_3_18_3_3_3_18_18_18_18_3_3_18_18_18_18_18_18_18_18_3_3_18_39_3_3_39_3_3_3_3_4_4_5_5_5_5_5_5_4_4_4_5_3_5_5_3_5_4
2754,98,1328018220,4,22,4,1328045460,27240,2278800,7319880,5041080,34_34_2_2_35_35_34_34_2_2_3_3_3_3_3_3_18_18_3_3_3_18_3_3_3_18_18_18_18_3_3_18_18_18_18_18_18_18_18_3_3_18_39_3_3_39_3_3_3_3_4_4_5_5_5_5_5_5_4_4_4_5_3_5_5_3_5_4_4
2755,171,1328018220,19,14,19,1328022060,3840,230220,435600,205380,19_19_19_19
2756,108,1328018400,14,17,1,1328019000,600,1302540,3191940,1889400,1_1_1_17_1_17_17_17_17_17_17_17_1_1_17_17_7_7_17_17_1_1_1_1_17_17_1_1_17_17_41_41_1_1_1_1_25_2_9_9_3_25_2_3_18_18_4_4_4_4_4_4_14
2757,203,1328018460,7,12,7,1328086080,67620,23160,1897500,1874340,7_7
2758,173,1328018880,0,1,0,1328032080,13200,27660,3215700,3188040,0_0
2759,69,1328019000,1,2,2,1328077620,58620,105060,2073180,1968120,16_16_1_1_0_0_1_1
2760,108,1328019000,1,2,1,1328025540,6540,1303140,3191940,1888800,1_1_1_17_1_17_17_17_17_17_17_17_1_1_17_17_7_7_17_17_1_1_1_1_17_17_1_1_17_17_41_41_1_1_1_1_25_2_9_9_3_25_2_3_18_18_4_4_4_4_4_4_14_1
2761,165,1328019180,24,8,24,1328020740,1560,68880,1262880,1194000,24_24_24_24_24
2762,156,1328019300,16,20,16,1328045820,26520,620580,2639280,2018700,16_16_16_16_16_16_16_16_16_16_16_1_1_1_16_1_16_16_16_16_16_16_1_1_1_1_16_16_16_16_16_16_16_16_16_16_16_16_16_16_16
2763,200,1328019960,5,18,99,1328019960,0,59160,59160,0,6_6_5_5_5_5
2764,165,1328020740,24,8,24,1328020800,60,70440,1262880,1192440,24_24_24_24_24_24
2765,165,1328020800,24,8,24,1328023680,2880,70500,1262880,1192380,24_24_24_24_24_24_24
2766,130,1328021280,17,8,17,1328045820,24540,1297620,3083940,1786320,26_26_26_26_26_26_8_8_26_26_26_26_26_26_26_26_26_26_26_8_26_8_17_17_1_1_17_1_17_17_1_17_17
2767,171,1328022060,19,20,19,1328033040,10980,234060,435600,201540,19_19_19_19_19
2768,141,1328022120,3,3,3,1328097120,75000,2368920,7406100,5037180,1_1_16_16_16_16_16_1_16_16_1_1_1_16_16_16_16_16_16_16_16_16_16_16_16_16_16_16_1_1_1_1_1_1_1_1_1_1_1_1_16_2_2_16_3_3
2769,165,1328023680,24,8,24,1328023740,60,73380,1262880,1189500,24_24_24_24_24_24_24_24
2770,165,1328023740,24,8,24,1328045820,22080,73440,1262880,1189440,24_24_24_24_24_24_24_24_24
2771,108,1328025540,1,2,14,1328041200,15660,1309680,3191940,1882260,1_1_1_17_1_17_17_17_17_17_17_17_1_1_17_17_7_7_17_17_1_1_1_1_17_17_1_1_17_17_41_41_1_1_1_1_25_2_9_9_3_25_2_3_18_18_4_4_4_4_4_4_14_1_1
2772,102,1328025540,15,18,3,1330243020,2217480,729780,3198240,2468460,43_43_43_43_16_16_8_1_16_1_8_16_16_16_2_2_3_3_13_13_13_13_15_15
2773,161,1328025600,10,45,10,1328072400,46800,115980,1955580,1839600,10_24_24_10_10_10_10_10_10_10
2774,173,1328032080,0,0,0,1328046900,14820,40860,3215700,3174840,0_0_0
2775,171,1328033040,19,11,19,1328033160,120,245040,435600,190560,19_19_19_19_19_19
2776,171,1328033160,19,20,19,1328042400,9240,245160,435600,190440,19_19_19_19_19_19_19
2777,92,1328038860,42,40,42,1328072100,33240,127320,613860,486540,42_42_42_42_42
2778,108,1328041200,14,17,4,1328072400,31200,1325340,3191940,1866600,1_1_1_17_1_17_17_17_17_17_17_17_1_1_17_17_7_7_17_17_1_1_1_1_17_17_1_1_17_17_41_41_1_1_1_1_25_2_9_9_3_25_2_3_18_18_4_4_4_4_4_4_14_1_1_14
2779,123,1328041500,14,17,14,1328045340,3840,1086720,3545820,2459100,16_16_16_16_16_16_16_16_16_16_16_16_1_1_2_2_3_3_3_14_14_3_3_3_14_14_14_14_14_14_14
2780,171,1328042400,19,11,19,1328042460,60,254400,435600,181200,19_19_19_19_19_19_19_19
2781,171,1328042460,19,11,19,1328059260,16800,254460,435600,181140,19_19_19_19_19_19_19_19_19
2782,123,1328045340,14,17,14,1328073960,28620,1090560,3545820,2455260,16_16_16_16_16_16_16_16_16_16_16_16_1_1_2_2_3_3_3_14_14_3_3_3_14_14_14_14_14_14_14_14
2783,98,1328045460,4,22,5,1328436000,390540,2306040,7319880,5013840,34_34_2_2_35_35_34_34_2_2_3_3_3_3_3_3_18_18_3_3_3_18_3_3_3_18_18_18_18_3_3_18_18_18_18_18_18_18_18_3_3_18_39_3_3_39_3_3_3_3_4_4_5_5_5_5_5_5_4_4_4_5_3_5_5_3_5_4_4_4
2784,130,1328045820,17,8,17,1328072520,26700,1322160,3083940,1761780,26_26_26_26_26_26_8_8_26_26_26_26_26_26_26_26_26_26_26_8_26_8_17_17_1_1_17_1_17_17_1_17_17_17
2785,165,1328045820,24,8,24,1328046420,600,95520,1262880,1167360,24_24_24_24_24_24_24_24_24_24
2786,156,1328045820,16,20,16,1328046600,780,647100,2639280,1992180,16_16_16_16_16_16_16_16_16_16_16_1_1_1_16_1_16_16_16_16_16_16_1_1_1_1_16_16_16_16_16_16_16_16_16_16_16_16_16_16_16_16
2787,165,1328046420,24,0,24,1328071380,24960,96120,1262880,1166760,24_24_24_24_24_24_24_24_24_24_24
2788,156,1328046600,16,11,16,1328072100,25500,647880,2639280,1991400,16_16_16_16_16_16_16_16_16_16_16_1_1_1_16_1_16_16_16_16_16_16_1_1_1_1_16_16_16_16_16_16_16_16_16_16_16_16_16_16_16_16_16
2789,173,1328046900,0,0,0,1328046960,60,55680,3215700,3160020,0_0_0_0
2790,173,1328046960,0,0,0,1328071380,24420,55740,3215700,3159960,0_0_0_0_0
2791,96,1328047200,9,4,9,1328051700,4500,737400,2123400,1386000,10_1_10_10_10_10_1_10_10_10_10_10_1_1_2_2_9_9_9
2792,107,1328047200,8,18,8,1328051700,4500,120600,4991760,4871160,8_8_8
2793,79,1328047200,1,18,1,1328051700,4500,2419200,4151700,1732500,15_1_15_1_26_26_26_26_26_26_26_26_26_26_26_26_26_26_26_26_8_8_1_1_10_10_10_10_10_10_41_1_1_41_6_6_41_41_41_41_18_14_15_18_15_14_1_1_14_14_14_14_1
2794,96,1328051700,9,4,9,1328080020,28320,741900,2123400,1381500,10_1_10_10_10_10_1_10_10_10_10_10_1_1_2_2_9_9_9_9
2795,79,1328051700,1,18,1,1328783700,732000,2423700,4151700,1728000,15_1_15_1_26_26_26_26_26_26_26_26_26_26_26_26_26_26_26_26_8_8_1_1_10_10_10_10_10_10_41_1_1_41_6_6_41_41_41_41_18_14_15_18_15_14_1_1_14_14_14_14_1_1
2796,107,1328051700,8,18,28,1328086800,35100,125100,4991760,4866660,8_8_8_8
2797,171,1328059260,19,11,1,1328080560,21300,271260,435600,164340,19_19_19_19_19_19_19_19_19_19
2798,114,1328059320,19,11,19,1328072400,13080,0,1201080,1201080,19
2799,165,1328071380,24,0,8,1328072100,720,121080,1262880,1141800,24_24_24_24_24_24_24_24_24_24_24_24
2800,173,1328071380,0,0,1,1328072400,1020,80160,3215700,3135540,0_0_0_0_0_0
2801,92,1328072100,42,40,42,1328072400,300,160560,613860,453300,42_42_42_42_42_42
2802,165,1328072100,8,9,8,1328073780,1680,121800,1262880,1141080,24_24_24_24_24_24_24_24_24_24_24_24_8
2803,156,1328072100,16,11,16,1328072400,300,673380,2639280,1965900,16_16_16_16_16_16_16_16_16_16_16_1_1_1_16_1_16_16_16_16_16_16_1_1_1_1_16_16_16_16_16_16_16_16_16_16_16_16_16_16_16_16_16_16
2804,173,1328072400,1,18,1,1328078400,6000,81180,3215700,3134520,0_0_0_0_0_0_1
2805,114,1328072400,19,11,19,1328072520,120,13080,1201080,1188000,19_19
2806,161,1328072400,10,16,10,1328107140,34740,162780,1955580,1792800,10_24_24_10_10_10_10_10_10_10_10
2807,92,1328072400,42,39,42,1328101200,28800,160860,613860,453000,42_42_42_42_42_42_42
2808,108,1328072400,4,5,4,1328077200,4800,1356540,3191940,1835400,1_1_1_17_1_17_17_17_17_17_17_17_1_1_17_17_7_7_17_17_1_1_1_1_17_17_1_1_17_17_41_41_1_1_1_1_25_2_9_9_3_25_2_3_18_18_4_4_4_4_4_4_14_1_1_14_4
2809,63,1328072400,1,2,1,1328074200,1800,1220940,6232860,5011920,16_16_16_16_16_16_16_16_16_0_0_16_16_0_16_16_0_16_16_0_0_16_16_16_0_0_16_0_0_16_0_16_0_0_0_16_1_1_1_16_16_16_0_1_1_1_16_0_0_16_16_0_16_0_16_0_0_2_2_1_1_0_0_0_0_2_2_2_2_2_2_0_1_0_1_1_0_0_0_1_1_0_0_1_1_1_0_0_0_0_0_2_2_2_2_0_0_0_0_0_0_1_1_1_1_0_0_16_0_16_16_16_16_16_0_0_1_1_2_2_1_1_16_0_2_16_2_2_2_0_1_1_1
2810,156,1328072400,16,14,16,1328104080,31680,673680,2639280,1965600,16_16_16_16_16_16_16_16_16_16_16_1_1_1_16_1_16_16_16_16_16_16_1_1_1_1_16_16_16_16_16_16_16_16_16_16_16_16_16_16_16_16_16_16_16
2811,130,1328072520,17,12,17,1328085960,13440,1348860,3083940,1735080,26_26_26_26_26_26_8_8_26_26_26_26_26_26_26_26_26_26_26_8_26_8_17_17_1_1_17_1_17_17_1_17_17_17_17
2812,114,1328072520,19,14,19,1328101260,28740,13200,1201080,1187880,19_19_19
2813,165,1328073780,8,9,9,1328626200,552420,123480,1262880,1139400,24_24_24_24_24_24_24_24_24_24_24_24_8_8
2814,215,1328073780,8,9,8,1328074200,420,146700,1851720,1705020,24_24_24_24_24_24_8
2815,123,1328073960,14,15,15,1328087400,13440,1119180,3545820,2426640,16_16_16_16_16_16_16_16_16_16_16_16_1_1_2_2_3_3_3_14_14_3_3_3_14_14_14_14_14_14_14_14_14
2816,215,1328074200,8,9,3,1328082840,8640,147120,1851720,1704600,24_24_24_24_24_24_8_8
2817,63,1328074200,1,2,16,1328074200,0,1222740,6232860,5010120,16_16_16_16_16_16_16_16_16_0_0_16_16_0_16_16_0_16_16_0_0_16_16_16_0_0_16_0_0_16_0_16_0_0_0_16_1_1_1_16_16_16_0_1_1_1_16_0_0_16_16_0_16_0_16_0_0_2_2_1_1_0_0_0_0_2_2_2_2_2_2_0_1_0_1_1_0_0_0_1_1_0_0_1_1_1_0_0_0_0_0_2_2_2_2_0_0_0_0_0_0_1_1_1_1_0_0_16_0_16_16_16_16_16_0_0_1_1_2_2_1_1_16_0_2_16_2_2_2_0_1_1_1_1_1
2818,63,1328074200,16,2,16,1328075400,1200,1222740,6232860,5010120,16_16_16_16_16_16_16_16_16_0_0_16_16_0_16_16_0_16_16_0_0_16_16_16_0_0_16_0_0_16_0_16_0_0_0_16_1_1_1_16_16_16_0_1_1_1_16_0_0_16_16_0_16_0_16_0_0_2_2_1_1_0_0_0_0_2_2_2_2_2_2_0_1_0_1_1_0_0_0_1_1_0_0_1_1_1_0_0_0_0_0_2_2_2_2_0_0_0_0_0_0_1_1_1_1_0_0_16_0_16_16_16_16_16_0_0_1_1_2_2_1_1_16_0_2_16_2_2_2_0_1_1_1_1_1_16
2819,63,1328074200,1,2,1,1328074200,0,1222740,6232860,5010120,16_16_16_16_16_16_16_16_16_0_0_16_16_0_16_16_0_16_16_0_0_16_16_16_0_0_16_0_0_16_0_16_0_0_0_16_1_1_1_16_16_16_0_1_1_1_16_0_0_16_16_0_16_0_16_0_0_2_2_1_1_0_0_0_0_2_2_2_2_2_2_0_1_0_1_1_0_0_0_1_1_0_0_1_1_1_0_0_0_0_0_2_2_2_2_0_0_0_0_0_0_1_1_1_1_0_0_16_0_16_16_16_16_16_0_0_1_1_2_2_1_1_16_0_2_16_2_2_2_0_1_1_1_1
2820,63,1328075400,16,2,1,1328080740,5340,1223940,6232860,5008920,16_16_16_16_16_16_16_16_16_0_0_16_16_0_16_16_0_16_16_0_0_16_16_16_0_0_16_0_0_16_0_16_0_0_0_16_1_1_1_16_16_16_0_1_1_1_16_0_0_16_16_0_16_0_16_0_0_2_2_1_1_0_0_0_0_2_2_2_2_2_2_0_1_0_1_1_0_0_0_1_1_0_0_1_1_1_0_0_0_0_0_2_2_2_2_0_0_0_0_0_0_1_1_1_1_0_0_16_0_16_16_16_16_16_0_0_1_1_2_2_1_1_16_0_2_16_2_2_2_0_1_1_1_1_1_16_16
2821,0,1328077080,2,3,2,1328077620,540,204840,1560960,1356120,0_0_0_0_0_0_0_0_1_1_2
2822,108,1328077200,4,5,4,1328077200,0,1361340,3191940,1830600,1_1_1_17_1_17_17_17_17_17_17_17_1_1_17_17_7_7_17_17_1_1_1_1_17_17_1_1_17_17_41_41_1_1_1_1_25_2_9_9_3_25_2_3_18_18_4_4_4_4_4_4_14_1_1_14_4_4
2823,108,1328077200,4,5,25,1328089320,12120,1361340,3191940,1830600,1_1_1_17_1_17_17_17_17_17_17_17_1_1_17_17_7_7_17_17_1_1_1_1_17_17_1_1_17_17_41_41_1_1_1_1_25_2_9_9_3_25_2_3_18_18_4_4_4_4_4_4_14_1_1_14_4_4_4
2824,0,1328077620,2,3,3,1329170400,1092780,205380,1560960,1355580,0_0_0_0_0_0_0_0_1_1_2_2
2825,69,1328077620,2,3,2,1328080740,3120,163680,2073180,1909500,16_16_1_1_0_0_1_1_2
2826,173,1328078400,1,18,0,1328079600,1200,87180,3215700,3128520,0_0_0_0_0_0_1_1
2827,173,1328079600,0,1,0,1328088480,8880,88380,3215700,3127320,0_0_0_0_0_0_1_1_0
2828,96,1328080020,9,4,9,1328082420,2400,770220,2123400,1353180,10_1_10_10_10_10_1_10_10_10_10_10_1_1_2_2_9_9_9_9_9
2829,171,1328080560,1,18,1,1328087460,6900,292560,435600,143040,19_19_19_19_19_19_19_19_19_19_1
2830,69,1328080740,2,3,3,1329688800,1608060,166800,2073180,1906380,16_16_1_1_0_0_1_1_2_2
2831,63,1328080740,1,2,1,1329121800,1041060,1229280,6232860,5003580,16_16_16_16_16_16_16_16_16_0_0_16_16_0_16_16_0_16_16_0_0_16_16_16_0_0_16_0_0_16_0_16_0_0_0_16_1_1_1_16_16_16_0_1_1_1_16_0_0_16_16_0_16_0_16_0_0_2_2_1_1_0_0_0_0_2_2_2_2_2_2_0_1_0_1_1_0_0_0_1_1_0_0_1_1_1_0_0_0_0_0_2_2_2_2_0_0_0_0_0_0_1_1_1_1_0_0_16_0_16_16_16_16_16_0_0_1_1_2_2_1_1_16_0_2_16_2_2_2_0_1_1_1_1_1_16_16_1
2832,158,1328080800,2,3,2,1328082840,2040,260280,2044680,1784400,17_17_17_17_17_17_17_17_17_1_17_1_2
2833,96,1328082420,3,4,3,1328083620,1200,772620,2123400,1350780,10_1_10_10_10_10_1_10_10_10_10_10_1_1_2_2_9_9_9_9_9_9_3
2834,96,1328082420,9,4,3,1328082420,0,772620,2123400,1350780,10_1_10_10_10_10_1_10_10_10_10_10_1_1_2_2_9_9_9_9_9_9
2835,158,1328082840,2,3,3,1328087880,5040,262320,2044680,1782360,17_17_17_17_17_17_17_17_17_1_17_1_2_2
2836,215,1328082840,3,3,3,1328087880,5040,155760,1851720,1695960,24_24_24_24_24_24_8_8_3
2837,96,1328083620,3,4,5,1328100000,16380,773820,2123400,1349580,10_1_10_10_10_10_1_10_10_10_10_10_1_1_2_2_9_9_9_9_9_9_3_3
2838,130,1328085960,17,12,17,1328105220,19260,1362300,3083940,1721640,26_26_26_26_26_26_8_8_26_26_26_26_26_26_26_26_26_26_26_8_26_8_17_17_1_1_17_1_17_17_1_17_17_17_17_17
2839,203,1328086080,7,12,7,1328105040,18960,90780,1897500,1806720,7_7_7
2840,132,1328086740,5,9,5,1328105280,18540,1348980,1658640,309660,19_19_19_19_19_19_19_19_19_19_19_19_19_19_1_1_1_1_2_2_3_1_1_3_5
2841,107,1328086800,28,26,28,1328104800,18000,160200,4991760,4831560,8_8_8_8_28
2842,142,1328086920,2,4,2,1328093460,6540,2328480,7299960,4971480,0_0_0_0_0_0_0_1_1_0_0_0_0_0_0_0_0_1_1_0_0_0_0_0_0_1_1_0_0_0_0_0_0_1_1_0_0_0_0_0_0_0_1_0_1_0_0_0_1_1_1_1_27_27_27_27_1_27_27_1_27_27_27_27_27_27_27_27_27_27_27_27_27_27_27_27_2
2843,123,1328087400,15,18,14,1328088360,960,1132620,3545820,2413200,16_16_16_16_16_16_16_16_16_16_16_16_1_1_2_2_3_3_3_14_14_3_3_3_14_14_14_14_14_14_14_14_14_15
2844,171,1328087460,1,18,2,1328100600,13140,299460,435600,136140,19_19_19_19_19_19_19_19_19_19_1_1
2845,215,1328087880,3,3,3,1329225180,1137300,160800,1851720,1690920,24_24_24_24_24_24_8_8_3_3
2846,158,1328087880,3,3,3,1328088000,120,267360,2044680,1777320,17_17_17_17_17_17_17_17_17_1_17_1_2_2_3
2847,158,1328088000,3,3,3,1328088060,60,267480,2044680,1777200,17_17_17_17_17_17_17_17_17_1_17_1_2_2_3_3
2848,158,1328088060,3,3,13,1328088600,540,267540,2044680,1777140,17_17_17_17_17_17_17_17_17_1_17_1_2_2_3_3_3
2849,123,1328088360,14,15,15,1328097000,8640,1133580,3545820,2412240,16_16_16_16_16_16_16_16_16_16_16_16_1_1_2_2_3_3_3_14_14_3_3_3_14_14_14_14_14_14_14_14_14_15_14
2850,173,1328088480,0,1,1,1328097000,8520,97260,3215700,3118440,0_0_0_0_0_0_1_1_0_0
2851,162,1328088540,0,1,0,1328104920,16380,0,4836120,4836120,0
2852,158,1328088600,13,15,13,1328089260,660,268080,2044680,1776600,17_17_17_17_17_17_17_17_17_1_17_1_2_2_3_3_3_13
2853,158,1328089260,13,15,3,1328097120,7860,268740,2044680,1775940,17_17_17_17_17_17_17_17_17_1_17_1_2_2_3_3_3_13_13
2854,108,1328089320,25,15,4,1328091840,2520,1373460,3191940,1818480,1_1_1_17_1_17_17_17_17_17_17_17_1_1_17_17_7_7_17_17_1_1_1_1_17_17_1_1_17_17_41_41_1_1_1_1_25_2_9_9_3_25_2_3_18_18_4_4_4_4_4_4_14_1_1_14_4_4_4_25
2855,67,1328091840,4,5,4,1328099640,7800,2592540,3120480,527940,2_3_3_3_2_3_3_3_1_1_27_27_4
2856,108,1328091840,4,5,25,1328096760,4920,1375980,3191940,1815960,1_1_1_17_1_17_17_17_17_17_17_17_1_1_17_17_7_7_17_17_1_1_1_1_17_17_1_1_17_17_41_41_1_1_1_1_25_2_9_9_3_25_2_3_18_18_4_4_4_4_4_4_14_1_1_14_4_4_4_25_4
2857,142,1328093460,2,4,2,1328095380,1920,2335020,7299960,4964940,0_0_0_0_0_0_0_1_1_0_0_0_0_0_0_0_0_1_1_0_0_0_0_0_0_1_1_0_0_0_0_0_0_1_1_0_0_0_0_0_0_0_1_0_1_0_0_0_1_1_1_1_27_27_27_27_1_27_27_1_27_27_27_27_27_27_27_27_27_27_27_27_27_27_27_27_2_2
2858,142,1328095380,2,4,2,1328097720,2340,2336940,7299960,4963020,0_0_0_0_0_0_0_1_1_0_0_0_0_0_0_0_0_1_1_0_0_0_0_0_0_1_1_0_0_0_0_0_0_1_1_0_0_0_0_0_0_0_1_0_1_0_0_0_1_1_1_1_27_27_27_27_1_27_27_1_27_27_27_27_27_27_27_27_27_27_27_27_27_27_27_27_2_2_2
2859,108,1328096760,25,15,34,1328096760,0,1380900,3191940,1811040,1_1_1_17_1_17_17_17_17_17_17_17_1_1_17_17_7_7_17_17_1_1_1_1_17_17_1_1_17_17_41_41_1_1_1_1_25_2_9_9_3_25_2_3_18_18_4_4_4_4_4_4_14_1_1_14_4_4_4_25_4_25
2860,108,1328096760,34,15,34,1328098320,1560,1380900,3191940,1811040,1_1_1_17_1_17_17_17_17_17_17_17_1_1_17_17_7_7_17_17_1_1_1_1_17_17_1_1_17_17_41_41_1_1_1_1_25_2_9_9_3_25_2_3_18_18_4_4_4_4_4_4_14_1_1_14_4_4_4_25_4_25_34
2861,173,1328097000,1,18,1,1328099580,2580,105780,3215700,3109920,0_0_0_0_0_0_1_1_0_0_1
2862,123,1328097000,15,18,15,1329112800,1015800,1142220,3545820,2403600,16_16_16_16_16_16_16_16_16_16_16_16_1_1_2_2_3_3_3_14_14_3_3_3_14_14_14_14_14_14_14_14_14_15_14_15
2863,158,1328097120,3,3,13,1328098320,1200,276600,2044680,1768080,17_17_17_17_17_17_17_17_17_1_17_1_2_2_3_3_3_13_13_3
2864,141,1328097120,3,3,3,1328105040,7920,2443920,7406100,4962180,1_1_16_16_16_16_16_1_16_16_1_1_1_16_16_16_16_16_16_16_16_16_16_16_16_16_16_16_1_1_1_1_1_1_1_1_1_1_1_1_16_2_2_16_3_3_3
2865,142,1328097720,2,4,2,1328109960,12240,2339280,7299960,4960680,0_0_0_0_0_0_0_1_1_0_0_0_0_0_0_0_0_1_1_0_0_0_0_0_0_1_1_0_0_0_0_0_0_1_1_0_0_0_0_0_0_0_1_0_1_0_0_0_1_1_1_1_27_27_27_27_1_27_27_1_27_27_27_27_27_27_27_27_27_27_27_27_27_27_27_27_2_2_2_2
2866,158,1328098320,13,15,13,1328100360,2040,277800,2044680,1766880,17_17_17_17_17_17_17_17_17_1_17_1_2_2_3_3_3_13_13_3_13
2867,108,1328098320,34,15,6,1328133600,35280,1382460,3191940,1809480,1_1_1_17_1_17_17_17_17_17_17_17_1_1_17_17_7_7_17_17_1_1_1_1_17_17_1_1_17_17_41_41_1_1_1_1_25_2_9_9_3_25_2_3_18_18_4_4_4_4_4_4_14_1_1_14_4_4_4_25_4_25_34_34
2868,173,1328099580,1,18,2,1328100960,1380,108360,3215700,3107340,0_0_0_0_0_0_1_1_0_0_1_1
2869,67,1328099640,4,5,4,1328099640,0,2600340,3120480,520140,2_3_3_3_2_3_3_3_1_1_27_27_4_4
2870,67,1328099640,4,5,4,1328111940,12300,2600340,3120480,520140,2_3_3_3_2_3_3_3_1_1_27_27_4_4_4
2871,96,1328100000,5,18,5,1328101200,1200,790200,2123400,1333200,10_1_10_10_10_10_1_10_10_10_10_10_1_1_2_2_9_9_9_9_9_9_3_3_5
2872,158,1328100360,13,15,13,1328105400,5040,279840,2044680,1764840,17_17_17_17_17_17_17_17_17_1_17_1_2_2_3_3_3_13_13_3_13_13
2873,171,1328100600,3,3,3,1328100600,0,312600,435600,123000,19_19_19_19_19_19_19_19_19_19_1_1_2_3
2874,171,1328100600,3,3,5,1328101380,780,312600,435600,123000,19_19_19_19_19_19_19_19_19_19_1_1_2_3_3
2875,171,1328100600,2,3,3,1328100600,0,312600,435600,123000,19_19_19_19_19_19_19_19_19_19_1_1_2
2876,173,1328100960,2,3,2,1328102640,1680,109740,3215700,3105960,0_0_0_0_0_0_1_1_0_0_1_1_2
2877,96,1328101200,5,18,9,1328133600,32400,791400,2123400,1332000,10_1_10_10_10_10_1_10_10_10_10_10_1_1_2_2_9_9_9_9_9_9_3_3_5_5
2878,92,1328101200,42,39,5,1328167800,66600,189660,613860,424200,42_42_42_42_42_42_42_42
2879,114,1328101260,19,14,19,1328107440,6180,41940,1201080,1159140,19_19_19_19
2880,171,1328101380,5,18,5,1328104560,3180,313380,435600,122220,19_19_19_19_19_19_19_19_19_19_1_1_2_3_3_5
2881,173,1328102640,3,3,3,1328108820,6180,111420,3215700,3104280,0_0_0_0_0_0_1_1_0_0_1_1_2_2_3
2882,173,1328102640,2,3,3,1328102640,0,111420,3215700,3104280,0_0_0_0_0_0_1_1_0_0_1_1_2_2
2883,156,1328104080,16,14,16,1328104800,720,705360,2639280,1933920,16_16_16_16_16_16_16_16_16_16_16_1_1_1_16_1_16_16_16_16_16_16_1_1_1_1_16_16_16_16_16_16_16_16_16_16_16_16_16_16_16_16_16_16_16_16
2884,171,1328104560,5,18,2,1328105100,540,316560,435600,119040,19_19_19_19_19_19_19_19_19_19_1_1_2_3_3_5_5
2885,107,1328104800,28,26,28,1328108400,3600,178200,4991760,4813560,8_8_8_8_28_28
2886,156,1328104800,16,20,16,1328132220,27420,706080,2639280,1933200,16_16_16_16_16_16_16_16_16_16_16_1_1_1_16_1_16_16_16_16_16_16_1_1_1_1_16_16_16_16_16_16_16_16_16_16_16_16_16_16_16_16_16_16_16_16_16
2887,162,1328104920,16,20,16,1328107380,2460,16380,4836120,4819740,0_0_16
2888,162,1328104920,0,1,16,1328104920,0,16380,4836120,4819740,0_0
2889,141,1328105040,3,4,3,1328108820,3780,2451840,7406100,4954260,1_1_16_16_16_16_16_1_16_16_1_1_1_16_16_16_16_16_16_16_16_16_16_16_16_16_16_16_1_1_1_1_1_1_1_1_1_1_1_1_16_2_2_16_3_3_3_3
2890,203,1328105040,7,12,7,1328105160,120,109740,1897500,1787760,7_7_7_7
2891,171,1328105100,2,3,5,1328158140,53040,317100,435600,118500,19_19_19_19_19_19_19_19_19_19_1_1_2_3_3_5_5_2
2892,203,1328105160,7,8,7,1328132520,27360,109860,1897500,1787640,7_7_7_7_7
2893,130,1328105220,17,8,17,1328132460,27240,1381560,3083940,1702380,26_26_26_26_26_26_8_8_26_26_26_26_26_26_26_26_26_26_26_8_26_8_17_17_1_1_17_1_17_17_1_17_17_17_17_17_17
2894,132,1328105280,5,9,5,1328167740,62460,1367520,1658640,291120,19_19_19_19_19_19_19_19_19_19_19_19_19_19_1_1_1_1_2_2_3_1_1_3_5_5
2895,158,1328105400,13,17,13,1328109960,4560,284880,2044680,1759800,17_17_17_17_17_17_17_17_17_1_17_1_2_2_3_3_3_13_13_3_13_13_13
2896,161,1328107140,10,16,10,1328111820,4680,197520,1955580,1758060,10_24_24_10_10_10_10_10_10_10_10_10_10
2897,161,1328107140,10,16,10,1328107140,0,197520,1955580,1758060,10_24_24_10_10_10_10_10_10_10_10_10
2898,162,1328107380,16,20,0,1328118360,10980,18840,4836120,4817280,0_0_16_16
2899,114,1328107440,19,20,19,1328118840,11400,48120,1201080,1152960,19_19_19_19_19
2900,107,1328108400,28,27,28,1328122800,14400,181800,4991760,4809960,8_8_8_8_28_28_28
2901,141,1328108820,3,3,3,1328109540,720,2455620,7406100,4950480,1_1_16_16_16_16_16_1_16_16_1_1_1_16_16_16_16_16_16_16_16_16_16_16_16_16_16_16_1_1_1_1_1_1_1_1_1_1_1_1_16_2_2_16_3_3_3_3_3
2902,173,1328108820,3,3,14,1328113080,4260,117600,3215700,3098100,0_0_0_0_0_0_1_1_0_0_1_1_2_2_3_3
2903,141,1328109540,3,4,18,1328209740,100200,2456340,7406100,4949760,1_1_16_16_16_16_16_1_16_16_1_1_1_16_16_16_16_16_16_16_16_16_16_16_16_16_16_16_1_1_1_1_1_1_1_1_1_1_1_1_16_2_2_16_3_3_3_3_3_3
2904,158,1328109960,13,17,13,1328110020,60,289440,2044680,1755240,17_17_17_17_17_17_17_17_17_1_17_1_2_2_3_3_3_13_13_3_13_13_13_13
2905,142,1328109960,2,4,2,1328111940,1980,2351520,7299960,4948440,0_0_0_0_0_0_0_1_1_0_0_0_0_0_0_0_0_1_1_0_0_0_0_0_0_1_1_0_0_0_0_0_0_1_1_0_0_0_0_0_0_0_1_0_1_0_0_0_1_1_1_1_27_27_27_27_1_27_27_1_27_27_27_27_27_27_27_27_27_27_27_27_27_27_27_27_2_2_2_2_2
2906,158,1328110020,13,17,13,1328113080,3060,289500,2044680,1755180,17_17_17_17_17_17_17_17_17_1_17_1_2_2_3_3_3_13_13_3_13_13_13_13_13
2907,161,1328111820,10,16,10,1328123940,12120,202200,1955580,1753380,10_24_24_10_10_10_10_10_10_10_10_10_10_10
2908,142,1328111940,2,4,3,1328133600,21660,2353500,7299960,4946460,0_0_0_0_0_0_0_1_1_0_0_0_0_0_0_0_0_1_1_0_0_0_0_0_0_1_1_0_0_0_0_0_0_1_1_0_0_0_0_0_0_0_1_0_1_0_0_0_1_1_1_1_27_27_27_27_1_27_27_1_27_27_27_27_27_27_27_27_27_27_27_27_27_27_27_27_2_2_2_2_2_2
2909,67,1328111940,4,5,4,1328120640,8700,2612640,3120480,507840,2_3_3_3_2_3_3_3_1_1_27_27_4_4_4_4
2910,158,1328113080,13,17,5,1328189400,76320,292560,2044680,1752120,17_17_17_17_17_17_17_17_17_1_17_1_2_2_3_3_3_13_13_3_13_13_13_13_13_13
2911,173,1328113080,14,17,14,1328132040,18960,121860,3215700,3093840,0_0_0_0_0_0_1_1_0_0_1_1_2_2_3_3_14
2912,162,1328118360,0,0,0,1328123880,5520,29820,4836120,4806300,0_0_16_16_0
2913,114,1328118840,19,20,19,1328118960,120,59520,1201080,1141560,19_19_19_19_19_19
2914,114,1328118960,19,11,19,1328158020,39060,59640,1201080,1141440,19_19_19_19_19_19_19
2915,67,1328120640,4,22,4,1328158020,37380,2621340,3120480,499140,2_3_3_3_2_3_3_3_1_1_27_27_4_4_4_4_4
2916,151,1328122200,19,11,19,1328132340,10140,0,3643800,3643800,19
2917,107,1328122800,28,27,28,1328166000,43200,196200,4991760,4795560,8_8_8_8_28_28_28_28
2918,162,1328123880,0,0,0,1328129760,5880,35340,4836120,4800780,0_0_16_16_0_0_0
2919,162,1328123880,0,0,0,1328123880,0,35340,4836120,4800780,0_0_16_16_0_0
2920,161,1328123940,10,0,10,1328147280,23340,214320,1955580,1741260,10_24_24_10_10_10_10_10_10_10_10_10_10_10_10
2921,84,1328126880,18,23,18,1328148720,21840,2467980,3714840,1246860,17_17_17_17_17_17_17_17_17_17_17_17_17_17_17_17_1_1_2_2_3_3_18
2922,162,1328129760,0,0,0,1328129820,60,41220,4836120,4794900,0_0_16_16_0_0_0_0
2923,162,1328129820,0,0,0,1328132280,2460,41280,4836120,4794840,0_0_16_16_0_0_0_0_0
2924,173,1328132040,14,17,14,1328160240,28200,140820,3215700,3074880,0_0_0_0_0_0_1_1_0_0_1_1_2_2_3_3_14_14
2925,156,1328132220,16,20,16,1328132340,120,733500,2639280,1905780,16_16_16_16_16_16_16_16_16_16_16_1_1_1_16_1_16_16_16_16_16_16_1_1_1_1_16_16_16_16_16_16_16_16_16_16_16_16_16_16_16_16_16_16_16_16_16_16
2926,162,1328132280,0,0,0,1328132340,60,43740,4836120,4792380,0_0_16_16_0_0_0_0_0_0
2927,162,1328132340,0,0,0,1328157840,25500,43800,4836120,4792320,0_0_16_16_0_0_0_0_0_0_0
2928,156,1328132340,16,11,16,1328157960,25620,733620,2639280,1905660,16_16_16_16_16_16_16_16_16_16_16_1_1_1_16_1_16_16_16_16_16_16_1_1_1_1_16_16_16_16_16_16_16_16_16_16_16_16_16_16_16_16_16_16_16_16_16_16_16
2929,151,1328132340,19,11,19,1328206560,74220,10140,3643800,3633660,19_19
2930,130,1328132460,17,8,17,1328159400,26940,1408800,3083940,1675140,26_26_26_26_26_26_8_8_26_26_26_26_26_26_26_26_26_26_26_8_26_8_17_17_1_1_17_1_17_17_1_17_17_17_17_17_17_17
2931,203,1328132520,7,8,7,1328192520,60000,137220,1897500,1760280,7_7_7_7_7_7
2932,50,1328133600,4,9,9,1328138100,4500,0,35220,35220,9_2_4
2933,50,1328133600,2,9,4,1328133600,0,0,35220,35220,9_2
2934,96,1328133600,9,4,9,1328133600,0,823800,2123400,1299600,10_1_10_10_10_10_1_10_10_10_10_10_1_1_2_2_9_9_9_9_9_9_3_3_5_5_9
2935,50,1328133600,9,9,2,1328133600,0,0,35220,35220,9
2936,108,1328133600,6,7,6,1328137200,3600,1417740,3191940,1774200,1_1_1_17_1_17_17_17_17_17_17_17_1_1_17_17_7_7_17_17_1_1_1_1_17_17_1_1_17_17_41_41_1_1_1_1_25_2_9_9_3_25_2_3_18_18_4_4_4_4_4_4_14_1_1_14_4_4_4_25_4_25_34_34_6
2937,96,1328133600,9,4,9,1328138100,4500,823800,2123400,1299600,10_1_10_10_10_10_1_10_10_10_10_10_1_1_2_2_9_9_9_9_9_9_3_3_5_5_9_9_9
2938,96,1328133600,9,4,9,1328133600,0,823800,2123400,1299600,10_1_10_10_10_10_1_10_10_10_10_10_1_1_2_2_9_9_9_9_9_9_3_3_5_5_9_9
2939,142,1328133600,3,4,3,1328138100,4500,2375160,7299960,4924800,0_0_0_0_0_0_0_1_1_0_0_0_0_0_0_0_0_1_1_0_0_0_0_0_0_1_1_0_0_0_0_0_0_1_1_0_0_0_0_0_0_0_1_0_1_0_0_0_1_1_1_1_27_27_27_27_1_27_27_1_27_27_27_27_27_27_27_27_27_27_27_27_27_27_27_27_2_2_2_2_2_2_3
2940,108,1328137200,6,7,5,1328158800,21600,1421340,3191940,1770600,1_1_1_17_1_17_17_17_17_17_17_17_1_1_17_17_7_7_17_17_1_1_1_1_17_17_1_1_17_17_41_41_1_1_1_1_25_2_9_9_3_25_2_3_18_18_4_4_4_4_4_4_14_1_1_14_4_4_4_25_4_25_34_34_6_6
2941,96,1328138100,9,4,5,1328160600,22500,828300,2123400,1295100,10_1_10_10_10_10_1_10_10_10_10_10_1_1_2_2_9_9_9_9_9_9_3_3_5_5_9_9_9_9_9_9
2942,50,1328138100,9,9,4,1328138100,0,4500,35220,30720,9_2_4_9
2943,96,1328138100,9,4,9,1328138100,0,828300,2123400,1295100,10_1_10_10_10_10_1_10_10_10_10_10_1_1_2_2_9_9_9_9_9_9_3_3_5_5_9_9_9_9_9
2944,96,1328138100,9,4,9,1328138100,0,828300,2123400,1295100,10_1_10_10_10_10_1_10_10_10_10_10_1_1_2_2_9_9_9_9_9_9_3_3_5_5_9_9_9_9
2945,50,1328138100,4,9,2,1328138100,0,4500,35220,30720,9_2_4_9_4
2946,50,1328138100,2,9,5,1328168760,30660,4500,35220,30720,9_2_4_9_4_2
2947,142,1328138100,3,4,3,1328163780,25680,2379660,7299960,4920300,0_0_0_0_0_0_0_1_1_0_0_0_0_0_0_0_0_1_1_0_0_0_0_0_0_1_1_0_0_0_0_0_0_1_1_0_0_0_0_0_0_0_1_0_1_0_0_0_1_1_1_1_27_27_27_27_1_27_27_1_27_27_27_27_27_27_27_27_27_27_27_27_27_27_27_27_2_2_2_2_2_2_3_3
2948,161,1328147280,10,0,9,1328248800,101520,237660,1955580,1717920,10_24_24_10_10_10_10_10_10_10_10_10_10_10_10_10
2949,84,1328148720,18,23,18,1328148780,60,2489820,3714840,1225020,17_17_17_17_17_17_17_17_17_17_17_17_17_17_17_17_1_1_2_2_3_3_18_18
2950,84,1328148780,18,23,18,1328158800,10020,2489880,3714840,1224960,17_17_17_17_17_17_17_17_17_17_17_17_17_17_17_17_1_1_2_2_3_3_18_18_18
2951,162,1328157840,0,0,16,1328162880,5040,69300,4836120,4766820,0_0_16_16_0_0_0_0_0_0_0_0
2952,156,1328157960,16,11,16,1328158740,780,759240,2639280,1880040,16_16_16_16_16_16_16_16_16_16_16_1_1_1_16_1_16_16_16_16_16_16_1_1_1_1_16_16_16_16_16_16_16_16_16_16_16_16_16_16_16_16_16_16_16_16_16_16_16_16
2953,114,1328158020,19,11,19,1328158800,780,98700,1201080,1102380,19_19_19_19_19_19_19_19
2954,67,1328158020,4,22,4,1328158920,900,2658720,3120480,461760,2_3_3_3_2_3_3_3_1_1_27_27_4_4_4_4_4_4
2955,171,1328158140,5,18,5,1328158860,720,370140,435600,65460,19_19_19_19_19_19_19_19_19_19_1_1_2_3_3_5_5_2_5
2956,135,1328158260,1,9,1,1328158320,60,2083860,5649480,3565620,19_19_19_19_19_19_19_19_19_19_19_19_1_19_1_19_19_19_1_1_1_1_19_19_19_19_19_19_1_1_1_1_19_19_19_19_19_19_19_19_19_19_19_19_1_19_1_19_19_19_19_19_19_1_19_1_1
2957,135,1328158320,1,9,2,1328513940,355620,2083920,5649480,3565560,19_19_19_19_19_19_19_19_19_19_19_19_1_19_1_19_19_19_1_1_1_1_19_19_19_19_19_19_1_1_1_1_19_19_19_19_19_19_19_19_19_19_19_19_1_19_1_19_19_19_19_19_19_1_19_1_1_1
2958,156,1328158740,16,14,16,1328190300,31560,760020,2639280,1879260,16_16_16_16_16_16_16_16_16_16_16_1_1_1_16_1_16_16_16_16_16_16_1_1_1_1_16_16_16_16_16_16_16_16_16_16_16_16_16_16_16_16_16_16_16_16_16_16_16_16_16
2959,114,1328158800,19,14,19,1328190360,31560,99480,1201080,1101600,19_19_19_19_19_19_19_19_19
2960,108,1328158800,5,2,5,1328161800,3000,1442940,3191940,1749000,1_1_1_17_1_17_17_17_17_17_17_17_1_1_17_17_7_7_17_17_1_1_1_1_17_17_1_1_17_17_41_41_1_1_1_1_25_2_9_9_3_25_2_3_18_18_4_4_4_4_4_4_14_1_1_14_4_4_4_25_4_25_34_34_6_6_5
2961,84,1328158800,18,23,18,1328158860,60,2499900,3714840,1214940,17_17_17_17_17_17_17_17_17_17_17_17_17_17_17_17_1_1_2_2_3_3_18_18_18_18
2962,84,1328158860,18,5,18,1328177520,18660,2499960,3714840,1214880,17_17_17_17_17_17_17_17_17_17_17_17_17_17_17_17_1_1_2_2_3_3_18_18_18_18_18
2963,171,1328158860,5,18,6,1328220000,61140,370860,435600,64740,19_19_19_19_19_19_19_19_19_19_1_1_2_3_3_5_5_2_5_5
2964,67,1328158920,4,5,5,1328167140,8220,2659620,3120480,460860,2_3_3_3_2_3_3_3_1_1_27_27_4_4_4_4_4_4_4
2965,130,1328159400,17,10,1,1328175420,16020,1435740,3083940,1648200,26_26_26_26_26_26_8_8_26_26_26_26_26_26_26_26_26_26_26_8_26_8_17_17_1_1_17_1_17_17_1_17_17_17_17_17_17_17_17
2966,173,1328160240,14,15,14,1328185980,25740,169020,3215700,3046680,0_0_0_0_0_0_1_1_0_0_1_1_2_2_3_3_14_14_14
2967,96,1328160600,5,18,5,1328167800,7200,850800,2123400,1272600,10_1_10_10_10_10_1_10_10_10_10_10_1_1_2_2_9_9_9_9_9_9_3_3_5_5_9_9_9_9_9_9_5
2968,108,1328161800,5,2,5,1328164800,3000,1445940,3191940,1746000,1_1_1_17_1_17_17_17_17_17_17_17_1_1_17_17_7_7_17_17_1_1_1_1_17_17_1_1_17_17_41_41_1_1_1_1_25_2_9_9_3_25_2_3_18_18_4_4_4_4_4_4_14_1_1_14_4_4_4_25_4_25_34_34_6_6_5_5
2969,162,1328162880,16,16,0,1328162940,60,74340,4836120,4761780,0_0_16_16_0_0_0_0_0_0_0_0_16
2970,162,1328162940,0,16,0,1328166780,3840,74400,4836120,4761720,0_0_16_16_0_0_0_0_0_0_0_0_16_0
2971,142,1328163780,3,3,2,1328188920,25140,2405340,7299960,4894620,0_0_0_0_0_0_0_1_1_0_0_0_0_0_0_0_0_1_1_0_0_0_0_0_0_1_1_0_0_0_0_0_0_1_1_0_0_0_0_0_0_0_1_0_1_0_0_0_1_1_1_1_27_27_27_27_1_27_27_1_27_27_27_27_27_27_27_27_27_27_27_27_27_27_27_27_2_2_2_2_2_2_3_3_3
2972,108,1328164800,5,2,5,1328164800,0,1448940,3191940,1743000,1_1_1_17_1_17_17_17_17_17_17_17_1_1_17_17_7_7_17_17_1_1_1_1_17_17_1_1_17_17_41_41_1_1_1_1_25_2_9_9_3_25_2_3_18_18_4_4_4_4_4_4_14_1_1_14_4_4_4_25_4_25_34_34_6_6_5_5_5
2973,108,1328164800,5,2,5,1328166000,1200,1448940,3191940,1743000,1_1_1_17_1_17_17_17_17_17_17_17_1_1_17_17_7_7_17_17_1_1_1_1_17_17_1_1_17_17_41_41_1_1_1_1_25_2_9_9_3_25_2_3_18_18_4_4_4_4_4_4_14_1_1_14_4_4_4_25_4_25_34_34_6_6_5_5_5_5
2974,108,1328166000,5,2,5,1328166000,0,1450140,3191940,1741800,1_1_1_17_1_17_17_17_17_17_17_17_1_1_17_17_7_7_17_17_1_1_1_1_17_17_1_1_17_17_41_41_1_1_1_1_25_2_9_9_3_25_2_3_18_18_4_4_4_4_4_4_14_1_1_14_4_4_4_25_4_25_34_34_6_6_5_5_5_5_5
2975,108,1328166000,5,2,5,1328169600,3600,1450140,3191940,1741800,1_1_1_17_1_17_17_17_17_17_17_17_1_1_17_17_7_7_17_17_1_1_1_1_17_17_1_1_17_17_41_41_1_1_1_1_25_2_9_9_3_25_2_3_18_18_4_4_4_4_4_4_14_1_1_14_4_4_4_25_4_25_34_34_6_6_5_5_5_5_5_5
2976,107,1328166000,28,26,28,1328194800,28800,239400,4991760,4752360,8_8_8_8_28_28_28_28_28
2977,162,1328166780,0,16,16,1328167380,600,78240,4836120,4757880,0_0_16_16_0_0_0_0_0_0_0_0_16_0_0
2978,201,1328166960,10,16,10,1328170800,3840,0,1645440,1645440,10
2979,67,1328167140,5,9,5,1328167380,240,2667840,3120480,452640,2_3_3_3_2_3_3_3_1_1_27_27_4_4_4_4_4_4_4_5
2980,162,1328167380,16,16,0,1328167380,0,78840,4836120,4757280,0_0_16_16_0_0_0_0_0_0_0_0_16_0_0_16
2981,162,1328167380,0,1,0,1328191680,24300,78840,4836120,4757280,0_0_16_16_0_0_0_0_0_0_0_0_16_0_0_16_0
2982,67,1328167380,5,9,4,1328169420,2040,2668080,3120480,452400,2_3_3_3_2_3_3_3_1_1_27_27_4_4_4_4_4_4_4_5_5
2983,132,1328167740,5,9,5,1328168160,420,1429980,1658640,228660,19_19_19_19_19_19_19_19_19_19_19_19_19_19_1_1_1_1_2_2_3_1_1_3_5_5_5
2984,96,1328167800,5,18,6,1328392800,225000,858000,2123400,1265400,10_1_10_10_10_10_1_10_10_10_10_10_1_1_2_2_9_9_9_9_9_9_3_3_5_5_9_9_9_9_9_9_5_5
2985,92,1328167800,5,18,5,1328175360,7560,256260,613860,357600,42_42_42_42_42_42_42_42_5
2986,132,1328168160,5,9,5,1328172240,4080,1430400,1658640,228240,19_19_19_19_19_19_19_19_19_19_19_19_19_19_1_1_1_1_2_2_3_1_1_3_5_5_5_5
2987,50,1328168760,5,9,5,1328168820,60,35160,35220,60,9_2_4_9_4_2_5
2988,50,1328168820,5,9,99,1328168820,0,35220,35220,0,9_2_4_9_4_2_5_5
2989,67,1328169420,4,5,4,1328171760,2340,2670120,3120480,450360,2_3_3_3_2_3_3_3_1_1_27_27_4_4_4_4_4_4_4_5_5_4
2990,108,1328169600,5,2,5,1328179800,10200,1453740,3191940,1738200,1_1_1_17_1_17_17_17_17_17_17_17_1_1_17_17_7_7_17_17_1_1_1_1_17_17_1_1_17_17_41_41_1_1_1_1_25_2_9_9_3_25_2_3_18_18_4_4_4_4_4_4_14_1_1_14_4_4_4_25_4_25_34_34_6_6_5_5_5_5_5_5_5
2991,82,1328170680,5,9,5,1328177820,7140,2142960,2195880,52920,1_1_2_2_3_3_14_14_14_14_5_5_5_5_6_6_13_13_13_13_13_13_5
2992,201,1328170800,10,16,10,1328175660,4860,3840,1645440,1641600,10_10
2993,67,1328171760,4,5,2,1328171880,120,2672460,3120480,448020,2_3_3_3_2_3_3_3_1_1_27_27_4_4_4_4_4_4_4_5_5_4_4
2994,67,1328171880,2,3,2,1328172000,120,2672580,3120480,447900,2_3_3_3_2_3_3_3_1_1_27_27_4_4_4_4_4_4_4_5_5_4_4_2
2995,67,1328172000,2,3,3,1328182140,10140,2672700,3120480,447780,2_3_3_3_2_3_3_3_1_1_27_27_4_4_4_4_4_4_4_5_5_4_4_2_2
2996,132,1328172240,5,9,5,1328172660,420,1434480,1658640,224160,19_19_19_19_19_19_19_19_19_19_19_19_19_19_1_1_1_1_2_2_3_1_1_3_5_5_5_5_5
2997,132,1328172660,5,9,6,1328392800,220140,1434900,1658640,223740,19_19_19_19_19_19_19_19_19_19_19_19_19_19_1_1_1_1_2_2_3_1_1_3_5_5_5_5_5_5
2998,92,1328175360,5,18,6,1328479200,303840,263820,613860,350040,42_42_42_42_42_42_42_42_5_5
2999,130,1328175420,1,18,17,1328182020,6600,1451760,3083940,1632180,26_26_26_26_26_26_8_8_26_26_26_26_26_26_26_26_26_26_26_8_26_8_17_17_1_1_17_1_17_17_1_17_17_17_17_17_17_17_17_1
3000,201,1328175660,10,16,10,1328191200,15540,8700,1645440,1636740,10_10_10
3001,84,1328177520,18,5,5,1328685240,507720,2518620,3714840,1196220,17_17_17_17_17_17_17_17_17_17_17_17_17_17_17_17_1_1_2_2_3_3_18_18_18_18_18_18
3002,82,1328177820,5,9,5,1328182080,4260,2150100,2195880,45780,1_1_2_2_3_3_14_14_14_14_5_5_5_5_6_6_13_13_13_13_13_13_5_5
3003,1,1328179080,5,9,5,1328184960,5880,1402620,1447140,44520,7_8_7_8_7_7_7_7_7_7_7_7_7_7_7_7_7_7_7_7_7_7_7_7_7_7_7_7_7_7_8_8_2_2_2_2_2_2_9_9_9_9_9_9_5
3004,108,1328179800,5,2,5,1328181600,1800,1463940,3191940,1728000,1_1_1_17_1_17_17_17_17_17_17_17_1_1_17_17_7_7_17_17_1_1_1_1_17_17_1_1_17_17_41_41_1_1_1_1_25_2_9_9_3_25_2_3_18_18_4_4_4_4_4_4_14_1_1_14_4_4_4_25_4_25_34_34_6_6_5_5_5_5_5_5_5_5
3005,108,1328181600,5,2,5,1328198400,16800,1465740,3191940,1726200,1_1_1_17_1_17_17_17_17_17_17_17_1_1_17_17_7_7_17_17_1_1_1_1_17_17_1_1_17_17_41_41_1_1_1_1_25_2_9_9_3_25_2_3_18_18_4_4_4_4_4_4_14_1_1_14_4_4_4_25_4_25_34_34_6_6_5_5_5_5_5_5_5_5_5
3006,130,1328182020,17,10,1,1328187840,5820,1458360,3083940,1625580,26_26_26_26_26_26_8_8_26_26_26_26_26_26_26_26_26_26_26_8_26_8_17_17_1_1_17_1_17_17_1_17_17_17_17_17_17_17_17_1_17_17
3007,130,1328182020,17,10,17,1328182020,0,1458360,3083940,1625580,26_26_26_26_26_26_8_8_26_26_26_26_26_26_26_26_26_26_26_8_26_8_17_17_1_1_17_1_17_17_1_17_17_17_17_17_17_17_17_1_17
3008,82,1328182080,5,9,5,1328186580,4500,2154360,2195880,41520,1_1_2_2_3_3_14_14_14_14_5_5_5_5_6_6_13_13_13_13_13_13_5_5_5
3009,67,1328182140,3,3,3,1328182200,60,2682840,3120480,437640,2_3_3_3_2_3_3_3_1_1_27_27_4_4_4_4_4_4_4_5_5_4_4_2_2_3
3010,67,1328182200,3,3,4,1328182260,60,2682900,3120480,437580,2_3_3_3_2_3_3_3_1_1_27_27_4_4_4_4_4_4_4_5_5_4_4_2_2_3_3
3011,67,1328182260,4,5,4,1328182320,60,2682960,3120480,437520,2_3_3_3_2_3_3_3_1_1_27_27_4_4_4_4_4_4_4_5_5_4_4_2_2_3_3_4
3012,67,1328182320,4,5,4,1328183700,1380,2683020,3120480,437460,2_3_3_3_2_3_3_3_1_1_27_27_4_4_4_4_4_4_4_5_5_4_4_2_2_3_3_4_4
3013,67,1328183700,4,5,4,1328205480,21780,2684400,3120480,436080,2_3_3_3_2_3_3_3_1_1_27_27_4_4_4_4_4_4_4_5_5_4_4_2_2_3_3_4_4_4
3014,1,1328184960,5,9,6,1328220000,35040,1408500,1447140,38640,7_8_7_8_7_7_7_7_7_7_7_7_7_7_7_7_7_7_7_7_7_7_7_7_7_7_7_7_7_7_8_8_2_2_2_2_2_2_9_9_9_9_9_9_5_5
3015,173,1328185980,14,15,14,1328202120,16140,194760,3215700,3020940,0_0_0_0_0_0_1_1_0_0_1_1_2_2_3_3_14_14_14_14
3016,82,1328186580,5,9,6,1328220000,33420,2158860,2195880,37020,1_1_2_2_3_3_14_14_14_14_5_5_5_5_6_6_13_13_13_13_13_13_5_5_5_5
3017,130,1328187840,1,18,17,1328197140,9300,1464180,3083940,1619760,26_26_26_26_26_26_8_8_26_26_26_26_26_26_26_26_26_26_26_8_26_8_17_17_1_1_17_1_17_17_1_17_17_17_17_17_17_17_17_1_17_17_1
3018,142,1328188920,2,4,2,1328190780,1860,2430480,7299960,4869480,0_0_0_0_0_0_0_1_1_0_0_0_0_0_0_0_0_1_1_0_0_0_0_0_0_1_1_0_0_0_0_0_0_1_1_0_0_0_0_0_0_0_1_0_1_0_0_0_1_1_1_1_27_27_27_27_1_27_27_1_27_27_27_27_27_27_27_27_27_27_27_27_27_27_27_27_2_2_2_2_2_2_3_3_3_2
3019,158,1328189400,5,18,5,1328191440,2040,368880,2044680,1675800,17_17_17_17_17_17_17_17_17_1_17_1_2_2_3_3_3_13_13_3_13_13_13_13_13_13_5
3020,156,1328190300,16,14,1,1328418000,227700,791580,2639280,1847700,16_16_16_16_16_16_16_16_16_16_16_1_1_1_16_1_16_16_16_16_16_16_1_1_1_1_16_16_16_16_16_16_16_16_16_16_16_16_16_16_16_16_16_16_16_16_16_16_16_16_16_16
3021,114,1328190360,19,14,19,1328191800,1440,131040,1201080,1070040,19_19_19_19_19_19_19_19_19_19
3022,142,1328190780,2,4,3,1328194920,4140,2432340,7299960,4867620,0_0_0_0_0_0_0_1_1_0_0_0_0_0_0_0_0_1_1_0_0_0_0_0_0_1_1_0_0_0_0_0_0_1_1_0_0_0_0_0_0_0_1_0_1_0_0_0_1_1_1_1_27_27_27_27_1_27_27_1_27_27_27_27_27_27_27_27_27_27_27_27_27_27_27_27_2_2_2_2_2_2_3_3_3_2_2
3023,201,1328191200,10,16,10,1328191980,780,24240,1645440,1621200,10_10_10_10
3024,158,1328191440,5,18,6,1328392800,201360,370920,2044680,1673760,17_17_17_17_17_17_17_17_17_1_17_1_2_2_3_3_3_13_13_3_13_13_13_13_13_13_5_5
3025,162,1328191680,0,1,16,1328192040,360,103140,4836120,4732980,0_0_16_16_0_0_0_0_0_0_0_0_16_0_0_16_0_0
3026,114,1328191800,19,20,19,1328204700,12900,132480,1201080,1068600,19_19_19_19_19_19_19_19_19_19_19
3027,201,1328191980,10,13,10,1328204280,12300,25020,1645440,1620420,10_10_10_10_10
3028,162,1328192040,16,20,16,1328204640,12600,103500,4836120,4732620,0_0_16_16_0_0_0_0_0_0_0_0_16_0_0_16_0_0_16
3029,203,1328192520,7,8,7,1328218800,26280,197220,1897500,1700280,7_7_7_7_7_7_7
3030,107,1328194800,28,26,8,1328504400,309600,268200,4991760,4723560,8_8_8_8_28_28_28_28_28_28
3031,142,1328194920,3,3,3,1328220000,25080,2436480,7299960,4863480,0_0_0_0_0_0_0_1_1_0_0_0_0_0_0_0_0_1_1_0_0_0_0_0_0_1_1_0_0_0_0_0_0_1_1_0_0_0_0_0_0_0_1_0_1_0_0_0_1_1_1_1_27_27_27_27_1_27_27_1_27_27_27_27_27_27_27_27_27_27_27_27_27_27_27_27_2_2_2_2_2_2_3_3_3_2_2_3
3032,130,1328197140,17,10,17,1328245380,48240,1473480,3083940,1610460,26_26_26_26_26_26_8_8_26_26_26_26_26_26_26_26_26_26_26_8_26_8_17_17_1_1_17_1_17_17_1_17_17_17_17_17_17_17_17_1_17_17_1_17
3033,108,1328198400,5,2,5,1329901200,1702800,1482540,3191940,1709400,1_1_1_17_1_17_17_17_17_17_17_17_1_1_17_17_7_7_17_17_1_1_1_1_17_17_1_1_17_17_41_41_1_1_1_1_25_2_9_9_3_25_2_3_18_18_4_4_4_4_4_4_14_1_1_14_4_4_4_25_4_25_34_34_6_6_5_5_5_5_5_5_5_5_5_5
3034,173,1328202120,14,17,14,1328219580,17460,210900,3215700,3004800,0_0_0_0_0_0_1_1_0_0_1_1_2_2_3_3_14_14_14_14_14
3035,201,1328204280,10,13,10,1328209200,4920,37320,1645440,1608120,10_10_10_10_10_10
3036,162,1328204640,16,20,0,1328204820,180,116100,4836120,4720020,0_0_16_16_0_0_0_0_0_0_0_0_16_0_0_16_0_0_16_16
3037,114,1328204700,19,20,9,1328479200,274500,145380,1201080,1055700,19_19_19_19_19_19_19_19_19_19_19_19
3038,192,1328204760,16,20,16,1328212500,7740,0,4648740,4648740,16
3039,162,1328204820,0,0,0,1328220360,15540,116280,4836120,4719840,0_0_16_16_0_0_0_0_0_0_0_0_16_0_0_16_0_0_16_16_0
3040,67,1328205480,4,22,4,1328223300,17820,2706180,3120480,414300,2_3_3_3_2_3_3_3_1_1_27_27_4_4_4_4_4_4_4_5_5_4_4_2_2_3_3_4_4_4_4
3041,151,1328206560,19,11,19,1328244300,37740,84360,3643800,3559440,19_19_19
3042,201,1328209200,10,13,10,1328220000,10800,42240,1645440,1603200,10_10_10_10_10_10_10
3043,141,1328209740,18,23,18,1328218500,8760,2556540,7406100,4849560,1_1_16_16_16_16_16_1_16_16_1_1_1_16_16_16_16_16_16_16_16_16_16_16_16_16_16_16_1_1_1_1_1_1_1_1_1_1_1_1_16_2_2_16_3_3_3_3_3_3_18
3044,192,1328212500,16,20,16,1328215980,3480,7740,4648740,4641000,16_16
3045,192,1328215980,16,20,16,1328218740,2760,11220,4648740,4637520,16_16_16
3046,141,1328218500,18,23,18,1328218560,60,2565300,7406100,4840800,1_1_16_16_16_16_16_1_16_16_1_1_1_16_16_16_16_16_16_16_16_16_16_16_16_16_16_16_1_1_1_1_1_1_1_1_1_1_1_1_16_2_2_16_3_3_3_3_3_3_18_18
3047,141,1328218560,18,23,18,1328244960,26400,2565360,7406100,4840740,1_1_16_16_16_16_16_1_16_16_1_1_1_16_16_16_16_16_16_16_16_16_16_16_16_16_16_16_1_1_1_1_1_1_1_1_1_1_1_1_16_2_2_16_3_3_3_3_3_3_18_18_18
3048,192,1328218740,16,20,16,1328219160,420,13980,4648740,4634760,16_16_16_16
3049,203,1328218800,7,8,7,1328400780,181980,223500,1897500,1674000,7_7_7_7_7_7_7_7
3050,192,1328219160,16,0,0,1328223600,4440,14400,4648740,4634340,16_16_16_16_16
3051,173,1328219580,14,17,14,1328244420,24840,228360,3215700,2987340,0_0_0_0_0_0_1_1_0_0_1_1_2_2_3_3_14_14_14_14_14_14
3052,201,1328220000,10,13,10,1328245200,25200,53040,1645440,1592400,10_10_10_10_10_10_10_10
3053,1,1328220000,6,7,6,1328223600,3600,1443540,1447140,3600,7_8_7_8_7_7_7_7_7_7_7_7_7_7_7_7_7_7_7_7_7_7_7_7_7_7_7_7_7_7_8_8_2_2_2_2_2_2_9_9_9_9_9_9_5_5_6
3054,171,1328220000,6,7,6,1328223600,3600,432000,435600,3600,19_19_19_19_19_19_19_19_19_19_1_1_2_3_3_5_5_2_5_5_6
3055,82,1328220000,6,7,6,1328223600,3600,2192280,2195880,3600,1_1_2_2_3_3_14_14_14_14_5_5_5_5_6_6_13_13_13_13_13_13_5_5_5_5_6
3056,142,1328220000,3,4,3,1328224500,4500,2461560,7299960,4838400,0_0_0_0_0_0_0_1_1_0_0_0_0_0_0_0_0_1_1_0_0_0_0_0_0_1_1_0_0_0_0_0_0_1_1_0_0_0_0_0_0_0_1_0_1_0_0_0_1_1_1_1_27_27_27_27_1_27_27_1_27_27_27_27_27_27_27_27_27_27_27_27_27_27_27_27_2_2_2_2_2_2_3_3_3_2_2_3_3
3057,162,1328220360,0,0,1,1328426880,206520,131820,4836120,4704300,0_0_16_16_0_0_0_0_0_0_0_0_16_0_0_16_0_0_16_16_0_0
3058,67,1328223300,4,22,5,1328258160,34860,2724000,3120480,396480,2_3_3_3_2_3_3_3_1_1_27_27_4_4_4_4_4_4_4_5_5_4_4_2_2_3_3_4_4_4_4_4
3059,171,1328223600,6,7,99,1328223600,0,435600,435600,0,19_19_19_19_19_19_19_19_19_19_1_1_2_3_3_5_5_2_5_5_6_6
3060,192,1328223600,0,0,0,1328245200,21600,18840,4648740,4629900,16_16_16_16_16_0
3061,1,1328223600,6,7,99,1328223600,0,1447140,1447140,0,7_8_7_8_7_7_7_7_7_7_7_7_7_7_7_7_7_7_7_7_7_7_7_7_7_7_7_7_7_7_8_8_2_2_2_2_2_2_9_9_9_9_9_9_5_5_6_6
3062,82,1328223600,6,7,99,1328223600,0,2195880,2195880,0,1_1_2_2_3_3_14_14_14_14_5_5_5_5_6_6_13_13_13_13_13_13_5_5_5_5_6_6
3063,142,1328224500,3,4,2,1328245260,20760,2466060,7299960,4833900,0_0_0_0_0_0_0_1_1_0_0_0_0_0_0_0_0_1_1_0_0_0_0_0_0_1_1_0_0_0_0_0_0_1_1_0_0_0_0_0_0_0_1_0_1_0_0_0_1_1_1_1_27_27_27_27_1_27_27_1_27_27_27_27_27_27_27_27_27_27_27_27_27_27_27_27_2_2_2_2_2_2_3_3_3_2_2_3_3_3
3064,151,1328244300,19,11,19,1328246580,2280,122100,3643800,3521700,19_19_19_19
3065,173,1328244420,14,15,18,1328255460,11040,253200,3215700,2962500,0_0_0_0_0_0_1_1_0_0_1_1_2_2_3_3_14_14_14_14_14_14_14
3066,141,1328244960,18,23,18,1328245440,480,2591760,7406100,4814340,1_1_16_16_16_16_16_1_16_16_1_1_1_16_16_16_16_16_16_16_16_16_16_16_16_16_16_16_1_1_1_1_1_1_1_1_1_1_1_1_16_2_2_16_3_3_3_3_3_3_18_18_18_18
3067,192,1328245200,0,0,16,1328245320,120,40440,4648740,4608300,16_16_16_16_16_0_0
3068,201,1328245200,10,16,10,1328257800,12600,78240,1645440,1567200,10_10_10_10_10_10_10_10_10
3069,72,1328245200,5,18,5,1328263200,18000,2061960,2385960,324000,17_17_17_1_17_1_17_1_1_17_17_17_17_1_1_17_17_17_38_38_17_17_1_24_24_24_24_1_24_1_1_24_24_24_24_24_8_8_2_2_3_3_3_5_3_5_5_5_5_5_5_5_34_34_5_5_5
3070,142,1328245260,2,4,2,1328247600,2340,2486820,7299960,4813140,0_0_0_0_0_0_0_1_1_0_0_0_0_0_0_0_0_1_1_0_0_0_0_0_0_1_1_0_0_0_0_0_0_1_1_0_0_0_0_0_0_0_1_0_1_0_0_0_1_1_1_1_27_27_27_27_1_27_27_1_27_27_27_27_27_27_27_27_27_27_27_27_27_27_27_27_2_2_2_2_2_2_3_3_3_2_2_3_3_3_2
3071,192,1328245320,16,0,16,1328246160,840,40560,4648740,4608180,16_16_16_16_16_0_0_16
3072,130,1328245380,17,10,1,1328263200,17820,1521720,3083940,1562220,26_26_26_26_26_26_8_8_26_26_26_26_26_26_26_26_26_26_26_8_26_8_17_17_1_1_17_1_17_17_1_17_17_17_17_17_17_17_17_1_17_17_1_17_17
3073,141,1328245440,18,19,3,1328254560,9120,2592240,7406100,4813860,1_1_16_16_16_16_16_1_16_16_1_1_1_16_16_16_16_16_16_16_16_16_16_16_16_16_16_16_1_1_1_1_1_1_1_1_1_1_1_1_16_2_2_16_3_3_3_3_3_3_18_18_18_18_18
3074,192,1328246160,16,1,16,1328266200,20040,41400,4648740,4607340,16_16_16_16_16_0_0_16_16
3075,151,1328246580,19,1,1,1328246940,360,124380,3643800,3519420,19_19_19_19_19
3076,151,1328246940,1,9,1,1328252760,5820,124740,3643800,3519060,19_19_19_19_19_1
3077,142,1328247600,2,4,3,1328255280,7680,2489160,7299960,4810800,0_0_0_0_0_0_0_1_1_0_0_0_0_0_0_0_0_1_1_0_0_0_0_0_0_1_1_0_0_0_0_0_0_1_1_0_0_0_0_0_0_0_1_0_1_0_0_0_1_1_1_1_27_27_27_27_1_27_27_1_27_27_27_27_27_27_27_27_27_27_27_27_27_27_27_27_2_2_2_2_2_2_3_3_3_2_2_3_3_3_2_2
3078,161,1328248800,9,3,9,1328256000,7200,339180,1955580,1616400,10_24_24_10_10_10_10_10_10_10_10_10_10_10_10_10_9
3079,151,1328252760,1,9,19,1328266200,13440,130560,3643800,3513240,19_19_19_19_19_1_1
3080,141,1328254560,3,3,18,1328255460,900,2601360,7406100,4804740,1_1_16_16_16_16_16_1_16_16_1_1_1_16_16_16_16_16_16_16_16_16_16_16_16_16_16_16_1_1_1_1_1_1_1_1_1_1_1_1_16_2_2_16_3_3_3_3_3_3_18_18_18_18_18_3
3081,142,1328255280,3,4,3,1328262780,7500,2496840,7299960,4803120,0_0_0_0_0_0_0_1_1_0_0_0_0_0_0_0_0_1_1_0_0_0_0_0_0_1_1_0_0_0_0_0_0_1_1_0_0_0_0_0_0_0_1_0_1_0_0_0_1_1_1_1_27_27_27_27_1_27_27_1_27_27_27_27_27_27_27_27_27_27_27_27_27_27_27_27_2_2_2_2_2_2_3_3_3_2_2_3_3_3_2_2_3
3082,173,1328255460,18,19,14,1328262840,7380,264240,3215700,2951460,0_0_0_0_0_0_1_1_0_0_1_1_2_2_3_3_14_14_14_14_14_14_14_18
3083,141,1328255460,18,19,3,1328266800,11340,2602260,7406100,4803840,1_1_16_16_16_16_16_1_16_16_1_1_1_16_16_16_16_16_16_16_16_16_16_16_16_16_16_16_1_1_1_1_1_1_1_1_1_1_1_1_16_2_2_16_3_3_3_3_3_3_18_18_18_18_18_3_18
3084,161,1328256000,9,3,1,1328506860,250860,346380,1955580,1609200,10_24_24_10_10_10_10_10_10_10_10_10_10_10_10_10_9_9
3085,201,1328257800,10,16,10,1328261400,3600,90840,1645440,1554600,10_10_10_10_10_10_10_10_10_10_10
3086,201,1328257800,10,16,10,1328257800,0,90840,1645440,1554600,10_10_10_10_10_10_10_10_10_10
3087,67,1328258160,5,9,5,1328266440,8280,2758860,3120480,361620,2_3_3_3_2_3_3_3_1_1_27_27_4_4_4_4_4_4_4_5_5_4_4_2_2_3_3_4_4_4_4_4_5
3088,201,1328261400,10,16,1,1328434200,172800,94440,1645440,1551000,10_10_10_10_10_10_10_10_10_10_10_10
3089,142,1328262780,3,4,4,1328425980,163200,2504340,7299960,4795620,0_0_0_0_0_0_0_1_1_0_0_0_0_0_0_0_0_1_1_0_0_0_0_0_0_1_1_0_0_0_0_0_0_1_1_0_0_0_0_0_0_0_1_0_1_0_0_0_1_1_1_1_27_27_27_27_1_27_27_1_27_27_27_27_27_27_27_27_27_27_27_27_27_27_27_27_2_2_2_2_2_2_3_3_3_2_2_3_3_3_2_2_3_3
3090,173,1328262840,14,15,18,1328266500,3660,271620,3215700,2944080,0_0_0_0_0_0_1_1_0_0_1_1_2_2_3_3_14_14_14_14_14_14_14_18_14
3091,72,1328263200,5,18,6,1328479200,216000,2079960,2385960,306000,17_17_17_1_17_1_17_1_1_17_17_17_17_1_1_17_17_17_38_38_17_17_1_24_24_24_24_1_24_1_1_24_24_24_24_24_8_8_2_2_3_3_3_5_3_5_5_5_5_5_5_5_34_34_5_5_5_5
3092,130,1328263200,1,18,17,1328264040,840,1539540,3083940,1544400,26_26_26_26_26_26_8_8_26_26_26_26_26_26_26_26_26_26_26_8_26_8_17_17_1_1_17_1_17_17_1_17_17_17_17_17_17_17_17_1_17_17_1_17_17_1
3093,130,1328264040,17,10,1,1328266200,2160,1540380,3083940,1543560,26_26_26_26_26_26_8_8_26_26_26_26_26_26_26_26_26_26_26_8_26_8_17_17_1_1_17_1_17_17_1_17_17_17_17_17_17_17_17_1_17_17_1_17_17_1_17
3094,192,1328266200,16,1,16,1328266200,0,61440,4648740,4587300,16_16_16_16_16_0_0_16_16_16
3095,192,1328266200,16,0,16,1328293800,27600,61440,4648740,4587300,16_16_16_16_16_0_0_16_16_16_16
3096,151,1328266200,19,1,1,1328418180,151980,144000,3643800,3499800,19_19_19_19_19_1_1_19
3097,130,1328266200,1,18,17,1328395320,129120,1542540,3083940,1541400,26_26_26_26_26_26_8_8_26_26_26_26_26_26_26_26_26_26_26_8_26_8_17_17_1_1_17_1_17_17_1_17_17_17_17_17_17_17_17_1_17_17_1_17_17_1_17_1
3098,67,1328266440,5,9,4,1328388300,121860,2767140,3120480,353340,2_3_3_3_2_3_3_3_1_1_27_27_4_4_4_4_4_4_4_5_5_4_4_2_2_3_3_4_4_4_4_4_5_5
3099,173,1328266500,18,19,18,1328425740,159240,275280,3215700,2940420,0_0_0_0_0_0_1_1_0_0_1_1_2_2_3_3_14_14_14_14_14_14_14_18_14_18
3100,141,1328266800,3,3,3,1328392800,126000,2613600,7406100,4792500,1_1_16_16_16_16_16_1_16_16_1_1_1_16_16_16_16_16_16_16_16_16_16_16_16_16_16_16_1_1_1_1_1_1_1_1_1_1_1_1_16_2_2_16_3_3_3_3_3_3_18_18_18_18_18_3_18_3
3101,192,1328293800,16,0,0,1328390640,96840,89040,4648740,4559700,16_16_16_16_16_0_0_16_16_16_16_16
3102,67,1328388300,4,5,4,1328392800,4500,2889000,3120480,231480,2_3_3_3_2_3_3_3_1_1_27_27_4_4_4_4_4_4_4_5_5_4_4_2_2_3_3_4_4_4_4_4_5_5_4
3103,192,1328390640,0,12,0,1328416680,26040,185880,4648740,4462860,16_16_16_16_16_0_0_16_16_16_16_16_0
3104,132,1328392800,6,7,6,1328396400,3600,1655040,1658640,3600,19_19_19_19_19_19_19_19_19_19_19_19_19_19_1_1_1_1_2_2_3_1_1_3_5_5_5_5_5_5_6
3105,96,1328392800,6,30,6,1328396400,3600,1083000,2123400,1040400,10_1_10_10_10_10_1_10_10_10_10_10_1_1_2_2_9_9_9_9_9_9_3_3_5_5_9_9_9_9_9_9_5_5_6
3106,73,1328392800,9,4,9,1328397300,4500,388800,1303500,914700,1_1_9
3107,158,1328392800,6,7,6,1328396400,3600,572280,2044680,1472400,17_17_17_17_17_17_17_17_17_1_17_1_2_2_3_3_3_13_13_3_13_13_13_13_13_13_5_5_6
3108,23,1328392800,7,25,7,1328397300,4500,854520,1894920,1040400,24_24_24_24_8_8_24_24_24_24_24_24_24_24_24_24_24_24_24_24_8_8_7
3109,141,1328392800,3,4,3,1328397300,4500,2739600,7406100,4666500,1_1_16_16_16_16_16_1_16_16_1_1_1_16_16_16_16_16_16_16_16_16_16_16_16_16_16_16_1_1_1_1_1_1_1_1_1_1_1_1_16_2_2_16_3_3_3_3_3_3_18_18_18_18_18_3_18_3_3
3110,67,1328392800,4,5,4,1328397300,4500,2893500,3120480,226980,2_3_3_3_2_3_3_3_1_1_27_27_4_4_4_4_4_4_4_5_5_4_4_2_2_3_3_4_4_4_4_4_5_5_4_4
3111,130,1328395320,17,12,17,1328417640,22320,1671660,3083940,1412280,26_26_26_26_26_26_8_8_26_26_26_26_26_26_26_26_26_26_26_8_26_8_17_17_1_1_17_1_17_17_1_17_17_17_17_17_17_17_17_1_17_17_1_17_17_1_17_1_17
3112,96,1328396400,6,30,9,1328430660,34260,1086600,2123400,1036800,10_1_10_10_10_10_1_10_10_10_10_10_1_1_2_2_9_9_9_9_9_9_3_3_5_5_9_9_9_9_9_9_5_5_6_6
3113,158,1328396400,6,7,5,1328425200,28800,575880,2044680,1468800,17_17_17_17_17_17_17_17_17_1_17_1_2_2_3_3_3_13_13_3_13_13_13_13_13_13_5_5_6_6
3114,132,1328396400,6,7,99,1328396400,0,1658640,1658640,0,19_19_19_19_19_19_19_19_19_19_19_19_19_19_1_1_1_1_2_2_3_1_1_3_5_5_5_5_5_5_6_6
3115,73,1328397300,9,4,3,1328427660,30360,393300,1303500,910200,1_1_9_9
3116,141,1328397300,3,4,5,1328443200,45900,2744100,7406100,4662000,1_1_16_16_16_16_16_1_16_16_1_1_1_16_16_16_16_16_16_16_16_16_16_16_16_16_16_16_1_1_1_1_1_1_1_1_1_1_1_1_16_2_2_16_3_3_3_3_3_3_18_18_18_18_18_3_18_3_3_3
3117,23,1328397300,7,25,3,1328443200,45900,859020,1894920,1035900,24_24_24_24_8_8_24_24_24_24_24_24_24_24_24_24_24_24_24_24_8_8_7_7
3118,67,1328397300,4,5,4,1328417580,20280,2898000,3120480,222480,2_3_3_3_2_3_3_3_1_1_27_27_4_4_4_4_4_4_4_5_5_4_4_2_2_3_3_4_4_4_4_4_5_5_4_4_4
3119,203,1328400780,7,12,7,1328416680,15900,405480,1897500,1492020,7_7_7_7_7_7_7_7_7
3120,203,1328416680,7,12,7,1328418660,1980,421380,1897500,1476120,7_7_7_7_7_7_7_7_7_7
3121,192,1328416680,0,12,0,1328417460,780,211920,4648740,4436820,16_16_16_16_16_0_0_16_16_16_16_16_0_0
3122,192,1328417460,0,0,1,1328418000,540,212700,4648740,4436040,16_16_16_16_16_0_0_16_16_16_16_16_0_0_0
3123,67,1328417580,4,5,5,1328419680,2100,2918280,3120480,202200,2_3_3_3_2_3_3_3_1_1_27_27_4_4_4_4_4_4_4_5_5_4_4_2_2_3_3_4_4_4_4_4_5_5_4_4_4_4
3124,130,1328417640,17,12,1,1328418000,360,1693980,3083940,1389960,26_26_26_26_26_26_8_8_26_26_26_26_26_26_26_26_26_26_26_8_26_8_17_17_1_1_17_1_17_17_1_17_17_17_17_17_17_17_17_1_17_17_1_17_17_1_17_1_17_17
3125,130,1328418000,1,18,17,1328418540,540,1694340,3083940,1389600,26_26_26_26_26_26_8_8_26_26_26_26_26_26_26_26_26_26_26_8_26_8_17_17_1_1_17_1_17_17_1_17_17_17_17_17_17_17_17_1_17_17_1_17_17_1_17_1_17_17_1
3126,192,1328418000,1,2,1,1328424000,6000,213240,4648740,4435500,16_16_16_16_16_0_0_16_16_16_16_16_0_0_0_1
3127,156,1328418000,1,6,1,1328426820,8820,1019280,2639280,1620000,16_16_16_16_16_16_16_16_16_16_16_1_1_1_16_1_16_16_16_16_16_16_1_1_1_1_16_16_16_16_16_16_16_16_16_16_16_16_16_16_16_16_16_16_16_16_16_16_16_16_16_16_1
3128,151,1328418180,1,9,1,1328418960,780,295980,3643800,3347820,19_19_19_19_19_1_1_19_1
3129,130,1328418540,17,10,1,1328424000,5460,1694880,3083940,1389060,26_26_26_26_26_26_8_8_26_26_26_26_26_26_26_26_26_26_26_8_26_8_17_17_1_1_17_1_17_17_1_17_17_17_17_17_17_17_17_1_17_17_1_17_17_1_17_1_17_17_1_17
3130,203,1328418660,7,10,1,1328425200,6540,423360,1897500,1474140,7_7_7_7_7_7_7_7_7_7_7
3131,151,1328418960,1,9,19,1328800560,381600,296760,3643800,3347040,19_19_19_19_19_1_1_19_1_1
3132,67,1328419680,5,9,5,1328434320,14640,2920380,3120480,200100,2_3_3_3_2_3_3_3_1_1_27_27_4_4_4_4_4_4_4_5_5_4_4_2_2_3_3_4_4_4_4_4_5_5_4_4_4_4_5
3133,192,1328424000,1,2,0,1328449920,25920,219240,4648740,4429500,16_16_16_16_16_0_0_16_16_16_16_16_0_0_0_1_1
3134,130,1328424000,1,18,3,1328433480,9480,1700340,3083940,1383600,26_26_26_26_26_26_8_8_26_26_26_26_26_26_26_26_26_26_26_8_26_8_17_17_1_1_17_1_17_17_1_17_17_17_17_17_17_17_17_1_17_17_1_17_17_1_17_1_17_17_1_17_1
3135,158,1328425200,5,18,5,1328446800,21600,604680,2044680,1440000,17_17_17_17_17_17_17_17_17_1_17_1_2_2_3_3_3_13_13_3_13_13_13_13_13_13_5_5_6_6_5
3136,203,1328425200,1,2,1,1328436000,10800,429900,1897500,1467600,7_7_7_7_7_7_7_7_7_7_7_1
3137,173,1328425740,18,23,14,1328425860,120,434520,3215700,2781180,0_0_0_0_0_0_1_1_0_0_1_1_2_2_3_3_14_14_14_14_14_14_14_18_14_18_18
3138,173,1328425860,14,17,18,1328429700,3840,434640,3215700,2781060,0_0_0_0_0_0_1_1_0_0_1_1_2_2_3_3_14_14_14_14_14_14_14_18_14_18_18_14
3139,142,1328425980,4,22,4,1328428920,2940,2667540,7299960,4632420,0_0_0_0_0_0_0_1_1_0_0_0_0_0_0_0_0_1_1_0_0_0_0_0_0_1_1_0_0_0_0_0_0_1_1_0_0_0_0_0_0_0_1_0_1_0_0_0_1_1_1_1_27_27_27_27_1_27_27_1_27_27_27_27_27_27_27_27_27_27_27_27_27_27_27_27_2_2_2_2_2_2_3_3_3_2_2_3_3_3_2_2_3_3_4
3140,156,1328426820,1,6,16,1328427000,180,1028100,2639280,1611180,16_16_16_16_16_16_16_16_16_16_16_1_1_1_16_1_16_16_16_16_16_16_1_1_1_1_16_16_16_16_16_16_16_16_16_16_16_16_16_16_16_16_16_16_16_16_16_16_16_16_16_16_1_1
3141,162,1328426880,1,6,1,1328434140,7260,338340,4836120,4497780,0_0_16_16_0_0_0_0_0_0_0_0_16_0_0_16_0_0_16_16_0_0_1
3142,156,1328427000,16,20,16,1328427300,300,1028280,2639280,1611000,16_16_16_16_16_16_16_16_16_16_16_1_1_1_16_1_16_16_16_16_16_16_1_1_1_1_16_16_16_16_16_16_16_16_16_16_16_16_16_16_16_16_16_16_16_16_16_16_16_16_16_16_1_1_16
3143,156,1328427300,16,20,16,1328437860,10560,1028580,2639280,1610700,16_16_16_16_16_16_16_16_16_16_16_1_1_1_16_1_16_16_16_16_16_16_1_1_1_1_16_16_16_16_16_16_16_16_16_16_16_16_16_16_16_16_16_16_16_16_16_16_16_16_16_16_1_1_16_16
3144,73,1328427660,3,3,3,1328433480,5820,423660,1303500,879840,1_1_9_9_3
3145,142,1328428920,4,22,15,1328434320,5400,2670480,7299960,4629480,0_0_0_0_0_0_0_1_1_0_0_0_0_0_0_0_0_1_1_0_0_0_0_0_0_1_1_0_0_0_0_0_0_1_1_0_0_0_0_0_0_0_1_0_1_0_0_0_1_1_1_1_27_27_27_27_1_27_27_1_27_27_27_27_27_27_27_27_27_27_27_27_27_27_27_27_2_2_2_2_2_2_3_3_3_2_2_3_3_3_2_2_3_3_4_4
3146,173,1328429700,18,23,18,1328429820,120,438480,3215700,2777220,0_0_0_0_0_0_1_1_0_0_1_1_2_2_3_3_14_14_14_14_14_14_14_18_14_18_18_14_18
3147,173,1328429820,18,23,18,1328436900,7080,438600,3215700,2777100,0_0_0_0_0_0_1_1_0_0_1_1_2_2_3_3_14_14_14_14_14_14_14_18_14_18_18_14_18_18
3148,96,1328430660,9,4,9,1328433360,2700,1120860,2123400,1002540,10_1_10_10_10_10_1_10_10_10_10_10_1_1_2_2_9_9_9_9_9_9_3_3_5_5_9_9_9_9_9_9_5_5_6_6_9
3149,96,1328433360,9,4,3,1328620740,187380,1123560,2123400,999840,10_1_10_10_10_10_1_10_10_10_10_10_1_1_2_2_9_9_9_9_9_9_3_3_5_5_9_9_9_9_9_9_5_5_6_6_9_9
3150,130,1328433480,3,3,3,1328438580,5100,1709820,3083940,1374120,26_26_26_26_26_26_8_8_26_26_26_26_26_26_26_26_26_26_26_8_26_8_17_17_1_1_17_1_17_17_1_17_17_17_17_17_17_17_17_1_17_17_1_17_17_1_17_1_17_17_1_17_1_3
3151,73,1328433480,3,3,3,1328438580,5100,429480,1303500,874020,1_1_9_9_3_3
3152,162,1328434140,1,6,2,1328509200,75060,345600,4836120,4490520,0_0_16_16_0_0_0_0_0_0_0_0_16_0_0_16_0_0_16_16_0_0_1_1
3153,201,1328434200,1,6,1,1328439000,4800,267240,1645440,1378200,10_10_10_10_10_10_10_10_10_10_10_10_1
3154,142,1328434320,15,9,4,1328451420,17100,2675880,7299960,4624080,0_0_0_0_0_0_0_1_1_0_0_0_0_0_0_0_0_1_1_0_0_0_0_0_0_1_1_0_0_0_0_0_0_1_1_0_0_0_0_0_0_0_1_0_1_0_0_0_1_1_1_1_27_27_27_27_1_27_27_1_27_27_27_27_27_27_27_27_27_27_27_27_27_27_27_27_2_2_2_2_2_2_3_3_3_2_2_3_3_3_2_2_3_3_4_4_15
3155,67,1328434320,5,9,5,1328443440,9120,2935020,3120480,185460,2_3_3_3_2_3_3_3_1_1_27_27_4_4_4_4_4_4_4_5_5_4_4_2_2_3_3_4_4_4_4_4_5_5_4_4_4_4_5_5
3156,98,1328436000,5,2,5,1328439000,3000,2696580,7319880,4623300,34_34_2_2_35_35_34_34_2_2_3_3_3_3_3_3_18_18_3_3_3_18_3_3_3_18_18_18_18_3_3_18_18_18_18_18_18_18_18_3_3_18_39_3_3_39_3_3_3_3_4_4_5_5_5_5_5_5_4_4_4_5_3_5_5_3_5_4_4_4_5
3157,203,1328436000,1,2,7,1328456820,20820,440700,1897500,1456800,7_7_7_7_7_7_7_7_7_7_7_1_1
3158,173,1328436900,18,23,18,1328443440,6540,445680,3215700,2770020,0_0_0_0_0_0_1_1_0_0_1_1_2_2_3_3_14_14_14_14_14_14_14_18_14_18_18_14_18_18_18
3159,156,1328437860,16,20,16,1328456580,18720,1039140,2639280,1600140,16_16_16_16_16_16_16_16_16_16_16_1_1_1_16_1_16_16_16_16_16_16_1_1_1_1_16_16_16_16_16_16_16_16_16_16_16_16_16_16_16_16_16_16_16_16_16_16_16_16_16_16_1_1_16_16_16
3160,130,1328438580,3,3,1,1328446800,8220,1714920,3083940,1369020,26_26_26_26_26_26_8_8_26_26_26_26_26_26_26_26_26_26_26_8_26_8_17_17_1_1_17_1_17_17_1_17_17_17_17_17_17_17_17_1_17_17_1_17_17_1_17_1_17_17_1_17_1_3_3
3161,73,1328438580,3,3,9,1328440680,2100,434580,1303500,868920,1_1_9_9_3_3_3
3162,98,1328439000,5,2,5,1328440800,1800,2699580,7319880,4620300,34_34_2_2_35_35_34_34_2_2_3_3_3_3_3_3_18_18_3_3_3_18_3_3_3_18_18_18_18_3_3_18_18_18_18_18_18_18_18_3_3_18_39_3_3_39_3_3_3_3_4_4_5_5_5_5_5_5_4_4_4_5_3_5_5_3_5_4_4_4_5_5
3163,201,1328439000,1,6,2,1329385860,946860,272040,1645440,1373400,10_10_10_10_10_10_10_10_10_10_10_10_1_1
3164,73,1328440680,9,4,3,1328452680,12000,436680,1303500,866820,1_1_9_9_3_3_3_9
3165,98,1328440800,5,2,5,1328443200,2400,2701380,7319880,4618500,34_34_2_2_35_35_34_34_2_2_3_3_3_3_3_3_18_18_3_3_3_18_3_3_3_18_18_18_18_3_3_18_18_18_18_18_18_18_18_3_3_18_39_3_3_39_3_3_3_3_4_4_5_5_5_5_5_5_4_4_4_5_3_5_5_3_5_4_4_4_5_5_5
3166,141,1328443200,5,2,5,1328451000,7800,2790000,7406100,4616100,1_1_16_16_16_16_16_1_16_16_1_1_1_16_16_16_16_16_16_16_16_16_16_16_16_16_16_16_1_1_1_1_1_1_1_1_1_1_1_1_16_2_2_16_3_3_3_3_3_3_18_18_18_18_18_3_18_3_3_3_5
3167,23,1328443200,3,3,3,1328450400,7200,904920,1894920,990000,24_24_24_24_8_8_24_24_24_24_24_24_24_24_24_24_24_24_24_24_8_8_7_7_3
3168,98,1328443200,5,2,6,1328479200,36000,2703780,7319880,4616100,34_34_2_2_35_35_34_34_2_2_3_3_3_3_3_3_18_18_3_3_3_18_3_3_3_18_18_18_18_3_3_18_18_18_18_18_18_18_18_3_3_18_39_3_3_39_3_3_3_3_4_4_5_5_5_5_5_5_4_4_4_5_3_5_5_3_5_4_4_4_5_5_5_5
3169,173,1328443440,18,23,13,1328450400,6960,452220,3215700,2763480,0_0_0_0_0_0_1_1_0_0_1_1_2_2_3_3_14_14_14_14_14_14_14_18_14_18_18_14_18_18_18_18
3170,67,1328443440,5,9,5,1328443620,180,2944140,3120480,176340,2_3_3_3_2_3_3_3_1_1_27_27_4_4_4_4_4_4_4_5_5_4_4_2_2_3_3_4_4_4_4_4_5_5_4_4_4_4_5_5_5
3171,67,1328443620,5,9,1,1328444100,480,2944320,3120480,176160,2_3_3_3_2_3_3_3_1_1_27_27_4_4_4_4_4_4_4_5_5_4_4_2_2_3_3_4_4_4_4_4_5_5_4_4_4_4_5_5_5_5
3172,67,1328444100,1,9,1,1328444160,60,2944800,3120480,175680,2_3_3_3_2_3_3_3_1_1_27_27_4_4_4_4_4_4_4_5_5_4_4_2_2_3_3_4_4_4_4_4_5_5_4_4_4_4_5_5_5_5_1
3173,67,1328444160,1,9,1,1328444220,60,2944860,3120480,175620,2_3_3_3_2_3_3_3_1_1_27_27_4_4_4_4_4_4_4_5_5_4_4_2_2_3_3_4_4_4_4_4_5_5_4_4_4_4_5_5_5_5_1_1
3174,67,1328444220,1,9,1,1328444280,60,2944920,3120480,175560,2_3_3_3_2_3_3_3_1_1_27_27_4_4_4_4_4_4_4_5_5_4_4_2_2_3_3_4_4_4_4_4_5_5_4_4_4_4_5_5_5_5_1_1_1
3175,67,1328444280,1,9,5,1328445540,1260,2944980,3120480,175500,2_3_3_3_2_3_3_3_1_1_27_27_4_4_4_4_4_4_4_5_5_4_4_2_2_3_3_4_4_4_4_4_5_5_4_4_4_4_5_5_5_5_1_1_1_1
3176,67,1328445540,5,9,1,1328445780,240,2946240,3120480,174240,2_3_3_3_2_3_3_3_1_1_27_27_4_4_4_4_4_4_4_5_5_4_4_2_2_3_3_4_4_4_4_4_5_5_4_4_4_4_5_5_5_5_1_1_1_1_5
3177,67,1328445780,1,9,1,1328445780,0,2946480,3120480,174000,2_3_3_3_2_3_3_3_1_1_27_27_4_4_4_4_4_4_4_5_5_4_4_2_2_3_3_4_4_4_4_4_5_5_4_4_4_4_5_5_5_5_1_1_1_1_5_1
3178,67,1328445780,1,9,5,1328445840,60,2946480,3120480,174000,2_3_3_3_2_3_3_3_1_1_27_27_4_4_4_4_4_4_4_5_5_4_4_2_2_3_3_4_4_4_4_4_5_5_4_4_4_4_5_5_5_5_1_1_1_1_5_1_1
3179,67,1328445840,5,9,6,1328479200,33360,2946540,3120480,173940,2_3_3_3_2_3_3_3_1_1_27_27_4_4_4_4_4_4_4_5_5_4_4_2_2_3_3_4_4_4_4_4_5_5_4_4_4_4_5_5_5_5_1_1_1_1_5_1_1_5
3180,130,1328446800,1,18,1,1328450160,3360,1723140,3083940,1360800,26_26_26_26_26_26_8_8_26_26_26_26_26_26_26_26_26_26_26_8_26_8_17_17_1_1_17_1_17_17_1_17_17_17_17_17_17_17_17_1_17_17_1_17_17_1_17_1_17_17_1_17_1_3_3_1
3181,158,1328446800,5,18,13,1329655080,1208280,626280,2044680,1418400,17_17_17_17_17_17_17_17_17_1_17_1_2_2_3_3_3_13_13_3_13_13_13_13_13_13_5_5_6_6_5_5
3182,192,1328449920,0,0,0,1328450160,240,245160,4648740,4403580,16_16_16_16_16_0_0_16_16_16_16_16_0_0_0_1_1_0
3183,130,1328450160,1,18,17,1328456820,6660,1726500,3083940,1357440,26_26_26_26_26_26_8_8_26_26_26_26_26_26_26_26_26_26_26_8_26_8_17_17_1_1_17_1_17_17_1_17_17_17_17_17_17_17_17_1_17_17_1_17_17_1_17_1_17_17_1_17_1_3_3_1_1
3184,192,1328450160,0,1,0,1328478780,28620,245400,4648740,4403340,16_16_16_16_16_0_0_16_16_16_16_16_0_0_0_1_1_0_0
3185,173,1328450400,13,15,13,1328454720,4320,459180,3215700,2756520,0_0_0_0_0_0_1_1_0_0_1_1_2_2_3_3_14_14_14_14_14_14_14_18_14_18_18_14_18_18_18_18_13
3186,23,1328450400,3,3,9,1328479200,28800,912120,1894920,982800,24_24_24_24_8_8_24_24_24_24_24_24_24_24_24_24_24_24_24_24_8_8_7_7_3_3
3187,141,1328451000,5,2,5,1328504400,53400,2797800,7406100,4608300,1_1_16_16_16_16_16_1_16_16_1_1_1_16_16_16_16_16_16_16_16_16_16_16_16_16_16_16_1_1_1_1_1_1_1_1_1_1_1_1_16_2_2_16_3_3_3_3_3_3_18_18_18_18_18_3_18_3_3_3_5_5
3188,142,1328451420,4,19,15,1328457840,6420,2692980,7299960,4606980,0_0_0_0_0_0_0_1_1_0_0_0_0_0_0_0_0_1_1_0_0_0_0_0_0_1_1_0_0_0_0_0_0_1_1_0_0_0_0_0_0_0_1_0_1_0_0_0_1_1_1_1_27_27_27_27_1_27_27_1_27_27_27_27_27_27_27_27_27_27_27_27_27_27_27_27_2_2_2_2_2_2_3_3_3_2_2_3_3_3_2_2_3_3_4_4_15_4
3189,73,1328452680,3,3,9,1328456580,3900,448680,1303500,854820,1_1_9_9_3_3_3_9_3
3190,173,1328454720,13,15,13,1328454780,60,463500,3215700,2752200,0_0_0_0_0_0_1_1_0_0_1_1_2_2_3_3_14_14_14_14_14_14_14_18_14_18_18_14_18_18_18_18_13_13
3191,173,1328454780,13,15,14,1328456880,2100,463560,3215700,2752140,0_0_0_0_0_0_1_1_0_0_1_1_2_2_3_3_14_14_14_14_14_14_14_18_14_18_18_14_18_18_18_18_13_13_13
3192,156,1328456580,16,20,16,1328461320,4740,1057860,2639280,1581420,16_16_16_16_16_16_16_16_16_16_16_1_1_1_16_1_16_16_16_16_16_16_1_1_1_1_16_16_16_16_16_16_16_16_16_16_16_16_16_16_16_16_16_16_16_16_16_16_16_16_16_16_1_1_16_16_16_16
3193,73,1328456580,9,4,9,1328507640,51060,452580,1303500,850920,1_1_9_9_3_3_3_9_3_9
3194,130,1328456820,17,10,17,1328466900,10080,1733160,3083940,1350780,26_26_26_26_26_26_8_8_26_26_26_26_26_26_26_26_26_26_26_8_26_8_17_17_1_1_17_1_17_17_1_17_17_17_17_17_17_17_17_1_17_17_1_17_17_1_17_1_17_17_1_17_1_3_3_1_1_17
3195,203,1328456820,7,10,7,1328466840,10020,461520,1897500,1435980,7_7_7_7_7_7_7_7_7_7_7_1_1_7
3196,173,1328456880,14,17,13,1328456880,0,465660,3215700,2750040,0_0_0_0_0_0_1_1_0_0_1_1_2_2_3_3_14_14_14_14_14_14_14_18_14_18_18_14_18_18_18_18_13_13_13_14
3197,173,1328456880,13,15,14,1328456880,0,465660,3215700,2750040,0_0_0_0_0_0_1_1_0_0_1_1_2_2_3_3_14_14_14_14_14_14_14_18_14_18_18_14_18_18_18_18_13_13_13_14_13
3198,173,1328456880,14,15,18,1328457300,420,465660,3215700,2750040,0_0_0_0_0_0_1_1_0_0_1_1_2_2_3_3_14_14_14_14_14_14_14_18_14_18_18_14_18_18_18_18_13_13_13_14_13_14
3199,173,1328457300,18,23,18,1328465040,7740,466080,3215700,2749620,0_0_0_0_0_0_1_1_0_0_1_1_2_2_3_3_14_14_14_14_14_14_14_18_14_18_18_14_18_18_18_18_13_13_13_14_13_14_18
3200,142,1328457840,15,9,4,1328464980,7140,2699400,7299960,4600560,0_0_0_0_0_0_0_1_1_0_0_0_0_0_0_0_0_1_1_0_0_0_0_0_0_1_1_0_0_0_0_0_0_1_1_0_0_0_0_0_0_0_1_0_1_0_0_0_1_1_1_1_27_27_27_27_1_27_27_1_27_27_27_27_27_27_27_27_27_27_27_27_27_27_27_27_2_2_2_2_2_2_3_3_3_2_2_3_3_3_2_2_3_3_4_4_15_4_15
3201,156,1328461320,16,1,16,1328465100,3780,1062600,2639280,1576680,16_16_16_16_16_16_16_16_16_16_16_1_1_1_16_1_16_16_16_16_16_16_1_1_1_1_16_16_16_16_16_16_16_16_16_16_16_16_16_16_16_16_16_16_16_16_16_16_16_16_16_16_1_1_16_16_16_16_16
3202,142,1328464980,4,19,4,1328465160,180,2706540,7299960,4593420,0_0_0_0_0_0_0_1_1_0_0_0_0_0_0_0_0_1_1_0_0_0_0_0_0_1_1_0_0_0_0_0_0_1_1_0_0_0_0_0_0_0_1_0_1_0_0_0_1_1_1_1_27_27_27_27_1_27_27_1_27_27_27_27_27_27_27_27_27_27_27_27_27_27_27_27_2_2_2_2_2_2_3_3_3_2_2_3_3_3_2_2_3_3_4_4_15_4_15_4
3203,173,1328465040,18,19,18,1328478120,13080,473820,3215700,2741880,0_0_0_0_0_0_1_1_0_0_1_1_2_2_3_3_14_14_14_14_14_14_14_18_14_18_18_14_18_18_18_18_13_13_13_14_13_14_18_18
3204,156,1328465100,16,1,16,1328465280,180,1066380,2639280,1572900,16_16_16_16_16_16_16_16_16_16_16_1_1_1_16_1_16_16_16_16_16_16_1_1_1_1_16_16_16_16_16_16_16_16_16_16_16_16_16_16_16_16_16_16_16_16_16_16_16_16_16_16_1_1_16_16_16_16_16_16
3205,142,1328465160,4,5,4,1328503980,38820,2706720,7299960,4593240,0_0_0_0_0_0_0_1_1_0_0_0_0_0_0_0_0_1_1_0_0_0_0_0_0_1_1_0_0_0_0_0_0_1_1_0_0_0_0_0_0_0_1_0_1_0_0_0_1_1_1_1_27_27_27_27_1_27_27_1_27_27_27_27_27_27_27_27_27_27_27_27_27_27_27_27_2_2_2_2_2_2_3_3_3_2_2_3_3_3_2_2_3_3_4_4_15_4_15_4_4
3206,156,1328465280,16,14,16,1328492460,27180,1066560,2639280,1572720,16_16_16_16_16_16_16_16_16_16_16_1_1_1_16_1_16_16_16_16_16_16_1_1_1_1_16_16_16_16_16_16_16_16_16_16_16_16_16_16_16_16_16_16_16_16_16_16_16_16_16_16_1_1_16_16_16_16_16_16_16
3207,203,1328466840,7,12,7,1328503140,36300,471540,1897500,1425960,7_7_7_7_7_7_7_7_7_7_7_1_1_7_7
3208,130,1328466900,17,12,17,1328503140,36240,1743240,3083940,1340700,26_26_26_26_26_26_8_8_26_26_26_26_26_26_26_26_26_26_26_8_26_8_17_17_1_1_17_1_17_17_1_17_17_17_17_17_17_17_17_1_17_17_1_17_17_1_17_1_17_17_1_17_1_3_3_1_1_17_17
3209,173,1328478120,18,19,14,1328478240,120,486900,3215700,2728800,0_0_0_0_0_0_1_1_0_0_1_1_2_2_3_3_14_14_14_14_14_14_14_18_14_18_18_14_18_18_18_18_13_13_13_14_13_14_18_18_18
3210,173,1328478240,14,15,13,1328504340,26100,487020,3215700,2728680,0_0_0_0_0_0_1_1_0_0_1_1_2_2_3_3_14_14_14_14_14_14_14_18_14_18_18_14_18_18_18_18_13_13_13_14_13_14_18_18_18_14
3211,192,1328478780,0,1,0,1328479020,240,274020,4648740,4374720,16_16_16_16_16_0_0_16_16_16_16_16_0_0_0_1_1_0_0_0
3212,77,1328478960,4,5,4,1328480220,1260,1870800,3257040,1386240,0_0_1_0_0_1_0_0_0_0_0_0_0_0_0_0_0_0_1_0_1_0_2_2_4_4_4_4_4_4_4_4_4_4_4_4_4
3213,192,1328479020,0,14,0,1328492160,13140,274260,4648740,4374480,16_16_16_16_16_0_0_16_16_16_16_16_0_0_0_1_1_0_0_0_0
3214,114,1328479200,9,4,9,1328483700,4500,419880,1201080,781200,19_19_19_19_19_19_19_19_19_19_19_19_9
3215,67,1328479200,6,7,6,1328482800,3600,2979900,3120480,140580,2_3_3_3_2_3_3_3_1_1_27_27_4_4_4_4_4_4_4_5_5_4_4_2_2_3_3_4_4_4_4_4_5_5_4_4_4_4_5_5_5_5_1_1_1_1_5_1_1_5_6
3216,23,1328479200,9,4,9,1328483700,4500,940920,1894920,954000,24_24_24_24_8_8_24_24_24_24_24_24_24_24_24_24_24_24_24_24_8_8_7_7_3_3_9
3217,98,1328479200,6,7,6,1328479200,0,2739780,7319880,4580100,34_34_2_2_35_35_34_34_2_2_3_3_3_3_3_3_18_18_3_3_3_18_3_3_3_18_18_18_18_3_3_18_18_18_18_18_18_18_18_3_3_18_39_3_3_39_3_3_3_3_4_4_5_5_5_5_5_5_4_4_4_5_3_5_5_3_5_4_4_4_5_5_5_5_6
3218,98,1328479200,6,7,6,1328482800,3600,2739780,7319880,4580100,34_34_2_2_35_35_34_34_2_2_3_3_3_3_3_3_18_18_3_3_3_18_3_3_3_18_18_18_18_3_3_18_18_18_18_18_18_18_18_3_3_18_39_3_3_39_3_3_3_3_4_4_5_5_5_5_5_5_4_4_4_5_3_5_5_3_5_4_4_4_5_5_5_5_6_6
3219,72,1328479200,6,7,6,1328479200,0,2295960,2385960,90000,17_17_17_1_17_1_17_1_1_17_17_17_17_1_1_17_17_17_38_38_17_17_1_24_24_24_24_1_24_1_1_24_24_24_24_24_8_8_2_2_3_3_3_5_3_5_5_5_5_5_5_5_34_34_5_5_5_5_6
3220,72,1328479200,6,7,6,1328482800,3600,2295960,2385960,90000,17_17_17_1_17_1_17_1_1_17_17_17_17_1_1_17_17_17_38_38_17_17_1_24_24_24_24_1_24_1_1_24_24_24_24_24_8_8_2_2_3_3_3_5_3_5_5_5_5_5_5_5_34_34_5_5_5_5_6_6
3221,92,1328479200,6,7,6,1328482800,3600,567660,613860,46200,42_42_42_42_42_42_42_42_5_5_6
3222,77,1328480220,4,5,1,1328503800,23580,1872060,3257040,1384980,0_0_1_0_0_1_0_0_0_0_0_0_0_0_0_0_0_0_1_0_1_0_2_2_4_4_4_4_4_4_4_4_4_4_4_4_4_4
3223,72,1328482800,6,7,6,1328482800,0,2299560,2385960,86400,17_17_17_1_17_1_17_1_1_17_17_17_17_1_1_17_17_17_38_38_17_17_1_24_24_24_24_1_24_1_1_24_24_24_24_24_8_8_2_2_3_3_3_5_3_5_5_5_5_5_5_5_34_34_5_5_5_5_6_6_6
3224,98,1328482800,6,7,6,1328482800,0,2743380,7319880,4576500,34_34_2_2_35_35_34_34_2_2_3_3_3_3_3_3_18_18_3_3_3_18_3_3_3_18_18_18_18_3_3_18_18_18_18_18_18_18_18_3_3_18_39_3_3_39_3_3_3_3_4_4_5_5_5_5_5_5_4_4_4_5_3_5_5_3_5_4_4_4_5_5_5_5_6_6_6
3225,92,1328482800,6,7,2,1328520240,37440,571260,613860,42600,42_42_42_42_42_42_42_42_5_5_6_6
3226,98,1328482800,6,7,5,1328590800,108000,2743380,7319880,4576500,34_34_2_2_35_35_34_34_2_2_3_3_3_3_3_3_18_18_3_3_3_18_3_3_3_18_18_18_18_3_3_18_18_18_18_18_18_18_18_3_3_18_39_3_3_39_3_3_3_3_4_4_5_5_5_5_5_5_4_4_4_5_3_5_5_3_5_4_4_4_5_5_5_5_6_6_6_6
3227,67,1328482800,6,7,5,1328505240,22440,2983500,3120480,136980,2_3_3_3_2_3_3_3_1_1_27_27_4_4_4_4_4_4_4_5_5_4_4_2_2_3_3_4_4_4_4_4_5_5_4_4_4_4_5_5_5_5_1_1_1_1_5_1_1_5_6_6
3228,72,1328482800,6,7,6,1328565600,82800,2299560,2385960,86400,17_17_17_1_17_1_17_1_1_17_17_17_17_1_1_17_17_17_38_38_17_17_1_24_24_24_24_1_24_1_1_24_24_24_24_24_8_8_2_2_3_3_3_5_3_5_5_5_5_5_5_5_34_34_5_5_5_5_6_6_6_6
3229,114,1328483700,9,4,1,1328534460,50760,424380,1201080,776700,19_19_19_19_19_19_19_19_19_19_19_19_9_9
3230,23,1328483700,9,4,9,1328514780,31080,945420,1894920,949500,24_24_24_24_8_8_24_24_24_24_24_24_24_24_24_24_24_24_24_24_8_8_7_7_3_3_9_9
3231,192,1328492160,0,16,0,1328492460,300,287400,4648740,4361340,16_16_16_16_16_0_0_16_16_16_16_16_0_0_0_1_1_0_0_0_0_0
3232,192,1328492460,0,14,0,1328502960,10500,287700,4648740,4361040,16_16_16_16_16_0_0_16_16_16_16_16_0_0_0_1_1_0_0_0_0_0_0
3233,156,1328492460,16,14,1,1328504400,11940,1093740,2639280,1545540,16_16_16_16_16_16_16_16_16_16_16_1_1_1_16_1_16_16_16_16_16_16_1_1_1_1_16_16_16_16_16_16_16_16_16_16_16_16_16_16_16_16_16_16_16_16_16_16_16_16_16_16_1_1_16_16_16_16_16_16_16_16
3234,184,1328497200,10,16,10,1328501520,4320,0,1800900,1800900,10
3235,184,1328501520,10,16,10,1328502600,1080,4320,1800900,1796580,10_10
3236,184,1328502600,10,16,10,1328502960,360,5400,1800900,1795500,10_10_10
3237,192,1328502960,0,16,0,1328504460,1500,298200,4648740,4350540,16_16_16_16_16_0_0_16_16_16_16_16_0_0_0_1_1_0_0_0_0_0_0_0
3238,184,1328502960,10,16,10,1328611200,108240,5760,1800900,1795140,10_10_10_10
3239,130,1328503140,17,12,18,1328504880,1740,1779480,3083940,1304460,26_26_26_26_26_26_8_8_26_26_26_26_26_26_26_26_26_26_26_8_26_8_17_17_1_1_17_1_17_17_1_17_17_17_17_17_17_17_17_1_17_17_1_17_17_1_17_1_17_17_1_17_1_3_3_1_1_17_17_17
3240,203,1328503140,7,12,7,1328504280,1140,507840,1897500,1389660,7_7_7_7_7_7_7_7_7_7_7_1_1_7_7_7
3241,77,1328503800,1,9,1,1328504820,1020,1895640,3257040,1361400,0_0_1_0_0_1_0_0_0_0_0_0_0_0_0_0_0_0_1_0_1_0_2_2_4_4_4_4_4_4_4_4_4_4_4_4_4_4_1
3242,142,1328503980,4,5,4,1328504160,180,2745540,7299960,4554420,0_0_0_0_0_0_0_1_1_0_0_0_0_0_0_0_0_1_1_0_0_0_0_0_0_1_1_0_0_0_0_0_0_1_1_0_0_0_0_0_0_0_1_0_1_0_0_0_1_1_1_1_27_27_27_27_1_27_27_1_27_27_27_27_27_27_27_27_27_27_27_27_27_27_27_27_2_2_2_2_2_2_3_3_3_2_2_3_3_3_2_2_3_3_4_4_15_4_15_4_4_4
3243,142,1328504160,4,22,4,1328508540,4380,2745720,7299960,4554240,0_0_0_0_0_0_0_1_1_0_0_0_0_0_0_0_0_1_1_0_0_0_0_0_0_1_1_0_0_0_0_0_0_1_1_0_0_0_0_0_0_0_1_0_1_0_0_0_1_1_1_1_27_27_27_27_1_27_27_1_27_27_27_27_27_27_27_27_27_27_27_27_27_27_27_27_2_2_2_2_2_2_3_3_3_2_2_3_3_3_2_2_3_3_4_4_15_4_15_4_4_4_4
3244,203,1328504280,7,8,7,1328543340,39060,508980,1897500,1388520,7_7_7_7_7_7_7_7_7_7_7_1_1_7_7_7_7
3245,173,1328504340,13,17,18,1328515560,11220,513120,3215700,2702580,0_0_0_0_0_0_1_1_0_0_1_1_2_2_3_3_14_14_14_14_14_14_14_18_14_18_18_14_18_18_18_18_13_13_13_14_13_14_18_18_18_14_13
3246,156,1328504400,1,6,1,1328509200,4800,1105680,2639280,1533600,16_16_16_16_16_16_16_16_16_16_16_1_1_1_16_1_16_16_16_16_16_16_1_1_1_1_16_16_16_16_16_16_16_16_16_16_16_16_16_16_16_16_16_16_16_16_16_16_16_16_16_16_1_1_16_16_16_16_16_16_16_16_1
3247,107,1328504400,8,18,8,1328508780,4380,577800,4991760,4413960,8_8_8_8_28_28_28_28_28_28_8_8
3248,107,1328504400,8,18,8,1328504400,0,577800,4991760,4413960,8_8_8_8_28_28_28_28_28_28_8
3249,141,1328504400,5,2,5,1328510400,6000,2851200,7406100,4554900,1_1_16_16_16_16_16_1_16_16_1_1_1_16_16_16_16_16_16_16_16_16_16_16_16_16_16_16_1_1_1_1_1_1_1_1_1_1_1_1_16_2_2_16_3_3_3_3_3_3_18_18_18_18_18_3_18_3_3_3_5_5_5
3250,192,1328504460,0,0,0,1328521740,17280,299700,4648740,4349040,16_16_16_16_16_0_0_16_16_16_16_16_0_0_0_1_1_0_0_0_0_0_0_0_0
3251,77,1328504820,1,9,18,1328612520,107700,1896660,3257040,1360380,0_0_1_0_0_1_0_0_0_0_0_0_0_0_0_0_0_0_1_0_1_0_2_2_4_4_4_4_4_4_4_4_4_4_4_4_4_4_1_1
3252,130,1328504880,18,23,17,1328506140,1260,1781220,3083940,1302720,26_26_26_26_26_26_8_8_26_26_26_26_26_26_26_26_26_26_26_8_26_8_17_17_1_1_17_1_17_17_1_17_17_17_17_17_17_17_17_1_17_17_1_17_17_1_17_1_17_17_1_17_1_3_3_1_1_17_17_17_18
3253,67,1328505240,5,9,5,1328544060,38820,3005940,3120480,114540,2_3_3_3_2_3_3_3_1_1_27_27_4_4_4_4_4_4_4_5_5_4_4_2_2_3_3_4_4_4_4_4_5_5_4_4_4_4_5_5_5_5_1_1_1_1_5_1_1_5_6_6_5
3254,130,1328506140,17,10,1,1328508000,1860,1782480,3083940,1301460,26_26_26_26_26_26_8_8_26_26_26_26_26_26_26_26_26_26_26_8_26_8_17_17_1_1_17_1_17_17_1_17_17_17_17_17_17_17_17_1_17_17_1_17_17_1_17_1_17_17_1_17_1_3_3_1_1_17_17_17_18_17
3255,161,1328506860,1,9,1,1328506920,60,597240,1955580,1358340,10_24_24_10_10_10_10_10_10_10_10_10_10_10_10_10_9_9_1
3256,161,1328506920,1,9,4,1328997600,490680,597300,1955580,1358280,10_24_24_10_10_10_10_10_10_10_10_10_10_10_10_10_9_9_1_1
3257,198,1328507280,10,13,10,1328541720,34440,0,708660,708660,10
3258,73,1328507640,9,4,9,1328510220,2580,503640,1303500,799860,1_1_9_9_3_3_3_9_3_9_9
3259,130,1328508000,1,18,18,1328508480,480,1784340,3083940,1299600,26_26_26_26_26_26_8_8_26_26_26_26_26_26_26_26_26_26_26_8_26_8_17_17_1_1_17_1_17_17_1_17_17_17_17_17_17_17_17_1_17_17_1_17_17_1_17_1_17_17_1_17_1_3_3_1_1_17_17_17_18_17_1
3260,130,1328508480,18,23,4,1328508480,0,1784820,3083940,1299120,26_26_26_26_26_26_8_8_26_26_26_26_26_26_26_26_26_26_26_8_26_8_17_17_1_1_17_1_17_17_1_17_17_17_17_17_17_17_17_1_17_17_1_17_17_1_17_1_17_17_1_17_1_3_3_1_1_17_17_17_18_17_1_18
3261,130,1328508480,4,23,18,1328508600,120,1784820,3083940,1299120,26_26_26_26_26_26_8_8_26_26_26_26_26_26_26_26_26_26_26_8_26_8_17_17_1_1_17_1_17_17_1_17_17_17_17_17_17_17_17_1_17_17_1_17_17_1_17_1_17_17_1_17_1_3_3_1_1_17_17_17_18_17_1_18_4
3262,142,1328508540,4,22,4,1329596220,1087680,2750100,7299960,4549860,0_0_0_0_0_0_0_1_1_0_0_0_0_0_0_0_0_1_1_0_0_0_0_0_0_1_1_0_0_0_0_0_0_1_1_0_0_0_0_0_0_0_1_0_1_0_0_0_1_1_1_1_27_27_27_27_1_27_27_1_27_27_27_27_27_27_27_27_27_27_27_27_27_27_27_27_2_2_2_2_2_2_3_3_3_2_2_3_3_3_2_2_3_3_4_4_15_4_15_4_4_4_4_4
3263,130,1328508600,18,22,1,1328512020,3420,1784940,3083940,1299000,26_26_26_26_26_26_8_8_26_26_26_26_26_26_26_26_26_26_26_8_26_8_17_17_1_1_17_1_17_17_1_17_17_17_17_17_17_17_17_1_17_17_1_17_17_1_17_1_17_17_1_17_1_3_3_1_1_17_17_17_18_17_1_18_4_18
3264,107,1328508780,8,18,8,1328508780,0,582180,4991760,4409580,8_8_8_8_28_28_28_28_28_28_8_8_8
3265,107,1328508780,8,18,16,1329141600,632820,582180,4991760,4409580,8_8_8_8_28_28_28_28_28_28_8_8_8_8
3266,156,1328509200,1,6,47,1329380760,871560,1110480,2639280,1528800,16_16_16_16_16_16_16_16_16_16_16_1_1_1_16_1_16_16_16_16_16_16_1_1_1_1_16_16_16_16_16_16_16_16_16_16_16_16_16_16_16_16_16_16_16_16_16_16_16_16_16_16_1_1_16_16_16_16_16_16_16_16_1_1
3267,162,1328509200,2,3,2,1328513940,4740,420660,4836120,4415460,0_0_16_16_0_0_0_0_0_0_0_0_16_0_0_16_0_0_16_16_0_0_1_1_2
3268,73,1328510220,9,4,18,1328819460,309240,506220,1303500,797280,1_1_9_9_3_3_3_9_3_9_9_9
3269,141,1328510400,5,2,5,1328511600,1200,2857200,7406100,4548900,1_1_16_16_16_16_16_1_16_16_1_1_1_16_16_16_16_16_16_16_16_16_16_16_16_16_16_16_1_1_1_1_1_1_1_1_1_1_1_1_16_2_2_16_3_3_3_3_3_3_18_18_18_18_18_3_18_3_3_3_5_5_5_5
3270,143,1328511600,1,9,1,1328516460,4860,1040520,1898460,857940,10_10_10_1_10_1_10_1_1_10_10_10_10_10_1_1_10_1_10_1_10_10_10_10_1_1_1_1_1
3271,141,1328511600,5,2,5,1328518800,7200,2858400,7406100,4547700,1_1_16_16_16_16_16_1_16_16_1_1_1_16_16_16_16_16_16_16_16_16_16_16_16_16_16_16_1_1_1_1_1_1_1_1_1_1_1_1_16_2_2_16_3_3_3_3_3_3_18_18_18_18_18_3_18_3_3_3_5_5_5_5_5
3272,130,1328512020,1,18,4,1328523000,10980,1788360,3083940,1295580,26_26_26_26_26_26_8_8_26_26_26_26_26_26_26_26_26_26_26_8_26_8_17_17_1_1_17_1_17_17_1_17_17_17_17_17_17_17_17_1_17_17_1_17_17_1_17_1_17_17_1_17_1_3_3_1_1_17_17_17_18_17_1_18_4_18_1
3273,135,1328513940,2,3,2,1328516400,2460,2439540,5649480,3209940,19_19_19_19_19_19_19_19_19_19_19_19_1_19_1_19_19_19_1_1_1_1_19_19_19_19_19_19_1_1_1_1_19_19_19_19_19_19_19_19_19_19_19_19_1_19_1_19_19_19_19_19_19_1_19_1_1_1_2
3274,162,1328513940,2,3,3,1330812000,2298060,425400,4836120,4410720,0_0_16_16_0_0_0_0_0_0_0_0_16_0_0_16_0_0_16_16_0_0_1_1_2_2
3275,23,1328514780,9,4,9,1328524800,10020,976500,1894920,918420,24_24_24_24_8_8_24_24_24_24_24_24_24_24_24_24_24_24_24_24_8_8_7_7_3_3_9_9_9
3276,173,1328515560,18,15,13,1328536020,20460,524340,3215700,2691360,0_0_0_0_0_0_1_1_0_0_1_1_2_2_3_3_14_14_14_14_14_14_14_18_14_18_18_14_18_18_18_18_13_13_13_14_13_14_18_18_18_14_13_18
3277,135,1328516400,2,3,1,1329113340,596940,2442000,5649480,3207480,19_19_19_19_19_19_19_19_19_19_19_19_1_19_1_19_19_19_1_1_1_1_19_19_19_19_19_19_1_1_1_1_19_19_19_19_19_19_19_19_19_19_19_19_1_19_1_19_19_19_19_19_19_1_19_1_1_1_2_2
3278,166,1328516460,2,3,2,1328517660,1200,1047060,1666080,619020,7_7_7_1_7_7_1_7_7_7_21_21_1_1_2
3279,147,1328516460,1,9,2,1328518620,2160,1133580,1479360,345780,7_7_7_7_7_7_7_1_7_1_9_9_1
3280,143,1328516460,1,9,9,1328687460,171000,1045380,1898460,853080,10_10_10_1_10_1_10_1_1_10_10_10_10_10_1_1_10_1_10_1_10_10_10_10_1_1_1_1_1_1
3281,166,1328517660,2,3,3,1328610600,92940,1048260,1666080,617820,7_7_7_1_7_7_1_7_7_7_21_21_1_1_2_2
3282,148,1328517720,2,3,2,1328518200,480,1653420,1938900,285480,7_7_7_7_7_1_7_1_9_9_2
3283,148,1328518200,2,3,3,1328608800,90600,1653900,1938900,285000,7_7_7_7_7_1_7_1_9_9_2_2
3284,147,1328518620,2,3,2,1328520240,1620,1135740,1479360,343620,7_7_7_7_7_7_7_1_7_1_9_9_1_2
3285,141,1328518800,5,2,3,1328686080,167280,2865600,7406100,4540500,1_1_16_16_16_16_16_1_16_16_1_1_1_16_16_16_16_16_16_16_16_16_16_16_16_16_16_16_1_1_1_1_1_1_1_1_1_1_1_1_16_2_2_16_3_3_3_3_3_3_18_18_18_18_18_3_18_3_3_3_5_5_5_5_5_5
3286,92,1328520240,2,3,5,1328522400,2160,608700,613860,5160,42_42_42_42_42_42_42_42_5_5_6_6_2
3287,147,1328520240,2,3,1,1328526960,6720,1137360,1479360,342000,7_7_7_7_7_7_7_1_7_1_9_9_1_2_2
3288,192,1328521740,0,0,0,1328523000,1260,316980,4648740,4331760,16_16_16_16_16_0_0_16_16_16_16_16_0_0_0_1_1_0_0_0_0_0_0_0_0_0
3289,92,1328522400,5,18,2,1328525220,2820,610860,613860,3000,42_42_42_42_42_42_42_42_5_5_6_6_2_5
3290,130,1328523000,4,23,4,1328523000,0,1799340,3083940,1284600,26_26_26_26_26_26_8_8_26_26_26_26_26_26_26_26_26_26_26_8_26_8_17_17_1_1_17_1_17_17_1_17_17_17_17_17_17_17_17_1_17_17_1_17_17_1_17_1_17_17_1_17_1_3_3_1_1_17_17_17_18_17_1_18_4_18_1_4
3291,130,1328523000,4,23,18,1328523120,120,1799340,3083940,1284600,26_26_26_26_26_26_8_8_26_26_26_26_26_26_26_26_26_26_26_8_26_8_17_17_1_1_17_1_17_17_1_17_17_17_17_17_17_17_17_1_17_17_1_17_17_1_17_1_17_17_1_17_1_3_3_1_1_17_17_17_18_17_1_18_4_18_1_4_4
3292,192,1328523000,0,0,0,1328536740,13740,318240,4648740,4330500,16_16_16_16_16_0_0_16_16_16_16_16_0_0_0_1_1_0_0_0_0_0_0_0_0_0_0
3293,130,1328523120,18,22,18,1328523120,0,1799460,3083940,1284480,26_26_26_26_26_26_8_8_26_26_26_26_26_26_26_26_26_26_26_8_26_8_17_17_1_1_17_1_17_17_1_17_17_17_17_17_17_17_17_1_17_17_1_17_17_1_17_1_17_17_1_17_1_3_3_1_1_17_17_17_18_17_1_18_4_18_1_4_4_18
3294,130,1328523120,18,22,3,1328528820,5700,1799460,3083940,1284480,26_26_26_26_26_26_8_8_26_26_26_26_26_26_26_26_26_26_26_8_26_8_17_17_1_1_17_1_17_17_1_17_17_17_17_17_17_17_17_1_17_17_1_17_17_1_17_1_17_17_1_17_1_3_3_1_1_17_17_17_18_17_1_18_4_18_1_4_4_18_18
3295,23,1328524800,9,4,2,1328525220,420,986520,1894920,908400,24_24_24_24_8_8_24_24_24_24_24_24_24_24_24_24_24_24_24_24_8_8_7_7_3_3_9_9_9_9
3296,92,1328525220,2,3,5,1328525400,180,613680,613860,180,42_42_42_42_42_42_42_42_5_5_6_6_2_5_2
3297,23,1328525220,2,3,2,1328528820,3600,986940,1894920,907980,24_24_24_24_8_8_24_24_24_24_24_24_24_24_24_24_24_24_24_24_8_8_7_7_3_3_9_9_9_9_2
3298,92,1328525400,5,18,99,1328525400,0,613860,613860,0,42_42_42_42_42_42_42_42_5_5_6_6_2_5_2_5
3299,147,1328526960,1,9,3,1328612400,85440,1144080,1479360,335280,7_7_7_7_7_7_7_1_7_1_9_9_1_2_2_1
3300,23,1328528820,2,3,9,1328565600,36780,990540,1894920,904380,24_24_24_24_8_8_24_24_24_24_24_24_24_24_24_24_24_24_24_24_8_8_7_7_3_3_9_9_9_9_2_2
3301,130,1328528820,3,3,17,1328532000,3180,1805160,3083940,1278780,26_26_26_26_26_26_8_8_26_26_26_26_26_26_26_26_26_26_26_8_26_8_17_17_1_1_17_1_17_17_1_17_17_17_17_17_17_17_17_1_17_17_1_17_17_1_17_1_17_17_1_17_1_3_3_1_1_17_17_17_18_17_1_18_4_18_1_4_4_18_18_3
3302,130,1328532000,17,10,1,1328533200,1200,1808340,3083940,1275600,26_26_26_26_26_26_8_8_26_26_26_26_26_26_26_26_26_26_26_8_26_8_17_17_1_1_17_1_17_17_1_17_17_17_17_17_17_17_17_1_17_17_1_17_17_1_17_1_17_17_1_17_1_3_3_1_1_17_17_17_18_17_1_18_4_18_1_4_4_18_18_3_17
3303,130,1328533200,1,18,3,1328534400,1200,1809540,3083940,1274400,26_26_26_26_26_26_8_8_26_26_26_26_26_26_26_26_26_26_26_8_26_8_17_17_1_1_17_1_17_17_1_17_17_17_17_17_17_17_17_1_17_17_1_17_17_1_17_1_17_17_1_17_1_3_3_1_1_17_17_17_18_17_1_18_4_18_1_4_4_18_18_3_17_1
3304,130,1328534400,3,3,1,1328536800,2400,1810740,3083940,1273200,26_26_26_26_26_26_8_8_26_26_26_26_26_26_26_26_26_26_26_8_26_8_17_17_1_1_17_1_17_17_1_17_17_17_17_17_17_17_17_1_17_17_1_17_17_1_17_1_17_17_1_17_1_3_3_1_1_17_17_17_18_17_1_18_4_18_1_4_4_18_18_3_17_1_3
3305,114,1328534460,1,9,1,1328534520,60,475140,1201080,725940,19_19_19_19_19_19_19_19_19_19_19_19_9_9_1
3306,114,1328534520,1,9,2,1328534580,60,475200,1201080,725880,19_19_19_19_19_19_19_19_19_19_19_19_9_9_1_1
3307,114,1328534580,2,3,2,1328536980,2400,475260,1201080,725820,19_19_19_19_19_19_19_19_19_19_19_19_9_9_1_1_2
3308,173,1328536020,13,17,18,1328539560,3540,544800,3215700,2670900,0_0_0_0_0_0_1_1_0_0_1_1_2_2_3_3_14_14_14_14_14_14_14_18_14_18_18_14_18_18_18_18_13_13_13_14_13_14_18_18_18_14_13_18_13
3309,192,1328536740,0,0,0,1328541120,4380,331980,4648740,4316760,16_16_16_16_16_0_0_16_16_16_16_16_0_0_0_1_1_0_0_0_0_0_0_0_0_0_0_0
3310,130,1328536800,1,18,15,1328536800,0,1813140,3083940,1270800,26_26_26_26_26_26_8_8_26_26_26_26_26_26_26_26_26_26_26_8_26_8_17_17_1_1_17_1_17_17_1_17_17_17_17_17_17_17_17_1_17_17_1_17_17_1_17_1_17_17_1_17_1_3_3_1_1_17_17_17_18_17_1_18_4_18_1_4_4_18_18_3_17_1_3_1
3311,130,1328536800,15,18,4,1328536920,120,1813140,3083940,1270800,26_26_26_26_26_26_8_8_26_26_26_26_26_26_26_26_26_26_26_8_26_8_17_17_1_1_17_1_17_17_1_17_17_17_17_17_17_17_17_1_17_17_1_17_17_1_17_1_17_17_1_17_1_3_3_1_1_17_17_17_18_17_1_18_4_18_1_4_4_18_18_3_17_1_3_1_15
3312,130,1328536920,4,23,4,1328537160,240,1813260,3083940,1270680,26_26_26_26_26_26_8_8_26_26_26_26_26_26_26_26_26_26_26_8_26_8_17_17_1_1_17_1_17_17_1_17_17_17_17_17_17_17_17_1_17_17_1_17_17_1_17_1_17_17_1_17_1_3_3_1_1_17_17_17_18_17_1_18_4_18_1_4_4_18_18_3_17_1_3_1_15_4
3313,114,1328536980,2,3,9,1328538240,1260,477660,1201080,723420,19_19_19_19_19_19_19_19_19_19_19_19_9_9_1_1_2_2
3314,130,1328537160,4,19,3,1328538840,1680,1813500,3083940,1270440,26_26_26_26_26_26_8_8_26_26_26_26_26_26_26_26_26_26_26_8_26_8_17_17_1_1_17_1_17_17_1_17_17_17_17_17_17_17_17_1_17_17_1_17_17_1_17_1_17_17_1_17_1_3_3_1_1_17_17_17_18_17_1_18_4_18_1_4_4_18_18_3_17_1_3_1_15_4_4
3315,114,1328538240,9,4,9,1328540760,2520,478920,1201080,722160,19_19_19_19_19_19_19_19_19_19_19_19_9_9_1_1_2_2_9
3316,130,1328538840,3,3,3,1328540880,2040,1815180,3083940,1268760,26_26_26_26_26_26_8_8_26_26_26_26_26_26_26_26_26_26_26_8_26_8_17_17_1_1_17_1_17_17_1_17_17_17_17_17_17_17_17_1_17_17_1_17_17_1_17_1_17_17_1_17_1_3_3_1_1_17_17_17_18_17_1_18_4_18_1_4_4_18_18_3_17_1_3_1_15_4_4_3
3317,173,1328539560,18,15,6,1328565600,26040,548340,3215700,2667360,0_0_0_0_0_0_1_1_0_0_1_1_2_2_3_3_14_14_14_14_14_14_14_18_14_18_18_14_18_18_18_18_13_13_13_14_13_14_18_18_18_14_13_18_13_18
3318,114,1328540760,9,4,6,1328565600,24840,481440,1201080,719640,19_19_19_19_19_19_19_19_19_19_19_19_9_9_1_1_2_2_9_9
3319,130,1328540880,3,3,18,1328543580,2700,1817220,3083940,1266720,26_26_26_26_26_26_8_8_26_26_26_26_26_26_26_26_26_26_26_8_26_8_17_17_1_1_17_1_17_17_1_17_17_17_17_17_17_17_17_1_17_17_1_17_17_1_17_1_17_17_1_17_1_3_3_1_1_17_17_17_18_17_1_18_4_18_1_4_4_18_18_3_17_1_3_1_15_4_4_3_3
3320,192,1328541120,0,1,0,1328552160,11040,336360,4648740,4312380,16_16_16_16_16_0_0_16_16_16_16_16_0_0_0_1_1_0_0_0_0_0_0_0_0_0_0_0_0
3321,198,1328541720,10,13,10,1328541780,60,34440,708660,674220,10_10
3322,198,1328541780,10,13,10,1328544540,2760,34500,708660,674160,10_10_10
3323,203,1328543340,7,8,7,1328552160,8820,548040,1897500,1349460,7_7_7_7_7_7_7_7_7_7_7_1_1_7_7_7_7_7
3324,130,1328543580,18,22,15,1328544000,420,1819920,3083940,1264020,26_26_26_26_26_26_8_8_26_26_26_26_26_26_26_26_26_26_26_8_26_8_17_17_1_1_17_1_17_17_1_17_17_17_17_17_17_17_17_1_17_17_1_17_17_1_17_1_17_17_1_17_1_3_3_1_1_17_17_17_18_17_1_18_4_18_1_4_4_18_18_3_17_1_3_1_15_4_4_3_3_18
3325,130,1328544000,15,18,18,1328552460,8460,1820340,3083940,1263600,26_26_26_26_26_26_8_8_26_26_26_26_26_26_26_26_26_26_26_8_26_8_17_17_1_1_17_1_17_17_1_17_17_17_17_17_17_17_17_1_17_17_1_17_17_1_17_1_17_17_1_17_1_3_3_1_1_17_17_17_18_17_1_18_4_18_1_4_4_18_18_3_17_1_3_1_15_4_4_3_3_18_15
3326,67,1328544060,5,9,6,1328565600,21540,3044760,3120480,75720,2_3_3_3_2_3_3_3_1_1_27_27_4_4_4_4_4_4_4_5_5_4_4_2_2_3_3_4_4_4_4_4_5_5_4_4_4_4_5_5_5_5_1_1_1_1_5_1_1_5_6_6_5_5
3327,198,1328544540,10,13,1,1328595840,51300,37260,708660,671400,10_10_10_10
3328,137,1328545620,19,1,19,1328564220,18600,0,243720,243720,19
3329,192,1328552160,0,14,0,1328574420,22260,347400,4648740,4301340,16_16_16_16_16_0_0_16_16_16_16_16_0_0_0_1_1_0_0_0_0_0_0_0_0_0_0_0_0_0_0
3330,203,1328552160,7,12,7,1328589060,36900,556860,1897500,1340640,7_7_7_7_7_7_7_7_7_7_7_1_1_7_7_7_7_7_7
3331,192,1328552160,0,1,0,1328552160,0,347400,4648740,4301340,16_16_16_16_16_0_0_16_16_16_16_16_0_0_0_1_1_0_0_0_0_0_0_0_0_0_0_0_0_0
3332,130,1328552460,18,5,4,1328563800,11340,1828800,3083940,1255140,26_26_26_26_26_26_8_8_26_26_26_26_26_26_26_26_26_26_26_8_26_8_17_17_1_1_17_1_17_17_1_17_17_17_17_17_17_17_17_1_17_17_1_17_17_1_17_1_17_17_1_17_1_3_3_1_1_17_17_17_18_17_1_18_4_18_1_4_4_18_18_3_17_1_3_1_15_4_4_3_3_18_15_18
3333,136,1328553480,10,16,10,1328573100,19620,0,646380,646380,10
3334,130,1328563800,4,19,18,1328579040,15240,1840140,3083940,1243800,26_26_26_26_26_26_8_8_26_26_26_26_26_26_26_26_26_26_26_8_26_8_17_17_1_1_17_1_17_17_1_17_17_17_17_17_17_17_17_1_17_17_1_17_17_1_17_1_17_17_1_17_1_3_3_1_1_17_17_17_18_17_1_18_4_18_1_4_4_18_18_3_17_1_3_1_15_4_4_3_3_18_15_18_4
3335,137,1328564220,19,1,19,1328565240,1020,18600,243720,225120,19_19
3336,137,1328565240,19,14,19,1328569200,3960,19620,243720,224100,19_19_19
3337,67,1328565600,6,24,6,1328569200,3600,3066300,3120480,54180,2_3_3_3_2_3_3_3_1_1_27_27_4_4_4_4_4_4_4_5_5_4_4_2_2_3_3_4_4_4_4_4_5_5_4_4_4_4_5_5_5_5_1_1_1_1_5_1_1_5_6_6_5_5_6
3338,173,1328565600,6,24,6,1328569200,3600,574380,3215700,2641320,0_0_0_0_0_0_1_1_0_0_1_1_2_2_3_3_14_14_14_14_14_14_14_18_14_18_18_14_18_18_18_18_13_13_13_14_13_14_18_18_18_14_13_18_13_18_6
3339,23,1328565600,9,4,9,1328565600,0,1027320,1894920,867600,24_24_24_24_8_8_24_24_24_24_24_24_24_24_24_24_24_24_24_24_8_8_7_7_3_3_9_9_9_9_2_2_9
3340,23,1328565600,9,4,9,1328570100,4500,1027320,1894920,867600,24_24_24_24_8_8_24_24_24_24_24_24_24_24_24_24_24_24_24_24_8_8_7_7_3_3_9_9_9_9_2_2_9_9
3341,72,1328565600,6,7,6,1328565600,0,2382360,2385960,3600,17_17_17_1_17_1_17_1_1_17_17_17_17_1_1_17_17_17_38_38_17_17_1_24_24_24_24_1_24_1_1_24_24_24_24_24_8_8_2_2_3_3_3_5_3_5_5_5_5_5_5_5_34_34_5_5_5_5_6_6_6_6_6
3342,72,1328565600,6,7,6,1328569200,3600,2382360,2385960,3600,17_17_17_1_17_1_17_1_1_17_17_17_17_1_1_17_17_17_38_38_17_17_1_24_24_24_24_1_24_1_1_24_24_24_24_24_8_8_2_2_3_3_3_5_3_5_5_5_5_5_5_5_34_34_5_5_5_5_6_6_6_6_6_6
3343,114,1328565600,6,24,6,1328569200,3600,506280,1201080,694800,19_19_19_19_19_19_19_19_19_19_19_19_9_9_1_1_2_2_9_9_6
3344,67,1328569200,6,24,5,1328615280,46080,3069900,3120480,50580,2_3_3_3_2_3_3_3_1_1_27_27_4_4_4_4_4_4_4_5_5_4_4_2_2_3_3_4_4_4_4_4_5_5_4_4_4_4_5_5_5_5_1_1_1_1_5_1_1_5_6_6_5_5_6_6
3345,137,1328569200,19,14,19,1328569200,0,23580,243720,220140,19_19_19_19
3346,137,1328569200,19,14,19,1328589000,19800,23580,243720,220140,19_19_19_19_19
3347,72,1328569200,6,7,99,1328569200,0,2385960,2385960,0,17_17_17_1_17_1_17_1_1_17_17_17_17_1_1_17_17_17_38_38_17_17_1_24_24_24_24_1_24_1_1_24_24_24_24_24_8_8_2_2_3_3_3_5_3_5_5_5_5_5_5_5_34_34_5_5_5_5_6_6_6_6_6_6_6_6
3348,114,1328569200,6,24,19,1328591700,22500,509880,1201080,691200,19_19_19_19_19_19_19_19_19_19_19_19_9_9_1_1_2_2_9_9_6_6
3349,173,1328569200,6,24,5,1328590020,20820,577980,3215700,2637720,0_0_0_0_0_0_1_1_0_0_1_1_2_2_3_3_14_14_14_14_14_14_14_18_14_18_18_14_18_18_18_18_13_13_13_14_13_14_18_18_18_14_13_18_13_18_6_6
3350,72,1328569200,6,7,6,1328569200,0,2385960,2385960,0,17_17_17_1_17_1_17_1_1_17_17_17_17_1_1_17_17_17_38_38_17_17_1_24_24_24_24_1_24_1_1_24_24_24_24_24_8_8_2_2_3_3_3_5_3_5_5_5_5_5_5_5_34_34_5_5_5_5_6_6_6_6_6_6_6
3351,23,1328570100,9,4,9,1328570100,0,1031820,1894920,863100,24_24_24_24_8_8_24_24_24_24_24_24_24_24_24_24_24_24_24_24_8_8_7_7_3_3_9_9_9_9_2_2_9_9_9
3352,23,1328570100,9,4,5,1328614920,44820,1031820,1894920,863100,24_24_24_24_8_8_24_24_24_24_24_24_24_24_24_24_24_24_24_24_8_8_7_7_3_3_9_9_9_9_2_2_9_9_9_9
3353,136,1328573100,10,16,10,1328589780,16680,19620,646380,626760,10_10_10
3354,136,1328573100,10,16,10,1328573100,0,19620,646380,626760,10_10
3355,192,1328574420,0,14,1,1328598000,23580,369660,4648740,4279080,16_16_16_16_16_0_0_16_16_16_16_16_0_0_0_1_1_0_0_0_0_0_0_0_0_0_0_0_0_0_0_0
3356,130,1328579040,18,5,4,1328579040,0,1855380,3083940,1228560,26_26_26_26_26_26_8_8_26_26_26_26_26_26_26_26_26_26_26_8_26_8_17_17_1_1_17_1_17_17_1_17_17_17_17_17_17_17_17_1_17_17_1_17_17_1_17_1_17_17_1_17_1_3_3_1_1_17_17_17_18_17_1_18_4_18_1_4_4_18_18_3_17_1_3_1_15_4_4_3_3_18_15_18_4_18
3357,130,1328579040,4,5,4,1328590440,11400,1855380,3083940,1228560,26_26_26_26_26_26_8_8_26_26_26_26_26_26_26_26_26_26_26_8_26_8_17_17_1_1_17_1_17_17_1_17_17_17_17_17_17_17_17_1_17_17_1_17_17_1_17_1_17_17_1_17_1_3_3_1_1_17_17_17_18_17_1_18_4_18_1_4_4_18_18_3_17_1_3_1_15_4_4_3_3_18_15_18_4_18_4
3358,137,1328589000,19,14,1,1328591040,2040,43380,243720,200340,19_19_19_19_19_19
3359,203,1328589060,7,12,7,1328591460,2400,593760,1897500,1303740,7_7_7_7_7_7_7_7_7_7_7_1_1_7_7_7_7_7_7_7
3360,136,1328589780,10,16,1,1328590200,420,36300,646380,610080,10_10_10_10
3361,173,1328590020,5,6,13,1328591280,1260,598800,3215700,2616900,0_0_0_0_0_0_1_1_0_0_1_1_2_2_3_3_14_14_14_14_14_14_14_18_14_18_18_14_18_18_18_18_13_13_13_14_13_14_18_18_18_14_13_18_13_18_6_6_5
3362,155,1328590200,0,0,0,1328601780,11580,0,3225180,3225180,0
3363,136,1328590200,1,9,1,1328591640,1440,36720,646380,609660,10_10_10_10_1
3364,130,1328590440,4,5,15,1328590800,360,1866780,3083940,1217160,26_26_26_26_26_26_8_8_26_26_26_26_26_26_26_26_26_26_26_8_26_8_17_17_1_1_17_1_17_17_1_17_17_17_17_17_17_17_17_1_17_17_1_17_17_1_17_1_17_17_1_17_1_3_3_1_1_17_17_17_18_17_1_18_4_18_1_4_4_18_18_3_17_1_3_1_15_4_4_3_3_18_15_18_4_18_4_4
3365,130,1328590800,15,18,4,1328590920,120,1867140,3083940,1216800,26_26_26_26_26_26_8_8_26_26_26_26_26_26_26_26_26_26_26_8_26_8_17_17_1_1_17_1_17_17_1_17_17_17_17_17_17_17_17_1_17_17_1_17_17_1_17_1_17_17_1_17_1_3_3_1_1_17_17_17_18_17_1_18_4_18_1_4_4_18_18_3_17_1_3_1_15_4_4_3_3_18_15_18_4_18_4_4_15
3366,98,1328590800,5,2,5,1328596800,6000,2851380,7319880,4468500,34_34_2_2_35_35_34_34_2_2_3_3_3_3_3_3_18_18_3_3_3_18_3_3_3_18_18_18_18_3_3_18_18_18_18_18_18_18_18_3_3_18_39_3_3_39_3_3_3_3_4_4_5_5_5_5_5_5_4_4_4_5_3_5_5_3_5_4_4_4_5_5_5_5_6_6_6_6_5
3367,130,1328590920,4,22,18,1328591100,180,1867260,3083940,1216680,26_26_26_26_26_26_8_8_26_26_26_26_26_26_26_26_26_26_26_8_26_8_17_17_1_1_17_1_17_17_1_17_17_17_17_17_17_17_17_1_17_17_1_17_17_1_17_1_17_17_1_17_1_3_3_1_1_17_17_17_18_17_1_18_4_18_1_4_4_18_18_3_17_1_3_1_15_4_4_3_3_18_15_18_4_18_4_4_15_4
3368,137,1328591040,1,9,1,1328595480,4440,45420,243720,198300,19_19_19_19_19_19_1
3369,130,1328591100,18,23,18,1328593860,2760,1867440,3083940,1216500,26_26_26_26_26_26_8_8_26_26_26_26_26_26_26_26_26_26_26_8_26_8_17_17_1_1_17_1_17_17_1_17_17_17_17_17_17_17_17_1_17_17_1_17_17_1_17_1_17_17_1_17_1_3_3_1_1_17_17_17_18_17_1_18_4_18_1_4_4_18_18_3_17_1_3_1_15_4_4_3_3_18_15_18_4_18_4_4_15_4_18
3370,173,1328591280,13,17,5,1328608020,16740,600060,3215700,2615640,0_0_0_0_0_0_1_1_0_0_1_1_2_2_3_3_14_14_14_14_14_14_14_18_14_18_18_14_18_18_18_18_13_13_13_14_13_14_18_18_18_14_13_18_13_18_6_6_5_13
3371,203,1328591460,7,8,7,1328599260,7800,596160,1897500,1301340,7_7_7_7_7_7_7_7_7_7_7_1_1_7_7_7_7_7_7_7_7
3372,136,1328591640,1,9,10,1328595360,3720,38160,646380,608220,10_10_10_10_1_1
3373,114,1328591700,19,11,3,1328598360,6660,532380,1201080,668700,19_19_19_19_19_19_19_19_19_19_19_19_9_9_1_1_2_2_9_9_6_6_19
3374,130,1328593860,18,23,4,1328622360,28500,1870200,3083940,1213740,26_26_26_26_26_26_8_8_26_26_26_26_26_26_26_26_26_26_26_8_26_8_17_17_1_1_17_1_17_17_1_17_17_17_17_17_17_17_17_1_17_17_1_17_17_1_17_1_17_17_1_17_1_3_3_1_1_17_17_17_18_17_1_18_4_18_1_4_4_18_18_3_17_1_3_1_15_4_4_3_3_18_15_18_4_18_4_4_15_4_18_18
3375,110,1328594460,18,23,18,1328598360,3900,3052860,5579400,2526540,1_1_0_0_1_1_1_1_2_2_2_2_4_4_4_4_4_4_4_4_4_4_4_4_4_4_4_4_4_4_4_4_4_4_4_4_4_4_4_4_4_4_4_4_4_4_4_4_4_4_4_4_5_5_6_6_5_5_5_5_18
3376,136,1328595360,10,13,10,1328611140,15780,41880,646380,604500,10_10_10_10_1_1_10
3377,137,1328595480,1,9,1,1328601900,6420,49860,243720,193860,19_19_19_19_19_19_1_1
3378,198,1328595840,1,9,1,1328601000,5160,88560,708660,620100,10_10_10_10_1
3379,98,1328596800,5,2,5,1328605200,8400,2857380,7319880,4462500,34_34_2_2_35_35_34_34_2_2_3_3_3_3_3_3_18_18_3_3_3_18_3_3_3_18_18_18_18_3_3_18_18_18_18_18_18_18_18_3_3_18_39_3_3_39_3_3_3_3_4_4_5_5_5_5_5_5_4_4_4_5_3_5_5_3_5_4_4_4_5_5_5_5_6_6_6_6_5_5
3380,192,1328598000,1,2,1,1328609400,11400,393240,4648740,4255500,16_16_16_16_16_0_0_16_16_16_16_16_0_0_0_1_1_0_0_0_0_0_0_0_0_0_0_0_0_0_0_0_1
3381,110,1328598360,18,23,18,1328598420,60,3056760,5579400,2522640,1_1_0_0_1_1_1_1_2_2_2_2_4_4_4_4_4_4_4_4_4_4_4_4_4_4_4_4_4_4_4_4_4_4_4_4_4_4_4_4_4_4_4_4_4_4_4_4_4_4_4_4_5_5_6_6_5_5_5_5_18_18
3382,114,1328598360,3,3,19,1328599020,660,539040,1201080,662040,19_19_19_19_19_19_19_19_19_19_19_19_9_9_1_1_2_2_9_9_6_6_19_3
3383,110,1328598420,18,23,18,1328604300,5880,3056820,5579400,2522580,1_1_0_0_1_1_1_1_2_2_2_2_4_4_4_4_4_4_4_4_4_4_4_4_4_4_4_4_4_4_4_4_4_4_4_4_4_4_4_4_4_4_4_4_4_4_4_4_4_4_4_4_5_5_6_6_5_5_5_5_18_18_18
3384,114,1328599020,19,11,19,1328599080,60,539700,1201080,661380,19_19_19_19_19_19_19_19_19_19_19_19_9_9_1_1_2_2_9_9_6_6_19_3_19
3385,114,1328599080,19,11,3,1328601540,2460,539760,1201080,661320,19_19_19_19_19_19_19_19_19_19_19_19_9_9_1_1_2_2_9_9_6_6_19_3_19_19
3386,203,1328599260,7,8,17,1328599260,0,603960,1897500,1293540,7_7_7_7_7_7_7_7_7_7_7_1_1_7_7_7_7_7_7_7_7_7
3387,203,1328599260,17,8,17,1328622180,22920,603960,1897500,1293540,7_7_7_7_7_7_7_7_7_7_7_1_1_7_7_7_7_7_7_7_7_7_17
3388,198,1328601000,1,9,9,1328997600,396600,93720,708660,614940,10_10_10_10_1_1
3389,71,1328601240,7,10,7,1328624220,22980,2339640,3996240,1656600,29_29_1_1_7
3390,114,1328601540,3,3,5,1328603100,1560,542220,1201080,658860,19_19_19_19_19_19_19_19_19_19_19_19_9_9_1_1_2_2_9_9_6_6_19_3_19_19_3
3391,155,1328601780,0,0,0,1328606100,4320,11580,3225180,3213600,0_0
3392,137,1328601900,1,9,1,1328602080,180,56280,243720,187440,19_19_19_19_19_19_1_1_1
3393,137,1328602080,1,9,2,1328602380,300,56460,243720,187260,19_19_19_19_19_19_1_1_1_1
3394,137,1328602380,2,3,2,1328605380,3000,56760,243720,186960,19_19_19_19_19_19_1_1_1_1_2
3395,114,1328603100,5,9,5,1328614800,11700,543780,1201080,657300,19_19_19_19_19_19_19_19_19_19_19_19_9_9_1_1_2_2_9_9_6_6_19_3_19_19_3_5
3396,110,1328604300,18,23,18,1328604360,60,3062700,5579400,2516700,1_1_0_0_1_1_1_1_2_2_2_2_4_4_4_4_4_4_4_4_4_4_4_4_4_4_4_4_4_4_4_4_4_4_4_4_4_4_4_4_4_4_4_4_4_4_4_4_4_4_4_4_5_5_6_6_5_5_5_5_18_18_18_18
3397,110,1328604360,18,23,18,1328612460,8100,3062760,5579400,2516640,1_1_0_0_1_1_1_1_2_2_2_2_4_4_4_4_4_4_4_4_4_4_4_4_4_4_4_4_4_4_4_4_4_4_4_4_4_4_4_4_4_4_4_4_4_4_4_4_4_4_4_4_5_5_6_6_5_5_5_5_18_18_18_18_18
3398,98,1328605200,5,2,5,1328609400,4200,2865780,7319880,4454100,34_34_2_2_35_35_34_34_2_2_3_3_3_3_3_3_18_18_3_3_3_18_3_3_3_18_18_18_18_3_3_18_18_18_18_18_18_18_18_3_3_18_39_3_3_39_3_3_3_3_4_4_5_5_5_5_5_5_4_4_4_5_3_5_5_3_5_4_4_4_5_5_5_5_6_6_6_6_5_5_5
3399,137,1328605380,2,3,9,1328605440,60,59760,243720,183960,19_19_19_19_19_19_1_1_1_1_2_2
3400,137,1328605440,9,3,9,1328606700,1260,59820,243720,183900,19_19_19_19_19_19_1_1_1_1_2_2_9
3401,155,1328606100,0,0,0,1328616900,10800,15900,3225180,3209280,0_0_0
3402,137,1328606700,9,4,9,1328609880,3180,61080,243720,182640,19_19_19_19_19_19_1_1_1_1_2_2_9_9_9
3403,137,1328606700,9,3,9,1328606700,0,61080,243720,182640,19_19_19_19_19_19_1_1_1_1_2_2_9_9
3404,173,1328608020,5,6,13,1328614620,6600,616800,3215700,2598900,0_0_0_0_0_0_1_1_0_0_1_1_2_2_3_3_14_14_14_14_14_14_14_18_14_18_18_14_18_18_18_18_13_13_13_14_13_14_18_18_18_14_13_18_13_18_6_6_5_13_5
3405,148,1328608800,3,3,3,1328616000,7200,1744500,1938900,194400,7_7_7_7_7_1_7_1_9_9_2_2_3
3406,98,1328609400,5,2,5,1328611800,2400,2869980,7319880,4449900,34_34_2_2_35_35_34_34_2_2_3_3_3_3_3_3_18_18_3_3_3_18_3_3_3_18_18_18_18_3_3_18_18_18_18_18_18_18_18_3_3_18_39_3_3_39_3_3_3_3_4_4_5_5_5_5_5_5_4_4_4_5_3_5_5_3_5_4_4_4_5_5_5_5_6_6_6_6_5_5_5_5
3407,192,1328609400,1,2,2,1328684700,75300,404640,4648740,4244100,16_16_16_16_16_0_0_16_16_16_16_16_0_0_0_1_1_0_0_0_0_0_0_0_0_0_0_0_0_0_0_0_1_1
3408,137,1328609880,9,4,9,1328609940,60,64260,243720,179460,19_19_19_19_19_19_1_1_1_1_2_2_9_9_9_9
3409,137,1328609940,9,4,3,1328610180,240,64320,243720,179400,19_19_19_19_19_19_1_1_1_1_2_2_9_9_9_9_9
3410,137,1328610180,3,3,9,1328610780,600,64560,243720,179160,19_19_19_19_19_19_1_1_1_1_2_2_9_9_9_9_9_3
3411,166,1328610600,3,3,3,1328612400,1800,1141200,1666080,524880,7_7_7_1_7_7_1_7_7_7_21_21_1_1_2_2_3
3412,137,1328610780,9,4,3,1328614740,3960,65160,243720,178560,19_19_19_19_19_19_1_1_1_1_2_2_9_9_9_9_9_3_9
3413,136,1328611140,10,13,1,1328613600,2460,57660,646380,588720,10_10_10_10_1_1_10_10
3414,184,1328611200,10,13,10,1328622180,10980,114000,1800900,1686900,10_10_10_10_10
3415,98,1328611800,5,2,5,1328613600,1800,2872380,7319880,4447500,34_34_2_2_35_35_34_34_2_2_3_3_3_3_3_3_18_18_3_3_3_18_3_3_3_18_18_18_18_3_3_18_18_18_18_18_18_18_18_3_3_18_39_3_3_39_3_3_3_3_4_4_5_5_5_5_5_5_4_4_4_5_3_5_5_3_5_4_4_4_5_5_5_5_6_6_6_6_5_5_5_5_5_5
3416,98,1328611800,5,2,5,1328611800,0,2872380,7319880,4447500,34_34_2_2_35_35_34_34_2_2_3_3_3_3_3_3_18_18_3_3_3_18_3_3_3_18_18_18_18_3_3_18_18_18_18_18_18_18_18_3_3_18_39_3_3_39_3_3_3_3_4_4_5_5_5_5_5_5_4_4_4_5_3_5_5_3_5_4_4_4_5_5_5_5_6_6_6_6_5_5_5_5_5
3417,147,1328612400,3,3,3,1328614200,1800,1229520,1479360,249840,7_7_7_7_7_7_7_1_7_1_9_9_1_2_2_1_3
3418,166,1328612400,3,3,4,1328677200,64800,1143000,1666080,523080,7_7_7_1_7_7_1_7_7_7_21_21_1_1_2_2_3_3
3419,110,1328612460,18,23,5,1329663720,1051260,3070860,5579400,2508540,1_1_0_0_1_1_1_1_2_2_2_2_4_4_4_4_4_4_4_4_4_4_4_4_4_4_4_4_4_4_4_4_4_4_4_4_4_4_4_4_4_4_4_4_4_4_4_4_4_4_4_4_5_5_6_6_5_5_5_5_18_18_18_18_18_18
3420,77,1328612520,18,23,18,1328617020,4500,2004360,3257040,1252680,0_0_1_0_0_1_0_0_0_0_0_0_0_0_0_0_0_0_1_0_1_0_2_2_4_4_4_4_4_4_4_4_4_4_4_4_4_4_1_1_18
3421,98,1328613600,5,2,5,1328618400,4800,2874180,7319880,4445700,34_34_2_2_35_35_34_34_2_2_3_3_3_3_3_3_18_18_3_3_3_18_3_3_3_18_18_18_18_3_3_18_18_18_18_18_18_18_18_3_3_18_39_3_3_39_3_3_3_3_4_4_5_5_5_5_5_5_4_4_4_5_3_5_5_3_5_4_4_4_5_5_5_5_6_6_6_6_5_5_5_5_5_5_5_5
3422,98,1328613600,5,2,5,1328613600,0,2874180,7319880,4445700,34_34_2_2_35_35_34_34_2_2_3_3_3_3_3_3_18_18_3_3_3_18_3_3_3_18_18_18_18_3_3_18_18_18_18_18_18_18_18_3_3_18_39_3_3_39_3_3_3_3_4_4_5_5_5_5_5_5_4_4_4_5_3_5_5_3_5_4_4_4_5_5_5_5_6_6_6_6_5_5_5_5_5_5_5
3423,136,1328613600,1,9,1,1328614860,1260,60120,646380,586260,10_10_10_10_1_1_10_10_1
3424,147,1328614200,3,3,4,1328699880,85680,1231320,1479360,248040,7_7_7_7_7_7_7_1_7_1_9_9_1_2_2_1_3_3
3425,173,1328614620,13,17,6,1329084000,469380,623400,3215700,2592300,0_0_0_0_0_0_1_1_0_0_1_1_2_2_3_3_14_14_14_14_14_14_14_18_14_18_18_14_18_18_18_18_13_13_13_14_13_14_18_18_18_14_13_18_13_18_6_6_5_13_5_13
3426,137,1328614740,3,3,3,1328614800,60,69120,243720,174600,19_19_19_19_19_19_1_1_1_1_2_2_9_9_9_9_9_3_9_3
3427,137,1328614800,3,3,14,1328614860,60,69180,243720,174540,19_19_19_19_19_19_1_1_1_1_2_2_9_9_9_9_9_3_9_3_3
3428,114,1328614800,5,9,5,1328615100,300,555480,1201080,645600,19_19_19_19_19_19_19_19_19_19_19_19_9_9_1_1_2_2_9_9_6_6_19_3_19_19_3_5_5
3429,137,1328614860,14,17,3,1328620680,5820,69240,243720,174480,19_19_19_19_19_19_1_1_1_1_2_2_9_9_9_9_9_3_9_3_3_14
3430,136,1328614860,1,9,9,1328652000,37140,61380,646380,585000,10_10_10_10_1_1_10_10_1_1
3431,23,1328614920,5,9,2,1328615280,360,1076640,1894920,818280,24_24_24_24_8_8_24_24_24_24_24_24_24_24_24_24_24_24_24_24_8_8_7_7_3_3_9_9_9_9_2_2_9_9_9_9_5
3432,114,1328615100,5,9,1,1328618040,2940,555780,1201080,645300,19_19_19_19_19_19_19_19_19_19_19_19_9_9_1_1_2_2_9_9_6_6_19_3_19_19_3_5_5_5
3433,23,1328615280,2,3,9,1328615460,180,1077000,1894920,817920,24_24_24_24_8_8_24_24_24_24_24_24_24_24_24_24_24_24_24_24_8_8_7_7_3_3_9_9_9_9_2_2_9_9_9_9_5_2
3434,67,1328615280,5,9,5,1328619780,4500,3115980,3120480,4500,2_3_3_3_2_3_3_3_1_1_27_27_4_4_4_4_4_4_4_5_5_4_4_2_2_3_3_4_4_4_4_4_5_5_4_4_4_4_5_5_5_5_1_1_1_1_5_1_1_5_6_6_5_5_6_6_5
3435,23,1328615460,9,4,9,1328615520,60,1077180,1894920,817740,24_24_24_24_8_8_24_24_24_24_24_24_24_24_24_24_24_24_24_24_8_8_7_7_3_3_9_9_9_9_2_2_9_9_9_9_5_2_9
3436,23,1328615520,9,4,9,1328615520,0,1077240,1894920,817680,24_24_24_24_8_8_24_24_24_24_24_24_24_24_24_24_24_24_24_24_8_8_7_7_3_3_9_9_9_9_2_2_9_9_9_9_5_2_9_9
3437,23,1328615520,9,4,9,1328622180,6660,1077240,1894920,817680,24_24_24_24_8_8_24_24_24_24_24_24_24_24_24_24_24_24_24_24_8_8_7_7_3_3_9_9_9_9_2_2_9_9_9_9_5_2_9_9_9
3438,148,1328616000,3,3,14,1328625000,9000,1751700,1938900,187200,7_7_7_7_7_1_7_1_9_9_2_2_3_3
3439,155,1328616900,0,0,0,1328617080,180,26700,3225180,3198480,0_0_0_0
3440,77,1328617020,18,23,18,1328617140,120,2008860,3257040,1248180,0_0_1_0_0_1_0_0_0_0_0_0_0_0_0_0_0_0_1_0_1_0_2_2_4_4_4_4_4_4_4_4_4_4_4_4_4_4_1_1_18_18
3441,155,1328617080,0,0,0,1328622480,5400,26880,3225180,3198300,0_0_0_0_0
3442,77,1328617140,18,23,18,1328629320,12180,2008980,3257040,1248060,0_0_1_0_0_1_0_0_0_0_0_0_0_0_0_0_0_0_1_0_1_0_2_2_4_4_4_4_4_4_4_4_4_4_4_4_4_4_1_1_18_18_18
3443,114,1328618040,1,9,1,1328618100,60,558720,1201080,642360,19_19_19_19_19_19_19_19_19_19_19_19_9_9_1_1_2_2_9_9_6_6_19_3_19_19_3_5_5_5_1
3444,114,1328618100,1,9,5,1328619600,1500,558780,1201080,642300,19_19_19_19_19_19_19_19_19_19_19_19_9_9_1_1_2_2_9_9_6_6_19_3_19_19_3_5_5_5_1_1
3445,98,1328618400,5,2,5,1328623800,5400,2878980,7319880,4440900,34_34_2_2_35_35_34_34_2_2_3_3_3_3_3_3_18_18_3_3_3_18_3_3_3_18_18_18_18_3_3_18_18_18_18_18_18_18_18_3_3_18_39_3_3_39_3_3_3_3_4_4_5_5_5_5_5_5_4_4_4_5_3_5_5_3_5_4_4_4_5_5_5_5_6_6_6_6_5_5_5_5_5_5_5_5_5
3446,114,1328619600,5,9,19,1328622420,2820,560280,1201080,640800,19_19_19_19_19_19_19_19_19_19_19_19_9_9_1_1_2_2_9_9_6_6_19_3_19_19_3_5_5_5_1_1_5
3447,67,1328619780,5,9,99,1328619780,0,3120480,3120480,0,2_3_3_3_2_3_3_3_1_1_27_27_4_4_4_4_4_4_4_5_5_4_4_2_2_3_3_4_4_4_4_4_5_5_4_4_4_4_5_5_5_5_1_1_1_1_5_1_1_5_6_6_5_5_6_6_5_5
3448,137,1328620680,3,3,14,1328623740,3060,75060,243720,168660,19_19_19_19_19_19_1_1_1_1_2_2_9_9_9_9_9_3_9_3_3_14_3
3449,96,1328620740,3,3,3,1328623740,3000,1310940,2123400,812460,10_1_10_10_10_10_1_10_10_10_10_10_1_1_2_2_9_9_9_9_9_9_3_3_5_5_9_9_9_9_9_9_5_5_6_6_9_9_3
3450,203,1328622180,17,8,17,1328638620,16440,626880,1897500,1270620,7_7_7_7_7_7_7_7_7_7_7_1_1_7_7_7_7_7_7_7_7_7_17_17
3451,184,1328622180,10,13,10,1328623200,1020,124980,1800900,1675920,10_10_10_10_10_10
3452,23,1328622180,9,4,5,1328623500,1320,1083900,1894920,811020,24_24_24_24_8_8_24_24_24_24_24_24_24_24_24_24_24_24_24_24_8_8_7_7_3_3_9_9_9_9_2_2_9_9_9_9_5_2_9_9_9_9
3453,130,1328622360,4,22,15,1328623200,840,1898700,3083940,1185240,26_26_26_26_26_26_8_8_26_26_26_26_26_26_26_26_26_26_26_8_26_8_17_17_1_1_17_1_17_17_1_17_17_17_17_17_17_17_17_1_17_17_1_17_17_1_17_1_17_17_1_17_1_3_3_1_1_17_17_17_18_17_1_18_4_18_1_4_4_18_18_3_17_1_3_1_15_4_4_3_3_18_15_18_4_18_4_4_15_4_18_18_4
3454,114,1328622420,19,11,2,1329027660,405240,563100,1201080,637980,19_19_19_19_19_19_19_19_19_19_19_19_9_9_1_1_2_2_9_9_6_6_19_3_19_19_3_5_5_5_1_1_5_19
3455,155,1328622480,0,0,0,1328638020,15540,32280,3225180,3192900,0_0_0_0_0_0
3456,130,1328623200,15,18,4,1328623860,660,1899540,3083940,1184400,26_26_26_26_26_26_8_8_26_26_26_26_26_26_26_26_26_26_26_8_26_8_17_17_1_1_17_1_17_17_1_17_17_17_17_17_17_17_17_1_17_17_1_17_17_1_17_1_17_17_1_17_1_3_3_1_1_17_17_17_18_17_1_18_4_18_1_4_4_18_18_3_17_1_3_1_15_4_4_3_3_18_15_18_4_18_4_4_15_4_18_18_4_15
3457,184,1328623200,10,13,10,1328633520,10320,126000,1800900,1674900,10_10_10_10_10_10_10
3458,23,1328623500,5,9,2,1328625480,1980,1085220,1894920,809700,24_24_24_24_8_8_24_24_24_24_24_24_24_24_24_24_24_24_24_24_8_8_7_7_3_3_9_9_9_9_2_2_9_9_9_9_5_2_9_9_9_9_5
3459,96,1328623740,3,3,5,1329207300,583560,1313940,2123400,809460,10_1_10_10_10_10_1_10_10_10_10_10_1_1_2_2_9_9_9_9_9_9_3_3_5_5_9_9_9_9_9_9_5_5_6_6_9_9_3_3
3460,137,1328623740,14,17,14,1328623740,0,78120,243720,165600,19_19_19_19_19_19_1_1_1_1_2_2_9_9_9_9_9_3_9_3_3_14_3_14
3461,137,1328623740,14,15,14,1328646180,22440,78120,243720,165600,19_19_19_19_19_19_1_1_1_1_2_2_9_9_9_9_9_3_9_3_3_14_3_14_14
3462,98,1328623800,5,2,5,1328865000,241200,2884380,7319880,4435500,34_34_2_2_35_35_34_34_2_2_3_3_3_3_3_3_18_18_3_3_3_18_3_3_3_18_18_18_18_3_3_18_18_18_18_18_18_18_18_3_3_18_39_3_3_39_3_3_3_3_4_4_5_5_5_5_5_5_4_4_4_5_3_5_5_3_5_4_4_4_5_5_5_5_6_6_6_6_5_5_5_5_5_5_5_5_5_5
3463,130,1328623860,4,19,4,1328634000,10140,1900200,3083940,1183740,26_26_26_26_26_26_8_8_26_26_26_26_26_26_26_26_26_26_26_8_26_8_17_17_1_1_17_1_17_17_1_17_17_17_17_17_17_17_17_1_17_17_1_17_17_1_17_1_17_17_1_17_1_3_3_1_1_17_17_17_18_17_1_18_4_18_1_4_4_18_18_3_17_1_3_1_15_4_4_3_3_18_15_18_4_18_4_4_15_4_18_18_4_15_4
3464,71,1328624220,7,10,1,1328677500,53280,2362620,3996240,1633620,29_29_1_1_7_7
3465,148,1328625000,14,17,14,1328629500,4500,1760700,1938900,178200,7_7_7_7_7_1_7_1_9_9_2_2_3_3_14
3466,23,1328625480,2,3,5,1329141000,515520,1087200,1894920,807720,24_24_24_24_8_8_24_24_24_24_24_24_24_24_24_24_24_24_24_24_8_8_7_7_3_3_9_9_9_9_2_2_9_9_9_9_5_2_9_9_9_9_5_2
3467,165,1328626200,9,4,9,1328629500,3300,675900,1262880,586980,24_24_24_24_24_24_24_24_24_24_24_24_8_8_9
3468,77,1328629320,18,23,18,1328637660,8340,2021160,3257040,1235880,0_0_1_0_0_1_0_0_0_0_0_0_0_0_0_0_0_0_1_0_1_0_2_2_4_4_4_4_4_4_4_4_4_4_4_4_4_4_1_1_18_18_18_18
3469,165,1328629500,9,4,2,1328687820,58320,679200,1262880,583680,24_24_24_24_24_24_24_24_24_24_24_24_8_8_9_9
3470,148,1328629500,14,17,13,1328646240,16740,1765200,1938900,173700,7_7_7_7_7_1_7_1_9_9_2_2_3_3_14_14
3471,184,1328633520,10,13,10,1328639220,5700,136320,1800900,1664580,10_10_10_10_10_10_10_10
3472,130,1328634000,4,19,4,1328634060,60,1910340,3083940,1173600,26_26_26_26_26_26_8_8_26_26_26_26_26_26_26_26_26_26_26_8_26_8_17_17_1_1_17_1_17_17_1_17_17_17_17_17_17_17_17_1_17_17_1_17_17_1_17_1_17_17_1_17_1_3_3_1_1_17_17_17_18_17_1_18_4_18_1_4_4_18_18_3_17_1_3_1_15_4_4_3_3_18_15_18_4_18_4_4_15_4_18_18_4_15_4_4
3473,130,1328634060,4,19,4,1328651040,16980,1910400,3083940,1173540,26_26_26_26_26_26_8_8_26_26_26_26_26_26_26_26_26_26_26_8_26_8_17_17_1_1_17_1_17_17_1_17_17_17_17_17_17_17_17_1_17_17_1_17_17_1_17_1_17_17_1_17_1_3_3_1_1_17_17_17_18_17_1_18_4_18_1_4_4_18_18_3_17_1_3_1_15_4_4_3_3_18_15_18_4_18_4_4_15_4_18_18_4_15_4_4_4
3474,77,1328637660,18,5,18,1328659260,21600,2029500,3257040,1227540,0_0_1_0_0_1_0_0_0_0_0_0_0_0_0_0_0_0_1_0_1_0_2_2_4_4_4_4_4_4_4_4_4_4_4_4_4_4_1_1_18_18_18_18_18
3475,155,1328638020,0,14,0,1328670720,32700,47820,3225180,3177360,0_0_0_0_0_0_0
3476,203,1328638620,17,12,17,1328652000,13380,643320,1897500,1254180,7_7_7_7_7_7_7_7_7_7_7_1_1_7_7_7_7_7_7_7_7_7_17_17_17
3477,184,1328639220,10,16,10,1328665080,25860,142020,1800900,1658880,10_10_10_10_10_10_10_10_10
3478,137,1328646180,14,15,5,1328697840,51660,100560,243720,143160,19_19_19_19_19_19_1_1_1_1_2_2_9_9_9_9_9_3_9_3_3_14_3_14_14_14
3479,148,1328646240,13,15,13,1328648580,2340,1781940,1938900,156960,7_7_7_7_7_1_7_1_9_9_2_2_3_3_14_14_13
3480,148,1328648580,13,15,13,1328648640,60,1784280,1938900,154620,7_7_7_7_7_1_7_1_9_9_2_2_3_3_14_14_13_13
3481,148,1328648640,13,15,13,1328651160,2520,1784340,1938900,154560,7_7_7_7_7_1_7_1_9_9_2_2_3_3_14_14_13_13_13
3482,130,1328651040,4,19,4,1328652060,1020,1927380,3083940,1156560,26_26_26_26_26_26_8_8_26_26_26_26_26_26_26_26_26_26_26_8_26_8_17_17_1_1_17_1_17_17_1_17_17_17_17_17_17_17_17_1_17_17_1_17_17_1_17_1_17_17_1_17_1_3_3_1_1_17_17_17_18_17_1_18_4_18_1_4_4_18_18_3_17_1_3_1_15_4_4_3_3_18_15_18_4_18_4_4_15_4_18_18_4_15_4_4_4_4
3483,148,1328651160,13,15,13,1328677860,26700,1786860,1938900,152040,7_7_7_7_7_1_7_1_9_9_2_2_3_3_14_14_13_13_13_13
3484,203,1328652000,4,5,17,1328652000,0,656700,1897500,1240800,7_7_7_7_7_7_7_7_7_7_7_1_1_7_7_7_7_7_7_7_7_7_17_17_17_17_4
3485,203,1328652000,17,12,4,1328652000,0,656700,1897500,1240800,7_7_7_7_7_7_7_7_7_7_7_1_1_7_7_7_7_7_7_7_7_7_17_17_17_17
3486,136,1328652000,9,4,9,1328656500,4500,98520,646380,547860,10_10_10_10_1_1_10_10_1_1_9
3487,203,1328652000,17,12,4,1328657400,5400,656700,1897500,1240800,7_7_7_7_7_7_7_7_7_7_7_1_1_7_7_7_7_7_7_7_7_7_17_17_17_17_4_17
3488,130,1328652060,4,5,4,1328665680,13620,1928400,3083940,1155540,26_26_26_26_26_26_8_8_26_26_26_26_26_26_26_26_26_26_26_8_26_8_17_17_1_1_17_1_17_17_1_17_17_17_17_17_17_17_17_1_17_17_1_17_17_1_17_1_17_17_1_17_1_3_3_1_1_17_17_17_18_17_1_18_4_18_1_4_4_18_18_3_17_1_3_1_15_4_4_3_3_18_15_18_4_18_4_4_15_4_18_18_4_15_4_4_4_4_4
3489,136,1328656500,9,4,2,1328689260,32760,103020,646380,543360,10_10_10_10_1_1_10_10_1_1_9_9
3490,203,1328657400,4,5,4,1328673600,16200,662100,1897500,1235400,7_7_7_7_7_7_7_7_7_7_7_1_1_7_7_7_7_7_7_7_7_7_17_17_17_17_4_17_4_4
3491,203,1328657400,4,5,4,1328657400,0,662100,1897500,1235400,7_7_7_7_7_7_7_7_7_7_7_1_1_7_7_7_7_7_7_7_7_7_17_17_17_17_4_17_4
3492,77,1328659260,18,5,5,1329804840,1145580,2051100,3257040,1205940,0_0_1_0_0_1_0_0_0_0_0_0_0_0_0_0_0_0_1_0_1_0_2_2_4_4_4_4_4_4_4_4_4_4_4_4_4_4_1_1_18_18_18_18_18_18
3493,184,1328665080,10,16,10,1328665140,60,167880,1800900,1633020,10_10_10_10_10_10_10_10_10_10
3494,184,1328665140,10,16,10,1328676240,11100,167940,1800900,1632960,10_10_10_10_10_10_10_10_10_10_10
3495,130,1328665680,4,5,15,1328684820,19140,1942020,3083940,1141920,26_26_26_26_26_26_8_8_26_26_26_26_26_26_26_26_26_26_26_8_26_8_17_17_1_1_17_1_17_17_1_17_17_17_17_17_17_17_17_1_17_17_1_17_17_1_17_1_17_17_1_17_1_3_3_1_1_17_17_17_18_17_1_18_4_18_1_4_4_18_18_3_17_1_3_1_15_4_4_3_3_18_15_18_4_18_4_4_15_4_18_18_4_15_4_4_4_4_4_4
3496,86,1328665800,18,5,18,1328668800,3000,2319780,3519180,1199400,0_0_0_0_1_0_0_0_0_1_0_0_0_0_1_1_0_0_1_1_1_1_1_1_2_2_4_4_4_4_4_4_4_4_4_4_18
3497,86,1328668800,18,5,18,1328668800,0,2322780,3519180,1196400,0_0_0_0_1_0_0_0_0_1_0_0_0_0_1_1_0_0_1_1_1_1_1_1_2_2_4_4_4_4_4_4_4_4_4_4_18_18
3498,86,1328668800,18,5,18,1328676900,8100,2322780,3519180,1196400,0_0_0_0_1_0_0_0_0_1_0_0_0_0_1_1_0_0_1_1_1_1_1_1_2_2_4_4_4_4_4_4_4_4_4_4_18_18_18
3499,155,1328670720,0,14,1,1329109200,438480,80520,3225180,3144660,0_0_0_0_0_0_0_0
3500,188,1328672040,0,14,0,1328675520,3480,0,4327560,4327560,0
3501,203,1328673600,4,5,17,1328675400,1800,678300,1897500,1219200,7_7_7_7_7_7_7_7_7_7_7_1_1_7_7_7_7_7_7_7_7_7_17_17_17_17_4_17_4_4_4
3502,203,1328675400,17,12,17,1328694000,18600,680100,1897500,1217400,7_7_7_7_7_7_7_7_7_7_7_1_1_7_7_7_7_7_7_7_7_7_17_17_17_17_4_17_4_4_4_17
3503,188,1328675520,0,14,0,1328748540,73020,3480,4327560,4324080,0_0
3504,184,1328676240,10,16,1,1328676600,360,179040,1800900,1621860,10_10_10_10_10_10_10_10_10_10_10_10
3505,184,1328676600,1,9,10,1328677200,600,179400,1800900,1621500,10_10_10_10_10_10_10_10_10_10_10_10_1_1
3506,184,1328676600,1,9,1,1328676600,0,179400,1800900,1621500,10_10_10_10_10_10_10_10_10_10_10_10_1
3507,86,1328676900,18,5,1,1328677200,300,2330880,3519180,1188300,0_0_0_0_1_0_0_0_0_1_0_0_0_0_1_1_0_0_1_1_1_1_1_1_2_2_4_4_4_4_4_4_4_4_4_4_18_18_18_18
3508,199,1328676960,0,0,0,1328677440,480,0,975720,975720,0
3509,166,1328677200,4,23,4,1328688420,11220,1207800,1666080,458280,7_7_7_1_7_7_1_7_7_7_21_21_1_1_2_2_3_3_4
3510,184,1328677200,10,13,1,1328677560,360,180000,1800900,1620900,10_10_10_10_10_10_10_10_10_10_10_10_1_1_10
3511,116,1328677200,19,11,19,1328703540,26340,0,786600,786600,19
3512,86,1328677200,1,9,18,1328677680,480,2331180,3519180,1188000,0_0_0_0_1_0_0_0_0_1_0_0_0_0_1_1_0_0_1_1_1_1_1_1_2_2_4_4_4_4_4_4_4_4_4_4_18_18_18_18_1
3513,199,1328677440,0,0,0,1328678520,1080,480,975720,975240,0_0
3514,71,1328677500,1,18,7,1328678220,720,2415900,3996240,1580340,29_29_1_1_7_7_1
3515,184,1328677560,1,9,1,1328705040,27480,180360,1800900,1620540,10_10_10_10_10_10_10_10_10_10_10_10_1_1_10_1
3516,86,1328677680,18,22,1,1328679000,1320,2331660,3519180,1187520,0_0_0_0_1_0_0_0_0_1_0_0_0_0_1_1_0_0_1_1_1_1_1_1_2_2_4_4_4_4_4_4_4_4_4_4_18_18_18_18_1_18
3517,148,1328677860,13,17,13,1328693400,15540,1813560,1938900,125340,7_7_7_7_7_1_7_1_9_9_2_2_3_3_14_14_13_13_13_13_13
3518,71,1328678220,7,10,1,1328683200,4980,2416620,3996240,1579620,29_29_1_1_7_7_1_7
3519,199,1328678520,0,20,0,1328711640,33120,1560,975720,974160,0_0_0
3520,86,1328679000,1,9,18,1328687820,8820,2332980,3519180,1186200,0_0_0_0_1_0_0_0_0_1_0_0_0_0_1_1_0_0_1_1_1_1_1_1_2_2_4_4_4_4_4_4_4_4_4_4_18_18_18_18_1_18_1
3521,71,1328683200,1,18,7,1328683260,60,2421600,3996240,1574640,29_29_1_1_7_7_1_7_1
3522,71,1328683260,7,10,7,1328683380,120,2421660,3996240,1574580,29_29_1_1_7_7_1_7_1_7
3523,71,1328683380,7,10,7,1328708760,25380,2421780,3996240,1574460,29_29_1_1_7_7_1_7_1_7_7
3524,192,1328684700,2,8,2,1328686380,1680,479940,4648740,4168800,16_16_16_16_16_0_0_16_16_16_16_16_0_0_0_1_1_0_0_0_0_0_0_0_0_0_0_0_0_0_0_0_1_1_2
3525,130,1328684820,15,18,15,1328709720,24900,1961160,3083940,1122780,26_26_26_26_26_26_8_8_26_26_26_26_26_26_26_26_26_26_26_8_26_8_17_17_1_1_17_1_17_17_1_17_17_17_17_17_17_17_17_1_17_17_1_17_17_1_17_1_17_17_1_17_1_3_3_1_1_17_17_17_18_17_1_18_4_18_1_4_4_18_18_3_17_1_3_1_15_4_4_3_3_18_15_18_4_18_4_4_15_4_18_18_4_15_4_4_4_4_4_4_15
3526,84,1328685240,5,6,5,1328692440,7200,3026340,3714840,688500,17_17_17_17_17_17_17_17_17_17_17_17_17_17_17_17_1_1_2_2_3_3_18_18_18_18_18_18_5
3527,141,1328686080,3,3,3,1328687820,1740,3032880,7406100,4373220,1_1_16_16_16_16_16_1_16_16_1_1_1_16_16_16_16_16_16_16_16_16_16_16_16_16_16_16_1_1_1_1_1_1_1_1_1_1_1_1_16_2_2_16_3_3_3_3_3_3_18_18_18_18_18_3_18_3_3_3_5_5_5_5_5_5_3
3528,192,1328686380,2,8,2,1328691600,5220,481620,4648740,4167120,16_16_16_16_16_0_0_16_16_16_16_16_0_0_0_1_1_0_0_0_0_0_0_0_0_0_0_0_0_0_0_0_1_1_2_2
3529,143,1328687460,9,4,9,1328691120,3660,1216380,1898460,682080,10_10_10_1_10_1_10_1_1_10_10_10_10_10_1_1_10_1_10_1_10_10_10_10_1_1_1_1_1_1_9
3530,141,1328687820,3,3,4,1328810460,122640,3034620,7406100,4371480,1_1_16_16_16_16_16_1_16_16_1_1_1_16_16_16_16_16_16_16_16_16_16_16_16_16_16_16_1_1_1_1_1_1_1_1_1_1_1_1_16_2_2_16_3_3_3_3_3_3_18_18_18_18_18_3_18_3_3_3_5_5_5_5_5_5_3_3
3531,86,1328687820,18,22,18,1328700480,12660,2341800,3519180,1177380,0_0_0_0_1_0_0_0_0_1_0_0_0_0_1_1_0_0_1_1_1_1_1_1_2_2_4_4_4_4_4_4_4_4_4_4_18_18_18_18_1_18_1_18
3532,165,1328687820,2,3,2,1328689260,1440,737520,1262880,525360,24_24_24_24_24_24_24_24_24_24_24_24_8_8_9_9_2
3533,166,1328688420,4,23,4,1328699820,11400,1219020,1666080,447060,7_7_7_1_7_7_1_7_7_7_21_21_1_1_2_2_3_3_4_4_4
3534,166,1328688420,4,23,4,1328688420,0,1219020,1666080,447060,7_7_7_1_7_7_1_7_7_7_21_21_1_1_2_2_3_3_4_4
3535,136,1328689260,2,3,2,1328691540,2280,135780,646380,510600,10_10_10_10_1_1_10_10_1_1_9_9_2
3536,165,1328689260,2,3,6,1329170400,481140,738960,1262880,523920,24_24_24_24_24_24_24_24_24_24_24_24_8_8_9_9_2_2
3537,143,1328691120,9,4,3,1329053220,362100,1220040,1898460,678420,10_10_10_1_10_1_10_1_1_10_10_10_10_10_1_1_10_1_10_1_10_10_10_10_1_1_1_1_1_1_9_9
3538,136,1328691540,2,3,9,1328700060,8520,138060,646380,508320,10_10_10_10_1_1_10_10_1_1_9_9_2_2
3539,192,1328691600,2,3,2,1328701140,9540,486840,4648740,4161900,16_16_16_16_16_0_0_16_16_16_16_16_0_0_0_1_1_0_0_0_0_0_0_0_0_0_0_0_0_0_0_0_1_1_2_2_2
3540,84,1328692440,5,6,34,1328693640,1200,3033540,3714840,681300,17_17_17_17_17_17_17_17_17_17_17_17_17_17_17_17_1_1_2_2_3_3_18_18_18_18_18_18_5_5
3541,148,1328693400,13,17,6,1328738400,45000,1829100,1938900,109800,7_7_7_7_7_1_7_1_9_9_2_2_3_3_14_14_13_13_13_13_13_13
3542,84,1328693640,34,17,34,1328710260,16620,3034740,3714840,680100,17_17_17_17_17_17_17_17_17_17_17_17_17_17_17_17_1_1_2_2_3_3_18_18_18_18_18_18_5_5_34
3543,203,1328694000,17,8,1,1328700000,6000,698700,1897500,1198800,7_7_7_7_7_7_7_7_7_7_7_1_1_7_7_7_7_7_7_7_7_7_17_17_17_17_4_17_4_4_4_17_17
3544,137,1328697840,5,9,5,1328705160,7320,152220,243720,91500,19_19_19_19_19_19_1_1_1_1_2_2_9_9_9_9_9_3_9_3_3_14_3_14_14_14_5
3545,166,1328699820,4,23,6,1329084000,384180,1230420,1666080,435660,7_7_7_1_7_7_1_7_7_7_21_21_1_1_2_2_3_3_4_4_4_4
3546,147,1328699880,4,23,4,1328703480,3600,1317000,1479360,162360,7_7_7_7_7_7_7_1_7_1_9_9_1_2_2_1_3_3_4
3547,203,1328700000,1,2,1,1328703060,3060,704700,1897500,1192800,7_7_7_7_7_7_7_7_7_7_7_1_1_7_7_7_7_7_7_7_7_7_17_17_17_17_4_17_4_4_4_17_17_1
3548,136,1328700060,9,4,9,1328702280,2220,146580,646380,499800,10_10_10_10_1_1_10_10_1_1_9_9_2_2_9
3549,86,1328700480,18,22,18,1328711640,11160,2354460,3519180,1164720,0_0_0_0_1_0_0_0_0_1_0_0_0_0_1_1_0_0_1_1_1_1_1_1_2_2_4_4_4_4_4_4_4_4_4_4_18_18_18_18_1_18_1_18_18
3550,192,1328701140,2,3,3,1332795600,4094460,496380,4648740,4152360,16_16_16_16_16_0_0_16_16_16_16_16_0_0_0_1_1_0_0_0_0_0_0_0_0_0_0_0_0_0_0_0_1_1_2_2_2_2
3551,136,1328702280,9,4,6,1329170400,468120,148800,646380,497580,10_10_10_10_1_1_10_10_1_1_9_9_2_2_9_9
3552,203,1328703060,1,2,2,1328703120,60,707760,1897500,1189740,7_7_7_7_7_7_7_7_7_7_7_1_1_7_7_7_7_7_7_7_7_7_17_17_17_17_4_17_4_4_4_17_17_1_1
3553,203,1328703120,2,3,2,1328707620,4500,707820,1897500,1189680,7_7_7_7_7_7_7_7_7_7_7_1_1_7_7_7_7_7_7_7_7_7_17_17_17_17_4_17_4_4_4_17_17_1_1_2
3554,147,1328703480,4,23,4,1328703540,60,1320600,1479360,158760,7_7_7_7_7_7_7_1_7_1_9_9_1_2_2_1_3_3_4_4
3555,147,1328703540,4,23,4,1328709540,6000,1320660,1479360,158700,7_7_7_7_7_7_7_1_7_1_9_9_1_2_2_1_3_3_4_4_4
3556,116,1328703540,19,11,19,1328703540,0,26340,786600,760260,19_19
3557,116,1328703540,19,11,19,1328709000,5460,26340,786600,760260,19_19_19
3558,184,1328705040,1,9,10,1328716980,11940,207840,1800900,1593060,10_10_10_10_10_10_10_10_10_10_10_10_1_1_10_1_1
3559,137,1328705160,5,9,6,1328738400,33240,159540,243720,84180,19_19_19_19_19_19_1_1_1_1_2_2_9_9_9_9_9_3_9_3_3_14_3_14_14_14_5_5
3560,203,1328707620,2,3,13,1328709600,1980,712320,1897500,1185180,7_7_7_7_7_7_7_7_7_7_7_1_1_7_7_7_7_7_7_7_7_7_17_17_17_17_4_17_4_4_4_17_17_1_1_2_2
3561,71,1328708760,7,10,7,1328724840,16080,2447160,3996240,1549080,29_29_1_1_7_7_1_7_1_7_7_7
3562,116,1328709000,19,11,19,1328711400,2400,31800,786600,754800,19_19_19_19
3563,147,1328709540,4,23,4,1328710320,780,1326660,1479360,152700,7_7_7_7_7_7_7_1_7_1_9_9_1_2_2_1_3_3_4_4_4_4
3564,203,1328709600,13,17,9,1328710680,1080,714300,1897500,1183200,7_7_7_7_7_7_7_7_7_7_7_1_1_7_7_7_7_7_7_7_7_7_17_17_17_17_4_17_4_4_4_17_17_1_1_2_2_13
3565,130,1328709720,15,18,15,1328770800,61080,1986060,3083940,1097880,26_26_26_26_26_26_8_8_26_26_26_26_26_26_26_26_26_26_26_8_26_8_17_17_1_1_17_1_17_17_1_17_17_17_17_17_17_17_17_1_17_17_1_17_17_1_17_1_17_17_1_17_1_3_3_1_1_17_17_17_18_17_1_18_4_18_1_4_4_18_18_3_17_1_3_1_15_4_4_3_3_18_15_18_4_18_4_4_15_4_18_18_4_15_4_4_4_4_4_4_15_15
3566,84,1328710260,34,17,34,1328710380,120,3051360,3714840,663480,17_17_17_17_17_17_17_17_17_17_17_17_17_17_17_17_1_1_2_2_3_3_18_18_18_18_18_18_5_5_34_34
3567,147,1328710320,4,19,4,1328715720,5400,1327440,1479360,151920,7_7_7_7_7_7_7_1_7_1_9_9_1_2_2_1_3_3_4_4_4_4_4
3568,84,1328710380,34,15,34,1328716380,6000,3051480,3714840,663360,17_17_17_17_17_17_17_17_17_17_17_17_17_17_17_17_1_1_2_2_3_3_18_18_18_18_18_18_5_5_34_34_34
3569,203,1328710680,9,3,9,1328710740,60,715380,1897500,1182120,7_7_7_7_7_7_7_7_7_7_7_1_1_7_7_7_7_7_7_7_7_7_17_17_17_17_4_17_4_4_4_17_17_1_1_2_2_13_9
3570,203,1328710740,3,3,9,1328710800,60,715440,1897500,1182060,7_7_7_7_7_7_7_7_7_7_7_1_1_7_7_7_7_7_7_7_7_7_17_17_17_17_4_17_4_4_4_17_17_1_1_2_2_13_9_9_3
3571,203,1328710740,9,3,3,1328710740,0,715440,1897500,1182060,7_7_7_7_7_7_7_7_7_7_7_1_1_7_7_7_7_7_7_7_7_7_17_17_17_17_4_17_4_4_4_17_17_1_1_2_2_13_9_9
3572,203,1328710800,9,3,3,1328715240,4440,715500,1897500,1182000,7_7_7_7_7_7_7_7_7_7_7_1_1_7_7_7_7_7_7_7_7_7_17_17_17_17_4_17_4_4_4_17_17_1_1_2_2_13_9_9_3_9
3573,116,1328711400,19,1,19,1328724720,13320,34200,786600,752400,19_19_19_19_19
3574,199,1328711640,0,20,0,1328724960,13320,34680,975720,941040,0_0_0_0
3575,86,1328711640,18,22,5,1329399120,687480,2365620,3519180,1153560,0_0_0_0_1_0_0_0_0_1_0_0_0_0_1_1_0_0_1_1_1_1_1_1_2_2_4_4_4_4_4_4_4_4_4_4_18_18_18_18_1_18_1_18_18_18
3576,111,1328712000,18,22,18,1328714580,2580,3253200,3974400,721200,0_0_0_0_0_0_0_0_0_0_0_1_0_1_0_0_0_0_1_0_1_0_0_0_0_0_0_1_1_0_1_1_2_2_4_4_4_4_4_1_4_4_1_4_4_4_4_4_4_4_4_4_18
3577,111,1328714580,18,22,18,1328724900,10320,3255780,3974400,718620,0_0_0_0_0_0_0_0_0_0_0_1_0_1_0_0_0_0_1_0_1_0_0_0_0_0_0_1_1_0_1_1_2_2_4_4_4_4_4_1_4_4_1_4_4_4_4_4_4_4_4_4_18_18
3578,203,1328715240,3,3,13,1328715600,360,719940,1897500,1177560,7_7_7_7_7_7_7_7_7_7_7_1_1_7_7_7_7_7_7_7_7_7_17_17_17_17_4_17_4_4_4_17_17_1_1_2_2_13_9_9_3_9_3
3579,203,1328715600,13,17,4,1328715780,180,720300,1897500,1177200,7_7_7_7_7_7_7_7_7_7_7_1_1_7_7_7_7_7_7_7_7_7_17_17_17_17_4_17_4_4_4_17_17_1_1_2_2_13_9_9_3_9_3_13
3580,147,1328715720,4,19,5,1328781600,65880,1332840,1479360,146520,7_7_7_7_7_7_7_1_7_1_9_9_1_2_2_1_3_3_4_4_4_4_4_4
3581,203,1328715780,4,19,17,1328716200,420,720480,1897500,1177020,7_7_7_7_7_7_7_7_7_7_7_1_1_7_7_7_7_7_7_7_7_7_17_17_17_17_4_17_4_4_4_17_17_1_1_2_2_13_9_9_3_9_3_13_4
3582,203,1328716200,17,8,13,1328716380,180,720900,1897500,1176600,7_7_7_7_7_7_7_7_7_7_7_1_1_7_7_7_7_7_7_7_7_7_17_17_17_17_4_17_4_4_4_17_17_1_1_2_2_13_9_9_3_9_3_13_4_17
3583,84,1328716380,34,15,34,1328764980,48600,3057480,3714840,657360,17_17_17_17_17_17_17_17_17_17_17_17_17_17_17_17_1_1_2_2_3_3_18_18_18_18_18_18_5_5_34_34_34_34
3584,203,1328716380,13,15,9,1328720460,4080,721080,1897500,1176420,7_7_7_7_7_7_7_7_7_7_7_1_1_7_7_7_7_7_7_7_7_7_17_17_17_17_4_17_4_4_4_17_17_1_1_2_2_13_9_9_3_9_3_13_4_17_13
3585,184,1328716980,10,13,10,1328726340,9360,219780,1800900,1581120,10_10_10_10_10_10_10_10_10_10_10_10_1_1_10_1_1_10
3586,203,1328720460,9,3,3,1328720520,60,725160,1897500,1172340,7_7_7_7_7_7_7_7_7_7_7_1_1_7_7_7_7_7_7_7_7_7_17_17_17_17_4_17_4_4_4_17_17_1_1_2_2_13_9_9_3_9_3_13_4_17_13_9
3587,203,1328720520,9,15,3,1328720520,0,725220,1897500,1172280,7_7_7_7_7_7_7_7_7_7_7_1_1_7_7_7_7_7_7_7_7_7_17_17_17_17_4_17_4_4_4_17_17_1_1_2_2_13_9_9_3_9_3_13_4_17_13_9_3_9
3588,203,1328720520,3,15,17,1328724720,4200,725220,1897500,1172280,7_7_7_7_7_7_7_7_7_7_7_1_1_7_7_7_7_7_7_7_7_7_17_17_17_17_4_17_4_4_4_17_17_1_1_2_2_13_9_9_3_9_3_13_4_17_13_9_3_9_3
3589,203,1328720520,3,3,9,1328720520,0,725220,1897500,1172280,7_7_7_7_7_7_7_7_7_7_7_1_1_7_7_7_7_7_7_7_7_7_17_17_17_17_4_17_4_4_4_17_17_1_1_2_2_13_9_9_3_9_3_13_4_17_13_9_3
3590,116,1328724720,19,1,19,1328724960,240,47520,786600,739080,19_19_19_19_19_19
3591,203,1328724720,17,12,3,1328725020,300,729420,1897500,1168080,7_7_7_7_7_7_7_7_7_7_7_1_1_7_7_7_7_7_7_7_7_7_17_17_17_17_4_17_4_4_4_17_17_1_1_2_2_13_9_9_3_9_3_13_4_17_13_9_3_9_3_17
3592,71,1328724840,7,12,7,1328725020,180,2463240,3996240,1533000,29_29_1_1_7_7_1_7_1_7_7_7_7
3593,111,1328724900,18,5,18,1328725200,300,3266100,3974400,708300,0_0_0_0_0_0_0_0_0_0_0_1_0_1_0_0_0_0_1_0_1_0_0_0_0_0_0_1_1_0_1_1_2_2_4_4_4_4_4_1_4_4_1_4_4_4_4_4_4_4_4_4_18_18_18
3594,199,1328724960,0,1,0,1328737500,12540,48000,975720,927720,0_0_0_0_0
3595,116,1328724960,19,14,19,1328748360,23400,47760,786600,738840,19_19_19_19_19_19_19
3596,71,1328725020,7,12,1,1328763600,38580,2463420,3996240,1532820,29_29_1_1_7_7_1_7_1_7_7_7_7_7
3597,203,1328725020,3,3,3,1328725320,300,729720,1897500,1167780,7_7_7_7_7_7_7_7_7_7_7_1_1_7_7_7_7_7_7_7_7_7_17_17_17_17_4_17_4_4_4_17_17_1_1_2_2_13_9_9_3_9_3_13_4_17_13_9_3_9_3_17_3
3598,111,1328725200,18,5,18,1328760180,34980,3266400,3974400,708000,0_0_0_0_0_0_0_0_0_0_0_1_0_1_0_0_0_0_1_0_1_0_0_0_0_0_0_1_1_0_1_1_2_2_4_4_4_4_4_1_4_4_1_4_4_4_4_4_4_4_4_4_18_18_18_18
3599,203,1328725320,3,5,4,1328727120,1800,730020,1897500,1167480,7_7_7_7_7_7_7_7_7_7_7_1_1_7_7_7_7_7_7_7_7_7_17_17_17_17_4_17_4_4_4_17_17_1_1_2_2_13_9_9_3_9_3_13_4_17_13_9_3_9_3_17_3_3
3600,184,1328726340,10,16,9,1328738400,12060,229140,1800900,1571760,10_10_10_10_10_10_10_10_10_10_10_10_1_1_10_1_1_10_10
3601,203,1328727120,4,19,4,1328727180,60,731820,1897500,1165680,7_7_7_7_7_7_7_7_7_7_7_1_1_7_7_7_7_7_7_7_7_7_17_17_17_17_4_17_4_4_4_17_17_1_1_2_2_13_9_9_3_9_3_13_4_17_13_9_3_9_3_17_3_3_4
3602,203,1328727180,4,19,9,1328736840,9660,731880,1897500,1165620,7_7_7_7_7_7_7_7_7_7_7_1_1_7_7_7_7_7_7_7_7_7_17_17_17_17_4_17_4_4_4_17_17_1_1_2_2_13_9_9_3_9_3_13_4_17_13_9_3_9_3_17_3_3_4_4
3603,203,1328736840,9,15,13,1328736900,60,741540,1897500,1155960,7_7_7_7_7_7_7_7_7_7_7_1_1_7_7_7_7_7_7_7_7_7_17_17_17_17_4_17_4_4_4_17_17_1_1_2_2_13_9_9_3_9_3_13_4_17_13_9_3_9_3_17_3_3_4_4_9
3604,203,1328736900,13,15,3,1328736900,0,741600,1897500,1155900,7_7_7_7_7_7_7_7_7_7_7_1_1_7_7_7_7_7_7_7_7_7_17_17_17_17_4_17_4_4_4_17_17_1_1_2_2_13_9_9_3_9_3_13_4_17_13_9_3_9_3_17_3_3_4_4_9_13
3605,203,1328736900,3,15,4,1328737200,300,741600,1897500,1155900,7_7_7_7_7_7_7_7_7_7_7_1_1_7_7_7_7_7_7_7_7_7_17_17_17_17_4_17_4_4_4_17_17_1_1_2_2_13_9_9_3_9_3_13_4_17_13_9_3_9_3_17_3_3_4_4_9_13_3
3606,203,1328737200,4,19,3,1328738160,960,741900,1897500,1155600,7_7_7_7_7_7_7_7_7_7_7_1_1_7_7_7_7_7_7_7_7_7_17_17_17_17_4_17_4_4_4_17_17_1_1_2_2_13_9_9_3_9_3_13_4_17_13_9_3_9_3_17_3_3_4_4_9_13_3_4
3607,199,1328737500,0,1,0,1328737980,480,60540,975720,915180,0_0_0_0_0_0
3608,199,1328737980,0,14,0,1328748360,10380,61020,975720,914700,0_0_0_0_0_0_0
3609,203,1328738160,3,5,17,1328762820,24660,742860,1897500,1154640,7_7_7_7_7_7_7_7_7_7_7_1_1_7_7_7_7_7_7_7_7_7_17_17_17_17_4_17_4_4_4_17_17_1_1_2_2_13_9_9_3_9_3_13_4_17_13_9_3_9_3_17_3_3_4_4_9_13_3_4_3
3610,148,1328738400,6,24,6,1328742000,3600,1874100,1938900,64800,7_7_7_7_7_1_7_1_9_9_2_2_3_3_14_14_13_13_13_13_13_13_6
3611,137,1328738400,6,24,6,1328742000,3600,192780,243720,50940,19_19_19_19_19_19_1_1_1_1_2_2_9_9_9_9_9_3_9_3_3_14_3_14_14_14_5_5_6
3612,184,1328738400,9,4,10,1328740620,2220,241200,1800900,1559700,10_10_10_10_10_10_10_10_10_10_10_10_1_1_10_1_1_10_10_9
3613,66,1328738400,6,24,6,1328742000,3600,3258000,4817700,1559700,3_3_4_4_4_4_4_4_4_4_4_4_4_4_4_4_4_4_4_4_4_3_3_4_4_4_4_4_4_4_4_4_5_5_5_5_5_5_5_5_6_6_5_5_5_5_4_4_5_5_5_5_5_5_5_5_5_5_6_6_6_6_6
3614,184,1328740620,10,16,9,1328742900,2280,243420,1800900,1557480,10_10_10_10_10_10_10_10_10_10_10_10_1_1_10_1_1_10_10_9_10
3615,137,1328742000,6,24,5,1328789280,47280,196380,243720,47340,19_19_19_19_19_19_1_1_1_1_2_2_9_9_9_9_9_3_9_3_3_14_3_14_14_14_5_5_6_6
3616,148,1328742000,6,24,5,1328763240,21240,1877700,1938900,61200,7_7_7_7_7_1_7_1_9_9_2_2_3_3_14_14_13_13_13_13_13_13_6_6
3617,66,1328742000,6,24,5,1328763000,21000,3261600,4817700,1556100,3_3_4_4_4_4_4_4_4_4_4_4_4_4_4_4_4_4_4_4_4_3_3_4_4_4_4_4_4_4_4_4_5_5_5_5_5_5_5_5_6_6_5_5_5_5_4_4_5_5_5_5_5_5_5_5_5_5_6_6_6_6_6_6
3618,184,1328742900,9,4,1,1328764440,21540,245700,1800900,1555200,10_10_10_10_10_10_10_10_10_10_10_10_1_1_10_1_1_10_10_9_10_9
3619,199,1328748360,0,14,0,1328763480,15120,71400,975720,904320,0_0_0_0_0_0_0_0
3620,116,1328748360,19,14,19,1328791920,43560,71160,786600,715440,19_19_19_19_19_19_19_19
3621,188,1328748540,0,14,0,1328756880,8340,76500,4327560,4251060,0_0_0
3622,188,1328756880,0,14,0,1328859180,102300,84840,4327560,4242720,0_0_0_0
3623,177,1328756940,10,16,10,1328762160,5220,0,1713060,1713060,10
3624,111,1328760180,18,5,18,1328762880,2700,3301380,3974400,673020,0_0_0_0_0_0_0_0_0_0_0_1_0_1_0_0_0_0_1_0_1_0_0_0_0_0_0_1_1_0_1_1_2_2_4_4_4_4_4_1_4_4_1_4_4_4_4_4_4_4_4_4_18_18_18_18_18
3625,177,1328762160,10,16,10,1329823680,1061520,5220,1713060,1707840,10_10
3626,203,1328762820,17,12,17,1328763360,540,767520,1897500,1129980,7_7_7_7_7_7_7_7_7_7_7_1_1_7_7_7_7_7_7_7_7_7_17_17_17_17_4_17_4_4_4_17_17_1_1_2_2_13_9_9_3_9_3_13_4_17_13_9_3_9_3_17_3_3_4_4_9_13_3_4_3_17
3627,111,1328762880,18,5,18,1328763060,180,3304080,3974400,670320,0_0_0_0_0_0_0_0_0_0_0_1_0_1_0_0_0_0_1_0_1_0_0_0_0_0_0_1_1_0_1_1_2_2_4_4_4_4_4_1_4_4_1_4_4_4_4_4_4_4_4_4_18_18_18_18_18_18
3628,66,1328763000,5,6,5,1328773860,10860,3282600,4817700,1535100,3_3_4_4_4_4_4_4_4_4_4_4_4_4_4_4_4_4_4_4_4_3_3_4_4_4_4_4_4_4_4_4_5_5_5_5_5_5_5_5_6_6_5_5_5_5_4_4_5_5_5_5_5_5_5_5_5_5_6_6_6_6_6_6_5
3629,111,1328763060,18,22,18,1328795460,32400,3304260,3974400,670140,0_0_0_0_0_0_0_0_0_0_0_1_0_1_0_0_0_0_1_0_1_0_0_0_0_0_0_1_1_0_1_1_2_2_4_4_4_4_4_1_4_4_1_4_4_4_4_4_4_4_4_4_18_18_18_18_18_18_18
3630,148,1328763240,5,9,5,1328781540,18300,1898940,1938900,39960,7_7_7_7_7_1_7_1_9_9_2_2_3_3_14_14_13_13_13_13_13_13_6_6_5
3631,203,1328763360,17,8,15,1328763600,240,768060,1897500,1129440,7_7_7_7_7_7_7_7_7_7_7_1_1_7_7_7_7_7_7_7_7_7_17_17_17_17_4_17_4_4_4_17_17_1_1_2_2_13_9_9_3_9_3_13_4_17_13_9_3_9_3_17_3_3_4_4_9_13_3_4_3_17_17
3632,199,1328763480,0,20,0,1328771340,7860,86520,975720,889200,0_0_0_0_0_0_0_0_0
3633,71,1328763600,1,18,7,1328764320,720,2502000,3996240,1494240,29_29_1_1_7_7_1_7_1_7_7_7_7_7_1
3634,203,1328763600,1,2,26,1328766540,2940,768300,1897500,1129200,7_7_7_7_7_7_7_7_7_7_7_1_1_7_7_7_7_7_7_7_7_7_17_17_17_17_4_17_4_4_4_17_17_1_1_2_2_13_9_9_3_9_3_13_4_17_13_9_3_9_3_17_3_3_4_4_9_13_3_4_3_17_17_15_1
3635,203,1328763600,15,2,1,1328763600,0,768300,1897500,1129200,7_7_7_7_7_7_7_7_7_7_7_1_1_7_7_7_7_7_7_7_7_7_17_17_17_17_4_17_4_4_4_17_17_1_1_2_2_13_9_9_3_9_3_13_4_17_13_9_3_9_3_17_3_3_4_4_9_13_3_4_3_17_17_15
3636,71,1328764320,7,10,1,1328769600,5280,2502720,3996240,1493520,29_29_1_1_7_7_1_7_1_7_7_7_7_7_1_7
3637,184,1328764440,1,9,1,1328764980,540,267240,1800900,1533660,10_10_10_10_10_10_10_10_10_10_10_10_1_1_10_1_1_10_10_9_10_9_1
3638,84,1328764980,34,17,34,1328774460,9480,3106080,3714840,608760,17_17_17_17_17_17_17_17_17_17_17_17_17_17_17_17_1_1_2_2_3_3_18_18_18_18_18_18_5_5_34_34_34_34_34
3639,184,1328764980,1,9,9,1328855460,90480,267780,1800900,1533120,10_10_10_10_10_10_10_10_10_10_10_10_1_1_10_1_1_10_10_9_10_9_1_1
3640,203,1328766540,26,13,17,1328767020,480,771240,1897500,1126260,7_7_7_7_7_7_7_7_7_7_7_1_1_7_7_7_7_7_7_7_7_7_17_17_17_17_4_17_4_4_4_17_17_1_1_2_2_13_9_9_3_9_3_13_4_17_13_9_3_9_3_17_3_3_4_4_9_13_3_4_3_17_17_15_1_26
3641,203,1328767020,17,8,17,1328767080,60,771720,1897500,1125780,7_7_7_7_7_7_7_7_7_7_7_1_1_7_7_7_7_7_7_7_7_7_17_17_17_17_4_17_4_4_4_17_17_1_1_2_2_13_9_9_3_9_3_13_4_17_13_9_3_9_3_17_3_3_4_4_9_13_3_4_3_17_17_15_1_26_17
3642,203,1328767080,17,8,9,1328769060,1980,771780,1897500,1125720,7_7_7_7_7_7_7_7_7_7_7_1_1_7_7_7_7_7_7_7_7_7_17_17_17_17_4_17_4_4_4_17_17_1_1_2_2_13_9_9_3_9_3_13_4_17_13_9_3_9_3_17_3_3_4_4_9_13_3_4_3_17_17_15_1_26_17_17
3643,203,1328769060,9,3,15,1328769600,540,773760,1897500,1123740,7_7_7_7_7_7_7_7_7_7_7_1_1_7_7_7_7_7_7_7_7_7_17_17_17_17_4_17_4_4_4_17_17_1_1_2_2_13_9_9_3_9_3_13_4_17_13_9_3_9_3_17_3_3_4_4_9_13_3_4_3_17_17_15_1_26_17_17_9
3644,71,1328769600,1,18,7,1328775180,5580,2508000,3996240,1488240,29_29_1_1_7_7_1_7_1_7_7_7_7_7_1_7_1
3645,203,1328769600,1,2,15,1328770800,1200,774300,1897500,1123200,7_7_7_7_7_7_7_7_7_7_7_1_1_7_7_7_7_7_7_7_7_7_17_17_17_17_4_17_4_4_4_17_17_1_1_2_2_13_9_9_3_9_3_13_4_17_13_9_3_9_3_17_3_3_4_4_9_13_3_4_3_17_17_15_1_26_17_17_9_15_1
3646,203,1328769600,15,2,1,1328769600,0,774300,1897500,1123200,7_7_7_7_7_7_7_7_7_7_7_1_1_7_7_7_7_7_7_7_7_7_17_17_17_17_4_17_4_4_4_17_17_1_1_2_2_13_9_9_3_9_3_13_4_17_13_9_3_9_3_17_3_3_4_4_9_13_3_4_3_17_17_15_1_26_17_17_9_15
3647,203,1328770800,15,2,1,1328770800,0,775500,1897500,1122000,7_7_7_7_7_7_7_7_7_7_7_1_1_7_7_7_7_7_7_7_7_7_17_17_17_17_4_17_4_4_4_17_17_1_1_2_2_13_9_9_3_9_3_13_4_17_13_9_3_9_3_17_3_3_4_4_9_13_3_4_3_17_17_15_1_26_17_17_9_15_1_15
3648,130,1328770800,15,18,15,1328796120,25320,2047140,3083940,1036800,26_26_26_26_26_26_8_8_26_26_26_26_26_26_26_26_26_26_26_8_26_8_17_17_1_1_17_1_17_17_1_17_17_17_17_17_17_17_17_1_17_17_1_17_17_1_17_1_17_17_1_17_1_3_3_1_1_17_17_17_18_17_1_18_4_18_1_4_4_18_18_3_17_1_3_1_15_4_4_3_3_18_15_18_4_18_4_4_15_4_18_18_4_15_4_4_4_4_4_4_15_15_15
3649,203,1328770800,1,2,17,1328774820,4020,775500,1897500,1122000,7_7_7_7_7_7_7_7_7_7_7_1_1_7_7_7_7_7_7_7_7_7_17_17_17_17_4_17_4_4_4_17_17_1_1_2_2_13_9_9_3_9_3_13_4_17_13_9_3_9_3_17_3_3_4_4_9_13_3_4_3_17_17_15_1_26_17_17_9_15_1_15_1
3650,199,1328771340,0,20,0,1328771400,60,94380,975720,881340,0_0_0_0_0_0_0_0_0_0
3651,199,1328771400,0,0,0,1328775960,4560,94440,975720,881280,0_0_0_0_0_0_0_0_0_0_0
3652,66,1328773860,5,6,2,1330293600,1519740,3293460,4817700,1524240,3_3_4_4_4_4_4_4_4_4_4_4_4_4_4_4_4_4_4_4_4_3_3_4_4_4_4_4_4_4_4_4_5_5_5_5_5_5_5_5_6_6_5_5_5_5_4_4_5_5_5_5_5_5_5_5_5_5_6_6_6_6_6_6_5_5
3653,84,1328774460,34,17,34,1329243840,469380,3115560,3714840,599280,17_17_17_17_17_17_17_17_17_17_17_17_17_17_17_17_1_1_2_2_3_3_18_18_18_18_18_18_5_5_34_34_34_34_34_34
3654,61,1328774520,34,17,34,1328777340,2820,3319320,6225300,2905980,4_4_18_18_34_34_34_3_3_34_3_3_34_35_34_35_35_35_36_36_35_35_35_35_34_34_34_34_34_34_34_34_34_34_34_34_34
3655,203,1328774820,17,8,4,1328775840,1020,779520,1897500,1117980,7_7_7_7_7_7_7_7_7_7_7_1_1_7_7_7_7_7_7_7_7_7_17_17_17_17_4_17_4_4_4_17_17_1_1_2_2_13_9_9_3_9_3_13_4_17_13_9_3_9_3_17_3_3_4_4_9_13_3_4_3_17_17_15_1_26_17_17_9_15_1_15_1_17
3656,71,1328775180,7,10,7,1328775360,180,2513580,3996240,1482660,29_29_1_1_7_7_1_7_1_7_7_7_7_7_1_7_1_7
3657,71,1328775360,7,8,7,1328795760,20400,2513760,3996240,1482480,29_29_1_1_7_7_1_7_1_7_7_7_7_7_1_7_1_7_7
3658,203,1328775840,4,23,13,1328779020,3180,780540,1897500,1116960,7_7_7_7_7_7_7_7_7_7_7_1_1_7_7_7_7_7_7_7_7_7_17_17_17_17_4_17_4_4_4_17_17_1_1_2_2_13_9_9_3_9_3_13_4_17_13_9_3_9_3_17_3_3_4_4_9_13_3_4_3_17_17_15_1_26_17_17_9_15_1_15_1_17_4
3659,199,1328775960,0,0,0,1328776020,60,99000,975720,876720,0_0_0_0_0_0_0_0_0_0_0_0
3660,199,1328776020,0,0,1,1328777580,1560,99060,975720,876660,0_0_0_0_0_0_0_0_0_0_0_0_0
3661,61,1328777340,34,17,34,1329383460,606120,3322140,6225300,2903160,4_4_18_18_34_34_34_3_3_34_3_3_34_35_34_35_35_35_36_36_35_35_35_35_34_34_34_34_34_34_34_34_34_34_34_34_34_34
3662,182,1328777340,14,17,14,1328778960,1620,0,915060,915060,14
3663,199,1328777580,1,9,1,1328781300,3720,100620,975720,875100,0_0_0_0_0_0_0_0_0_0_0_0_0_1
3664,182,1328778960,14,17,14,1328783280,4320,1620,915060,913440,14_14
3665,203,1328779020,13,17,13,1328783220,4200,783720,1897500,1113780,7_7_7_7_7_7_7_7_7_7_7_1_1_7_7_7_7_7_7_7_7_7_17_17_17_17_4_17_4_4_4_17_17_1_1_2_2_13_9_9_3_9_3_13_4_17_13_9_3_9_3_17_3_3_4_4_9_13_3_4_3_17_17_15_1_26_17_17_9_15_1_15_1_17_4_13
3666,199,1328781300,1,9,0,1328796300,15000,104340,975720,871380,0_0_0_0_0_0_0_0_0_0_0_0_0_1_1
3667,148,1328781540,5,9,5,1328787060,5520,1917240,1938900,21660,7_7_7_7_7_1_7_1_9_9_2_2_3_3_14_14_13_13_13_13_13_13_6_6_5_5
3668,147,1328781600,5,9,5,1328796420,14820,1398720,1479360,80640,7_7_7_7_7_7_7_1_7_1_9_9_1_2_2_1_3_3_4_4_4_4_4_4_5
3669,203,1328783220,13,17,15,1328784600,1380,787920,1897500,1109580,7_7_7_7_7_7_7_7_7_7_7_1_1_7_7_7_7_7_7_7_7_7_17_17_17_17_4_17_4_4_4_17_17_1_1_2_2_13_9_9_3_9_3_13_4_17_13_9_3_9_3_17_3_3_4_4_9_13_3_4_3_17_17_15_1_26_17_17_9_15_1_15_1_17_4_13_13
3670,182,1328783280,14,17,14,1328787420,4140,5940,915060,909120,14_14_14
3671,79,1328783700,1,6,1,1328803380,19680,3155700,4151700,996000,15_1_15_1_26_26_26_26_26_26_26_26_26_26_26_26_26_26_26_26_8_8_1_1_10_10_10_10_10_10_41_1_1_41_6_6_41_41_41_41_18_14_15_18_15_14_1_1_14_14_14_14_1_1_1
3672,203,1328784600,1,2,1,1328786400,1800,789300,1897500,1108200,7_7_7_7_7_7_7_7_7_7_7_1_1_7_7_7_7_7_7_7_7_7_17_17_17_17_4_17_4_4_4_17_17_1_1_2_2_13_9_9_3_9_3_13_4_17_13_9_3_9_3_17_3_3_4_4_9_13_3_4_3_17_17_15_1_26_17_17_9_15_1_15_1_17_4_13_13_15_1
3673,203,1328784600,15,2,1,1328784600,0,789300,1897500,1108200,7_7_7_7_7_7_7_7_7_7_7_1_1_7_7_7_7_7_7_7_7_7_17_17_17_17_4_17_4_4_4_17_17_1_1_2_2_13_9_9_3_9_3_13_4_17_13_9_3_9_3_17_3_3_4_4_9_13_3_4_3_17_17_15_1_26_17_17_9_15_1_15_1_17_4_13_13_15
3674,203,1328786400,15,2,4,1328786880,480,791100,1897500,1106400,7_7_7_7_7_7_7_7_7_7_7_1_1_7_7_7_7_7_7_7_7_7_17_17_17_17_4_17_4_4_4_17_17_1_1_2_2_13_9_9_3_9_3_13_4_17_13_9_3_9_3_17_3_3_4_4_9_13_3_4_3_17_17_15_1_26_17_17_9_15_1_15_1_17_4_13_13_15_1_1_15
3675,203,1328786400,1,2,15,1328786400,0,791100,1897500,1106400,7_7_7_7_7_7_7_7_7_7_7_1_1_7_7_7_7_7_7_7_7_7_17_17_17_17_4_17_4_4_4_17_17_1_1_2_2_13_9_9_3_9_3_13_4_17_13_9_3_9_3_17_3_3_4_4_9_13_3_4_3_17_17_15_1_26_17_17_9_15_1_15_1_17_4_13_13_15_1_1
3676,203,1328786880,4,23,4,1328786940,60,791580,1897500,1105920,7_7_7_7_7_7_7_7_7_7_7_1_1_7_7_7_7_7_7_7_7_7_17_17_17_17_4_17_4_4_4_17_17_1_1_2_2_13_9_9_3_9_3_13_4_17_13_9_3_9_3_17_3_3_4_4_9_13_3_4_3_17_17_15_1_26_17_17_9_15_1_15_1_17_4_13_13_15_1_1_15_4
3677,203,1328786940,4,23,13,1328787480,540,791640,1897500,1105860,7_7_7_7_7_7_7_7_7_7_7_1_1_7_7_7_7_7_7_7_7_7_17_17_17_17_4_17_4_4_4_17_17_1_1_2_2_13_9_9_3_9_3_13_4_17_13_9_3_9_3_17_3_3_4_4_9_13_3_4_3_17_17_15_1_26_17_17_9_15_1_15_1_17_4_13_13_15_1_1_15_4_4
3678,148,1328787060,5,9,5,1328787120,60,1922760,1938900,16140,7_7_7_7_7_1_7_1_9_9_2_2_3_3_14_14_13_13_13_13_13_13_6_6_5_5_5
3679,148,1328787120,5,9,5,1328791860,4740,1922820,1938900,16080,7_7_7_7_7_1_7_1_9_9_2_2_3_3_14_14_13_13_13_13_13_13_6_6_5_5_5_5
3680,182,1328787420,14,17,14,1328796120,8700,10080,915060,904980,14_14_14_14
3681,203,1328787480,13,17,9,1328789280,1800,792180,1897500,1105320,7_7_7_7_7_7_7_7_7_7_7_1_1_7_7_7_7_7_7_7_7_7_17_17_17_17_4_17_4_4_4_17_17_1_1_2_2_13_9_9_3_9_3_13_4_17_13_9_3_9_3_17_3_3_4_4_9_13_3_4_3_17_17_15_1_26_17_17_9_15_1_15_1_17_4_13_13_15_1_1_15_4_4_13
3682,137,1328789280,5,9,5,1328789340,60,243660,243720,60,19_19_19_19_19_19_1_1_1_1_2_2_9_9_9_9_9_3_9_3_3_14_3_14_14_14_5_5_6_6_5
3683,203,1328789280,9,3,3,1328789460,180,793980,1897500,1103520,7_7_7_7_7_7_7_7_7_7_7_1_1_7_7_7_7_7_7_7_7_7_17_17_17_17_4_17_4_4_4_17_17_1_1_2_2_13_9_9_3_9_3_13_4_17_13_9_3_9_3_17_3_3_4_4_9_13_3_4_3_17_17_15_1_26_17_17_9_15_1_15_1_17_4_13_13_15_1_1_15_4_4_13_9
3684,137,1328789340,5,9,99,1328789340,0,243720,243720,0,19_19_19_19_19_19_1_1_1_1_2_2_9_9_9_9_9_3_9_3_3_14_3_14_14_14_5_5_6_6_5_5
3685,203,1328789460,3,3,1,1328791200,1740,794160,1897500,1103340,7_7_7_7_7_7_7_7_7_7_7_1_1_7_7_7_7_7_7_7_7_7_17_17_17_17_4_17_4_4_4_17_17_1_1_2_2_13_9_9_3_9_3_13_4_17_13_9_3_9_3_17_3_3_4_4_9_13_3_4_3_17_17_15_1_26_17_17_9_15_1_15_1_17_4_13_13_15_1_1_15_4_4_13_9_3
3686,180,1328790420,50,10,50,1328802480,12060,0,3322080,3322080,50
3687,203,1328791200,1,2,13,1328795340,4140,795900,1897500,1101600,7_7_7_7_7_7_7_7_7_7_7_1_1_7_7_7_7_7_7_7_7_7_17_17_17_17_4_17_4_4_4_17_17_1_1_2_2_13_9_9_3_9_3_13_4_17_13_9_3_9_3_17_3_3_4_4_9_13_3_4_3_17_17_15_1_26_17_17_9_15_1_15_1_17_4_13_13_15_1_1_15_4_4_13_9_3_1
3688,148,1328791860,5,9,5,1328803200,11340,1927560,1938900,11340,7_7_7_7_7_1_7_1_9_9_2_2_3_3_14_14_13_13_13_13_13_13_6_6_5_5_5_5_5
3689,116,1328791920,19,11,19,1328794860,2940,114720,786600,671880,19_19_19_19_19_19_19_19_19
3690,116,1328794860,19,11,1,1328851800,56940,117660,786600,668940,19_19_19_19_19_19_19_19_19_19
3691,203,1328795340,13,17,4,1328795400,60,800040,1897500,1097460,7_7_7_7_7_7_7_7_7_7_7_1_1_7_7_7_7_7_7_7_7_7_17_17_17_17_4_17_4_4_4_17_17_1_1_2_2_13_9_9_3_9_3_13_4_17_13_9_3_9_3_17_3_3_4_4_9_13_3_4_3_17_17_15_1_26_17_17_9_15_1_15_1_17_4_13_13_15_1_1_15_4_4_13_9_3_1_13
3692,203,1328795400,4,23,15,1328803200,7800,800100,1897500,1097400,7_7_7_7_7_7_7_7_7_7_7_1_1_7_7_7_7_7_7_7_7_7_17_17_17_17_4_17_4_4_4_17_17_1_1_2_2_13_9_9_3_9_3_13_4_17_13_9_3_9_3_17_3_3_4_4_9_13_3_4_3_17_17_15_1_26_17_17_9_15_1_15_1_17_4_13_13_15_1_1_15_4_4_13_9_3_1_13_4
3693,111,1328795460,18,22,18,1328796300,840,3336660,3974400,637740,0_0_0_0_0_0_0_0_0_0_0_1_0_1_0_0_0_0_1_0_1_0_0_0_0_0_0_1_1_0_1_1_2_2_4_4_4_4_4_1_4_4_1_4_4_4_4_4_4_4_4_4_18_18_18_18_18_18_18_18
3694,71,1328795760,7,8,7,1328811240,15480,2534160,3996240,1462080,29_29_1_1_7_7_1_7_1_7_7_7_7_7_1_7_1_7_7_7
3695,130,1328796120,15,18,15,1328863260,67140,2072460,3083940,1011480,26_26_26_26_26_26_8_8_26_26_26_26_26_26_26_26_26_26_26_8_26_8_17_17_1_1_17_1_17_17_1_17_17_17_17_17_17_17_17_1_17_17_1_17_17_1_17_1_17_17_1_17_1_3_3_1_1_17_17_17_18_17_1_18_4_18_1_4_4_18_18_3_17_1_3_1_15_4_4_3_3_18_15_18_4_18_4_4_15_4_18_18_4_15_4_4_4_4_4_4_15_15_15_15
3696,182,1328796120,14,15,14,1328804040,7920,18780,915060,896280,14_14_14_14_14
3697,111,1328796300,18,19,18,1328819400,23100,3337500,3974400,636900,0_0_0_0_0_0_0_0_0_0_0_1_0_1_0_0_0_0_1_0_1_0_0_0_0_0_0_1_1_0_1_1_2_2_4_4_4_4_4_1_4_4_1_4_4_4_4_4_4_4_4_4_18_18_18_18_18_18_18_18_18
3698,199,1328796300,0,0,0,1328800440,4140,119340,975720,856380,0_0_0_0_0_0_0_0_0_0_0_0_0_1_1_0
3699,147,1328796420,5,9,6,1328824800,28380,1413540,1479360,65820,7_7_7_7_7_7_7_1_7_1_9_9_1_2_2_1_3_3_4_4_4_4_4_4_5_5
3700,199,1328800440,0,1,0,1328811300,10860,123480,975720,852240,0_0_0_0_0_0_0_0_0_0_0_0_0_1_1_0_0
3701,151,1328800560,19,1,19,1328825580,25020,678360,3643800,2965440,19_19_19_19_19_1_1_19_1_1_19
3702,180,1328802480,50,10,50,1328811180,8700,12060,3322080,3310020,50_50
3703,203,1328803200,15,2,1,1328803500,300,807900,1897500,1089600,7_7_7_7_7_7_7_7_7_7_7_1_1_7_7_7_7_7_7_7_7_7_17_17_17_17_4_17_4_4_4_17_17_1_1_2_2_13_9_9_3_9_3_13_4_17_13_9_3_9_3_17_3_3_4_4_9_13_3_4_3_17_17_15_1_26_17_17_9_15_1_15_1_17_4_13_13_15_1_1_15_4_4_13_9_3_1_13_4_15
3704,148,1328803200,5,9,99,1328803200,0,1938900,1938900,0,7_7_7_7_7_1_7_1_9_9_2_2_3_3_14_14_13_13_13_13_13_13_6_6_5_5_5_5_5_5
3705,79,1328803380,1,6,1,1329115500,312120,3175380,4151700,976320,15_1_15_1_26_26_26_26_26_26_26_26_26_26_26_26_26_26_26_26_8_8_1_1_10_10_10_10_10_10_41_1_1_41_6_6_41_41_41_41_18_14_15_18_15_14_1_1_14_14_14_14_1_1_1_1
3706,203,1328803500,1,2,3,1328804040,540,808200,1897500,1089300,7_7_7_7_7_7_7_7_7_7_7_1_1_7_7_7_7_7_7_7_7_7_17_17_17_17_4_17_4_4_4_17_17_1_1_2_2_13_9_9_3_9_3_13_4_17_13_9_3_9_3_17_3_3_4_4_9_13_3_4_3_17_17_15_1_26_17_17_9_15_1_15_1_17_4_13_13_15_1_1_15_4_4_13_9_3_1_13_4_15_1
3707,182,1328804040,14,15,14,1328994840,190800,26700,915060,888360,14_14_14_14_14_14
3708,203,1328804040,3,15,13,1328804100,60,808740,1897500,1088760,7_7_7_7_7_7_7_7_7_7_7_1_1_7_7_7_7_7_7_7_7_7_17_17_17_17_4_17_4_4_4_17_17_1_1_2_2_13_9_9_3_9_3_13_4_17_13_9_3_9_3_17_3_3_4_4_9_13_3_4_3_17_17_15_1_26_17_17_9_15_1_15_1_17_4_13_13_15_1_1_15_4_4_13_9_3_1_13_4_15_1_3
3709,203,1328804100,13,15,1,1328806800,2700,808800,1897500,1088700,7_7_7_7_7_7_7_7_7_7_7_1_1_7_7_7_7_7_7_7_7_7_17_17_17_17_4_17_4_4_4_17_17_1_1_2_2_13_9_9_3_9_3_13_4_17_13_9_3_9_3_17_3_3_4_4_9_13_3_4_3_17_17_15_1_26_17_17_9_15_1_15_1_17_4_13_13_15_1_1_15_4_4_13_9_3_1_13_4_15_1_3_13
3710,203,1328806800,1,2,26,1328809200,2400,811500,1897500,1086000,7_7_7_7_7_7_7_7_7_7_7_1_1_7_7_7_7_7_7_7_7_7_17_17_17_17_4_17_4_4_4_17_17_1_1_2_2_13_9_9_3_9_3_13_4_17_13_9_3_9_3_17_3_3_4_4_9_13_3_4_3_17_17_15_1_26_17_17_9_15_1_15_1_17_4_13_13_15_1_1_15_4_4_13_9_3_1_13_4_15_1_3_13_1
3711,203,1328809200,26,13,3,1328823660,14460,813900,1897500,1083600,7_7_7_7_7_7_7_7_7_7_7_1_1_7_7_7_7_7_7_7_7_7_17_17_17_17_4_17_4_4_4_17_17_1_1_2_2_13_9_9_3_9_3_13_4_17_13_9_3_9_3_17_3_3_4_4_9_13_3_4_3_17_17_15_1_26_17_17_9_15_1_15_1_17_4_13_13_15_1_1_15_4_4_13_9_3_1_13_4_15_1_3_13_1_26
3712,141,1328810460,4,5,4,1328819340,8880,3157260,7406100,4248840,1_1_16_16_16_16_16_1_16_16_1_1_1_16_16_16_16_16_16_16_16_16_16_16_16_16_16_16_1_1_1_1_1_1_1_1_1_1_1_1_16_2_2_16_3_3_3_3_3_3_18_18_18_18_18_3_18_3_3_3_5_5_5_5_5_5_3_3_4
3713,180,1328811180,50,12,50,1328815320,4140,20760,3322080,3301320,50_50_50
3714,71,1328811240,7,12,7,1328849100,37860,2549640,3996240,1446600,29_29_1_1_7_7_1_7_1_7_7_7_7_7_1_7_1_7_7_7_7
3715,199,1328811300,0,16,0,1328816160,4860,134340,975720,841380,0_0_0_0_0_0_0_0_0_0_0_0_0_1_1_0_0_0
3716,180,1328815320,50,12,50,1328815320,0,24900,3322080,3297180,50_50_50_50
3717,180,1328815320,50,12,50,1328849040,33720,24900,3322080,3297180,50_50_50_50_50
3718,199,1328816160,0,1,0,1328820180,4020,139200,975720,836520,0_0_0_0_0_0_0_0_0_0_0_0_0_1_1_0_0_0_0
3719,141,1328819340,4,5,4,1328849400,30060,3166140,7406100,4239960,1_1_16_16_16_16_16_1_16_16_1_1_1_16_16_16_16_16_16_16_16_16_16_16_16_16_16_16_1_1_1_1_1_1_1_1_1_1_1_1_16_2_2_16_3_3_3_3_3_3_18_18_18_18_18_3_18_3_3_3_5_5_5_5_5_5_3_3_4_4_4
3720,141,1328819340,4,5,4,1328819340,0,3166140,7406100,4239960,1_1_16_16_16_16_16_1_16_16_1_1_1_16_16_16_16_16_16_16_16_16_16_16_16_16_16_16_1_1_1_1_1_1_1_1_1_1_1_1_16_2_2_16_3_3_3_3_3_3_18_18_18_18_18_3_18_3_3_3_5_5_5_5_5_5_3_3_4_4
3721,111,1328819400,18,19,18,1329343200,523800,3360600,3974400,613800,0_0_0_0_0_0_0_0_0_0_0_1_0_1_0_0_0_0_1_0_1_0_0_0_0_0_0_1_1_0_1_1_2_2_4_4_4_4_4_1_4_4_1_4_4_4_4_4_4_4_4_4_18_18_18_18_18_18_18_18_18_18
3722,73,1328819460,18,19,18,1328824200,4740,815460,1303500,488040,1_1_9_9_3_3_3_9_3_9_9_9_18
3723,199,1328820180,0,16,1,1328852820,32640,143220,975720,832500,0_0_0_0_0_0_0_0_0_0_0_0_0_1_1_0_0_0_0_0
3724,203,1328823660,3,15,13,1328823660,0,828360,1897500,1069140,7_7_7_7_7_7_7_7_7_7_7_1_1_7_7_7_7_7_7_7_7_7_17_17_17_17_4_17_4_4_4_17_17_1_1_2_2_13_9_9_3_9_3_13_4_17_13_9_3_9_3_17_3_3_4_4_9_13_3_4_3_17_17_15_1_26_17_17_9_15_1_15_1_17_4_13_13_15_1_1_15_4_4_13_9_3_1_13_4_15_1_3_13_1_26_3
3725,203,1328823660,13,15,6,1328824800,1140,828360,1897500,1069140,7_7_7_7_7_7_7_7_7_7_7_1_1_7_7_7_7_7_7_7_7_7_17_17_17_17_4_17_4_4_4_17_17_1_1_2_2_13_9_9_3_9_3_13_4_17_13_9_3_9_3_17_3_3_4_4_9_13_3_4_3_17_17_15_1_26_17_17_9_15_1_15_1_17_4_13_13_15_1_1_15_4_4_13_9_3_1_13_4_15_1_3_13_1_26_3_13
3726,73,1328824200,18,19,18,1328851500,27300,820200,1303500,483300,1_1_9_9_3_3_3_9_3_9_9_9_18_18
3727,147,1328824800,6,7,6,1328828400,3600,1441920,1479360,37440,7_7_7_7_7_7_7_1_7_1_9_9_1_2_2_1_3_3_4_4_4_4_4_4_5_5_6
3728,203,1328824800,6,7,6,1328828400,3600,829500,1897500,1068000,7_7_7_7_7_7_7_7_7_7_7_1_1_7_7_7_7_7_7_7_7_7_17_17_17_17_4_17_4_4_4_17_17_1_1_2_2_13_9_9_3_9_3_13_4_17_13_9_3_9_3_17_3_3_4_4_9_13_3_4_3_17_17_15_1_26_17_17_9_15_1_15_1_17_4_13_13_15_1_1_15_4_4_13_9_3_1_13_4_15_1_3_13_1_26_3_13_6
3729,151,1328825580,19,1,19,1328826960,1380,703380,3643800,2940420,19_19_19_19_19_1_1_19_1_1_19_19
3730,151,1328826960,19,16,19,1328848440,21480,704760,3643800,2939040,19_19_19_19_19_1_1_19_1_1_19_19_19
3731,147,1328828400,6,7,5,1328855640,27240,1445520,1479360,33840,7_7_7_7_7_7_7_1_7_1_9_9_1_2_2_1_3_3_4_4_4_4_4_4_5_5_6_6
3732,203,1328828400,6,7,15,1328850000,21600,833100,1897500,1064400,7_7_7_7_7_7_7_7_7_7_7_1_1_7_7_7_7_7_7_7_7_7_17_17_17_17_4_17_4_4_4_17_17_1_1_2_2_13_9_9_3_9_3_13_4_17_13_9_3_9_3_17_3_3_4_4_9_13_3_4_3_17_17_15_1_26_17_17_9_15_1_15_1_17_4_13_13_15_1_1_15_4_4_13_9_3_1_13_4_15_1_3_13_1_26_3_13_6_6
3733,151,1328848440,19,16,1,1328849400,960,726240,3643800,2917560,19_19_19_19_19_1_1_19_1_1_19_19_19_19
3734,180,1328849040,50,12,1,1328849940,900,58620,3322080,3263460,50_50_50_50_50_50
3735,71,1328849100,7,12,7,1328849640,540,2587500,3996240,1408740,29_29_1_1_7_7_1_7_1_7_7_7_7_7_1_7_1_7_7_7_7_7
3736,151,1328849400,1,9,19,1328851620,2220,727200,3643800,2916600,19_19_19_19_19_1_1_19_1_1_19_19_19_19_1
3737,141,1328849400,4,22,4,1328849520,120,3196200,7406100,4209900,1_1_16_16_16_16_16_1_16_16_1_1_1_16_16_16_16_16_16_16_16_16_16_16_16_16_16_16_1_1_1_1_1_1_1_1_1_1_1_1_16_2_2_16_3_3_3_3_3_3_18_18_18_18_18_3_18_3_3_3_5_5_5_5_5_5_3_3_4_4_4_4
3738,141,1328849520,4,5,3,1328859780,10260,3196320,7406100,4209780,1_1_16_16_16_16_16_1_16_16_1_1_1_16_16_16_16_16_16_16_16_16_16_16_16_16_16_16_1_1_1_1_1_1_1_1_1_1_1_1_16_2_2_16_3_3_3_3_3_3_18_18_18_18_18_3_18_3_3_3_5_5_5_5_5_5_3_3_4_4_4_4_4
3739,71,1328849640,7,8,1,1328859420,9780,2588040,3996240,1408200,29_29_1_1_7_7_1_7_1_7_7_7_7_7_1_7_1_7_7_7_7_7_7
3740,180,1328849940,1,18,50,1328850720,780,59520,3322080,3262560,50_50_50_50_50_50_1
3741,203,1328850000,15,2,26,1328851560,1560,854700,1897500,1042800,7_7_7_7_7_7_7_7_7_7_7_1_1_7_7_7_7_7_7_7_7_7_17_17_17_17_4_17_4_4_4_17_17_1_1_2_2_13_9_9_3_9_3_13_4_17_13_9_3_9_3_17_3_3_4_4_9_13_3_4_3_17_17_15_1_26_17_17_9_15_1_15_1_17_4_13_13_15_1_1_15_4_4_13_9_3_1_13_4_15_1_3_13_1_26_3_13_6_6_15
3742,180,1328850720,50,8,1,1328851800,1080,60300,3322080,3261780,50_50_50_50_50_50_1_50
3743,73,1328851500,18,23,18,1328860320,8820,847500,1303500,456000,1_1_9_9_3_3_3_9_3_9_9_9_18_18_18
3744,203,1328851560,26,13,15,1328856000,4440,856260,1897500,1041240,7_7_7_7_7_7_7_7_7_7_7_1_1_7_7_7_7_7_7_7_7_7_17_17_17_17_4_17_4_4_4_17_17_1_1_2_2_13_9_9_3_9_3_13_4_17_13_9_3_9_3_17_3_3_4_4_9_13_3_4_3_17_17_15_1_26_17_17_9_15_1_15_1_17_4_13_13_15_1_1_15_4_4_13_9_3_1_13_4_15_1_3_13_1_26_3_13_6_6_15_26
3745,151,1328851620,19,20,1,1328852820,1200,729420,3643800,2914380,19_19_19_19_19_1_1_19_1_1_19_19_19_19_1_19
3746,180,1328851800,1,18,50,1328871180,19380,61380,3322080,3260700,50_50_50_50_50_50_1_50_1
3747,116,1328851800,1,18,1,1328858940,7140,174600,786600,612000,19_19_19_19_19_19_19_19_19_19_1
3748,151,1328852820,1,9,19,1328869740,16920,730620,3643800,2913180,19_19_19_19_19_1_1_19_1_1_19_19_19_19_1_19_1
3749,199,1328852820,1,9,1,1328854140,1320,175860,975720,799860,0_0_0_0_0_0_0_0_0_0_0_0_0_1_1_0_0_0_0_0_1
3750,199,1328854140,1,9,2,1329308400,454260,177180,975720,798540,0_0_0_0_0_0_0_0_0_0_0_0_0_1_1_0_0_0_0_0_1_1
3751,184,1328855460,9,4,9,1328858160,2700,358260,1800900,1442640,10_10_10_10_10_10_10_10_10_10_10_10_1_1_10_1_1_10_10_9_10_9_1_1_9
3752,147,1328855640,5,9,5,1328855760,120,1472760,1479360,6600,7_7_7_7_7_7_7_1_7_1_9_9_1_2_2_1_3_3_4_4_4_4_4_4_5_5_6_6_5
3753,147,1328855760,5,9,5,1328857740,1980,1472880,1479360,6480,7_7_7_7_7_7_7_1_7_1_9_9_1_2_2_1_3_3_4_4_4_4_4_4_5_5_6_6_5_5
3754,203,1328856000,15,2,5,1328857200,1200,860700,1897500,1036800,7_7_7_7_7_7_7_7_7_7_7_1_1_7_7_7_7_7_7_7_7_7_17_17_17_17_4_17_4_4_4_17_17_1_1_2_2_13_9_9_3_9_3_13_4_17_13_9_3_9_3_17_3_3_4_4_9_13_3_4_3_17_17_15_1_26_17_17_9_15_1_15_1_17_4_13_13_15_1_1_15_4_4_13_9_3_1_13_4_15_1_3_13_1_26_3_13_6_6_15_26_15
3755,203,1328857200,5,2,26,1328860200,3000,861900,1897500,1035600,7_7_7_7_7_7_7_7_7_7_7_1_1_7_7_7_7_7_7_7_7_7_17_17_17_17_4_17_4_4_4_17_17_1_1_2_2_13_9_9_3_9_3_13_4_17_13_9_3_9_3_17_3_3_4_4_9_13_3_4_3_17_17_15_1_26_17_17_9_15_1_15_1_17_4_13_13_15_1_1_15_4_4_13_9_3_1_13_4_15_1_3_13_1_26_3_13_6_6_15_26_15_5
3756,147,1328857740,5,9,5,1328862240,4500,1474860,1479360,4500,7_7_7_7_7_7_7_1_7_1_9_9_1_2_2_1_3_3_4_4_4_4_4_4_5_5_6_6_5_5_5
3757,184,1328858160,9,4,2,1329032340,174180,360960,1800900,1439940,10_10_10_10_10_10_10_10_10_10_10_10_1_1_10_1_1_10_10_9_10_9_1_1_9_9
3758,116,1328858940,1,18,1,1328859300,360,181740,786600,604860,19_19_19_19_19_19_19_19_19_19_1_1
3759,188,1328859180,0,20,1,1328860560,1380,187140,4327560,4140420,0_0_0_0_0
3760,116,1328859300,1,18,1,1328859360,60,182100,786600,604500,19_19_19_19_19_19_19_19_19_19_1_1_1
3761,116,1328859360,1,18,3,1328997600,138240,182160,786600,604440,19_19_19_19_19_19_19_19_19_19_1_1_1_1
3762,71,1328859420,1,18,1,1328863200,3780,2597820,3996240,1398420,29_29_1_1_7_7_1_7_1_7_7_7_7_7_1_7_1_7_7_7_7_7_7_1
3763,141,1328859780,3,4,1,1328868000,8220,3206580,7406100,4199520,1_1_16_16_16_16_16_1_16_16_1_1_1_16_16_16_16_16_16_16_16_16_16_16_16_16_16_16_1_1_1_1_1_1_1_1_1_1_1_1_16_2_2_16_3_3_3_3_3_3_18_18_18_18_18_3_18_3_3_3_5_5_5_5_5_5_3_3_4_4_4_4_4_3
3764,203,1328860200,25,28,26,1328860320,120,864900,1897500,1032600,7_7_7_7_7_7_7_7_7_7_7_1_1_7_7_7_7_7_7_7_7_7_17_17_17_17_4_17_4_4_4_17_17_1_1_2_2_13_9_9_3_9_3_13_4_17_13_9_3_9_3_17_3_3_4_4_9_13_3_4_3_17_17_15_1_26_17_17_9_15_1_15_1_17_4_13_13_15_1_1_15_4_4_13_9_3_1_13_4_15_1_3_13_1_26_3_13_6_6_15_26_15_5_26_25
3765,203,1328860200,26,13,25,1328860200,0,864900,1897500,1032600,7_7_7_7_7_7_7_7_7_7_7_1_1_7_7_7_7_7_7_7_7_7_17_17_17_17_4_17_4_4_4_17_17_1_1_2_2_13_9_9_3_9_3_13_4_17_13_9_3_9_3_17_3_3_4_4_9_13_3_4_3_17_17_15_1_26_17_17_9_15_1_15_1_17_4_13_13_15_1_1_15_4_4_13_9_3_1_13_4_15_1_3_13_1_26_3_13_6_6_15_26_15_5_26
3766,203,1328860320,26,13,26,1328860380,60,865020,1897500,1032480,7_7_7_7_7_7_7_7_7_7_7_1_1_7_7_7_7_7_7_7_7_7_17_17_17_17_4_17_4_4_4_17_17_1_1_2_2_13_9_9_3_9_3_13_4_17_13_9_3_9_3_17_3_3_4_4_9_13_3_4_3_17_17_15_1_26_17_17_9_15_1_15_1_17_4_13_13_15_1_1_15_4_4_13_9_3_1_13_4_15_1_3_13_1_26_3_13_6_6_15_26_15_5_26_25_26
3767,73,1328860320,18,23,18,1328860380,60,856320,1303500,447180,1_1_9_9_3_3_3_9_3_9_9_9_18_18_18_18
3768,203,1328860380,26,13,5,1328860560,180,865080,1897500,1032420,7_7_7_7_7_7_7_7_7_7_7_1_1_7_7_7_7_7_7_7_7_7_17_17_17_17_4_17_4_4_4_17_17_1_1_2_2_13_9_9_3_9_3_13_4_17_13_9_3_9_3_17_3_3_4_4_9_13_3_4_3_17_17_15_1_26_17_17_9_15_1_15_1_17_4_13_13_15_1_1_15_4_4_13_9_3_1_13_4_15_1_3_13_1_26_3_13_6_6_15_26_15_5_26_25_26_26
3769,73,1328860380,18,23,18,1328870640,10260,856380,1303500,447120,1_1_9_9_3_3_3_9_3_9_9_9_18_18_18_18_18
3770,188,1328860560,1,2,1,1328864400,3840,188520,4327560,4139040,0_0_0_0_0_1
3771,203,1328860560,5,2,25,1328864700,4140,865260,1897500,1032240,7_7_7_7_7_7_7_7_7_7_7_1_1_7_7_7_7_7_7_7_7_7_17_17_17_17_4_17_4_4_4_17_17_1_1_2_2_13_9_9_3_9_3_13_4_17_13_9_3_9_3_17_3_3_4_4_9_13_3_4_3_17_17_15_1_26_17_17_9_15_1_15_1_17_4_13_13_15_1_1_15_4_4_13_9_3_1_13_4_15_1_3_13_1_26_3_13_6_6_15_26_15_5_26_25_26_26_5
3772,147,1328862240,5,9,99,1328862240,0,1479360,1479360,0,7_7_7_7_7_7_7_1_7_1_9_9_1_2_2_1_3_3_4_4_4_4_4_4_5_5_6_6_5_5_5_5
3773,71,1328863200,1,18,7,1328871180,7980,2601600,3996240,1394640,29_29_1_1_7_7_1_7_1_7_7_7_7_7_1_7_1_7_7_7_7_7_7_1_1
3774,130,1328863260,15,18,15,1328871120,7860,2139600,3083940,944340,26_26_26_26_26_26_8_8_26_26_26_26_26_26_26_26_26_26_26_8_26_8_17_17_1_1_17_1_17_17_1_17_17_17_17_17_17_17_17_1_17_17_1_17_17_1_17_1_17_17_1_17_1_3_3_1_1_17_17_17_18_17_1_18_4_18_1_4_4_18_18_3_17_1_3_1_15_4_4_3_3_18_15_18_4_18_4_4_15_4_18_18_4_15_4_4_4_4_4_4_15_15_15_15_15
3775,188,1328864400,1,2,0,1328869980,5580,192360,4327560,4135200,0_0_0_0_0_1_1
3776,203,1328864700,25,28,3,1328871000,6300,869400,1897500,1028100,7_7_7_7_7_7_7_7_7_7_7_1_1_7_7_7_7_7_7_7_7_7_17_17_17_17_4_17_4_4_4_17_17_1_1_2_2_13_9_9_3_9_3_13_4_17_13_9_3_9_3_17_3_3_4_4_9_13_3_4_3_17_17_15_1_26_17_17_9_15_1_15_1_17_4_13_13_15_1_1_15_4_4_13_9_3_1_13_4_15_1_3_13_1_26_3_13_6_6_15_26_15_5_26_25_26_26_5_25
3777,98,1328865000,5,2,5,1328868000,3000,3125580,7319880,4194300,34_34_2_2_35_35_34_34_2_2_3_3_3_3_3_3_18_18_3_3_3_18_3_3_3_18_18_18_18_3_3_18_18_18_18_18_18_18_18_3_3_18_39_3_3_39_3_3_3_3_4_4_5_5_5_5_5_5_4_4_4_5_3_5_5_3_5_4_4_4_5_5_5_5_6_6_6_6_5_5_5_5_5_5_5_5_5_5_5
3778,98,1328868000,5,2,6,1328997600,129600,3128580,7319880,4191300,34_34_2_2_35_35_34_34_2_2_3_3_3_3_3_3_18_18_3_3_3_18_3_3_3_18_18_18_18_3_3_18_18_18_18_18_18_18_18_3_3_18_39_3_3_39_3_3_3_3_4_4_5_5_5_5_5_5_4_4_4_5_3_5_5_3_5_4_4_4_5_5_5_5_6_6_6_6_5_5_5_5_5_5_5_5_5_5_5_5
3779,141,1328868000,1,2,3,1328869800,1800,3214800,7406100,4191300,1_1_16_16_16_16_16_1_16_16_1_1_1_16_16_16_16_16_16_16_16_16_16_16_16_16_16_16_1_1_1_1_1_1_1_1_1_1_1_1_16_2_2_16_3_3_3_3_3_3_18_18_18_18_18_3_18_3_3_3_5_5_5_5_5_5_3_3_4_4_4_4_4_3_1
3780,151,1328869740,19,20,19,1328950020,80280,747540,3643800,2896260,19_19_19_19_19_1_1_19_1_1_19_19_19_19_1_19_1_19
3781,141,1328869800,3,4,1,1328870700,900,3216600,7406100,4189500,1_1_16_16_16_16_16_1_16_16_1_1_1_16_16_16_16_16_16_16_16_16_16_16_16_16_16_16_1_1_1_1_1_1_1_1_1_1_1_1_16_2_2_16_3_3_3_3_3_3_18_18_18_18_18_3_18_3_3_3_5_5_5_5_5_5_3_3_4_4_4_4_4_3_1_3
3782,188,1328869980,0,20,0,1328954400,84420,197940,4327560,4129620,0_0_0_0_0_1_1_0
3783,73,1328870640,18,23,18,1328990640,120000,866640,1303500,436860,1_1_9_9_3_3_3_9_3_9_9_9_18_18_18_18_18_18
3784,141,1328870700,4,22,18,1329060120,189420,3217500,7406100,4188600,1_1_16_16_16_16_16_1_16_16_1_1_1_16_16_16_16_16_16_16_16_16_16_16_16_16_16_16_1_1_1_1_1_1_1_1_1_1_1_1_16_2_2_16_3_3_3_3_3_3_18_18_18_18_18_3_18_3_3_3_5_5_5_5_5_5_3_3_4_4_4_4_4_3_1_3_1_4
3785,141,1328870700,1,2,4,1328870700,0,3217500,7406100,4188600,1_1_16_16_16_16_16_1_16_16_1_1_1_16_16_16_16_16_16_16_16_16_16_16_16_16_16_16_1_1_1_1_1_1_1_1_1_1_1_1_16_2_2_16_3_3_3_3_3_3_18_18_18_18_18_3_18_3_3_3_5_5_5_5_5_5_3_3_4_4_4_4_4_3_1_3_1
3786,203,1328871000,3,3,3,1328871120,120,875700,1897500,1021800,7_7_7_7_7_7_7_7_7_7_7_1_1_7_7_7_7_7_7_7_7_7_17_17_17_17_4_17_4_4_4_17_17_1_1_2_2_13_9_9_3_9_3_13_4_17_13_9_3_9_3_17_3_3_4_4_9_13_3_4_3_17_17_15_1_26_17_17_9_15_1_15_1_17_4_13_13_15_1_1_15_4_4_13_9_3_1_13_4_15_1_3_13_1_26_3_13_6_6_15_26_15_5_26_25_26_26_5_25_3
3787,203,1328871120,3,3,4,1329026220,155100,875820,1897500,1021680,7_7_7_7_7_7_7_7_7_7_7_1_1_7_7_7_7_7_7_7_7_7_17_17_17_17_4_17_4_4_4_17_17_1_1_2_2_13_9_9_3_9_3_13_4_17_13_9_3_9_3_17_3_3_4_4_9_13_3_4_3_17_17_15_1_26_17_17_9_15_1_15_1_17_4_13_13_15_1_1_15_4_4_13_9_3_1_13_4_15_1_3_13_1_26_3_13_6_6_15_26_15_5_26_25_26_26_5_25_3_3_3
3788,130,1328871120,15,18,15,1329023100,151980,2147460,3083940,936480,26_26_26_26_26_26_8_8_26_26_26_26_26_26_26_26_26_26_26_8_26_8_17_17_1_1_17_1_17_17_1_17_17_17_17_17_17_17_17_1_17_17_1_17_17_1_17_1_17_17_1_17_1_3_3_1_1_17_17_17_18_17_1_18_4_18_1_4_4_18_18_3_17_1_3_1_15_4_4_3_3_18_15_18_4_18_4_4_15_4_18_18_4_15_4_4_4_4_4_4_15_15_15_15_15_15
3789,203,1328871120,3,3,3,1328871120,0,875820,1897500,1021680,7_7_7_7_7_7_7_7_7_7_7_1_1_7_7_7_7_7_7_7_7_7_17_17_17_17_4_17_4_4_4_17_17_1_1_2_2_13_9_9_3_9_3_13_4_17_13_9_3_9_3_17_3_3_4_4_9_13_3_4_3_17_17_15_1_26_17_17_9_15_1_15_1_17_4_13_13_15_1_1_15_4_4_13_9_3_1_13_4_15_1_3_13_1_26_3_13_6_6_15_26_15_5_26_25_26_26_5_25_3_3
3790,71,1328871180,7,8,7,1328991000,119820,2609580,3996240,1386660,29_29_1_1_7_7_1_7_1_7_7_7_7_7_1_7_1_7_7_7_7_7_7_1_1_7
3791,180,1328871180,50,8,50,1328990700,119520,80760,3322080,3241320,50_50_50_50_50_50_1_50_1_50
3792,151,1328950020,19,0,19,1328952660,2640,827820,3643800,2815980,19_19_19_19_19_1_1_19_1_1_19_19_19_19_1_19_1_19_19
3793,151,1328952660,19,0,19,1328954400,1740,830460,3643800,2813340,19_19_19_19_19_1_1_19_1_1_19_19_19_19_1_19_1_19_19_19
3794,188,1328954400,0,11,0,1328958480,4080,282360,4327560,4045200,0_0_0_0_0_1_1_0_0
3795,151,1328954400,19,11,19,1328990340,35940,832200,3643800,2811600,19_19_19_19_19_1_1_19_1_1_19_19_19_19_1_19_1_19_19_19_19
3796,188,1328958480,0,0,0,1328979600,21120,286440,4327560,4041120,0_0_0_0_0_1_1_0_0_0
3797,188,1328979600,0,11,0,1328992560,12960,307560,4327560,4020000,0_0_0_0_0_1_1_0_0_0_0
3798,151,1328990340,19,11,19,1328990940,600,868140,3643800,2775660,19_19_19_19_19_1_1_19_1_1_19_19_19_19_1_19_1_19_19_19_19_19
3799,73,1328990640,18,17,18,1329022380,31740,986640,1303500,316860,1_1_9_9_3_3_3_9_3_9_9_9_18_18_18_18_18_18_18
3800,180,1328990700,50,10,50,1329021420,30720,200280,3322080,3121800,50_50_50_50_50_50_1_50_1_50_50
3801,151,1328990940,19,11,19,1328998260,7320,868740,3643800,2775060,19_19_19_19_19_1_1_19_1_1_19_19_19_19_1_19_1_19_19_19_19_19_19
3802,71,1328991000,7,10,7,1329021420,30420,2729400,3996240,1266840,29_29_1_1_7_7_1_7_1_7_7_7_7_7_1_7_1_7_7_7_7_7_7_1_1_7_7
3803,188,1328992560,0,11,0,1329021480,28920,320520,4327560,4007040,0_0_0_0_0_1_1_0_0_0_0_0
3804,182,1328994840,14,17,14,1329019920,25080,217500,915060,697560,14_14_14_14_14_14_14
3805,198,1328997600,9,4,9,1329002100,4500,490320,708660,218340,10_10_10_10_1_1_9
3806,161,1328997600,4,22,4,1329015600,18000,1087980,1955580,867600,10_24_24_10_10_10_10_10_10_10_10_10_10_10_10_10_9_9_1_1_4
3807,98,1328997600,6,7,6,1329001200,3600,3258180,7319880,4061700,34_34_2_2_35_35_34_34_2_2_3_3_3_3_3_3_18_18_3_3_3_18_3_3_3_18_18_18_18_3_3_18_18_18_18_18_18_18_18_3_3_18_39_3_3_39_3_3_3_3_4_4_5_5_5_5_5_5_4_4_4_5_3_5_5_3_5_4_4_4_5_5_5_5_6_6_6_6_5_5_5_5_5_5_5_5_5_5_5_5_6
3808,119,1328997600,3,4,3,1329002100,4500,2047980,2742780,694800,7_7_7_1_1_7_7_7_7_7_7_7_7_7_1_1_2_2_3
3809,116,1328997600,3,4,3,1329002100,4500,320400,786600,466200,19_19_19_19_19_19_19_19_19_19_1_1_1_1_3
3810,151,1328998260,19,11,19,1328998260,0,876060,3643800,2767740,19_19_19_19_19_1_1_19_1_1_19_19_19_19_1_19_1_19_19_19_19_19_19_19
3811,151,1328998260,19,11,19,1329021420,23160,876060,3643800,2767740,19_19_19_19_19_1_1_19_1_1_19_19_19_19_1_19_1_19_19_19_19_19_19_19_19
3812,98,1329001200,6,7,5,1329022800,21600,3261780,7319880,4058100,34_34_2_2_35_35_34_34_2_2_3_3_3_3_3_3_18_18_3_3_3_18_3_3_3_18_18_18_18_3_3_18_18_18_18_18_18_18_18_3_3_18_39_3_3_39_3_3_3_3_4_4_5_5_5_5_5_5_4_4_4_5_3_5_5_3_5_4_4_4_5_5_5_5_6_6_6_6_5_5_5_5_5_5_5_5_5_5_5_5_6_6
3813,119,1329002100,3,4,14,1329174000,171900,2052480,2742780,690300,7_7_7_1_1_7_7_7_7_7_7_7_7_7_1_1_2_2_3_3
3814,198,1329002100,9,4,9,1329036360,34260,494820,708660,213840,10_10_10_10_1_1_9_9
3815,116,1329002100,3,4,19,1329033960,31860,324900,786600,461700,19_19_19_19_19_19_19_19_19_19_1_1_1_1_3_3
3816,161,1329015600,4,22,3,1329041160,25560,1105980,1955580,849600,10_24_24_10_10_10_10_10_10_10_10_10_10_10_10_10_9_9_1_1_4_4
3817,182,1329019920,14,17,5,1329627000,607080,242580,915060,672480,14_14_14_14_14_14_14_14
3818,71,1329021420,7,10,7,1329022260,840,2759820,3996240,1236420,29_29_1_1_7_7_1_7_1_7_7_7_7_7_1_7_1_7_7_7_7_7_7_1_1_7_7_7
3819,180,1329021420,50,10,50,1329022680,1260,231000,3322080,3091080,50_50_50_50_50_50_1_50_1_50_50_50
3820,151,1329021420,19,11,1,1329022200,780,899220,3643800,2744580,19_19_19_19_19_1_1_19_1_1_19_19_19_19_1_19_1_19_19_19_19_19_19_19_19_19
3821,188,1329021480,0,11,0,1329023220,1740,349440,4327560,3978120,0_0_0_0_0_1_1_0_0_0_0_0_0
3822,151,1329022200,1,9,19,1329023340,1140,900000,3643800,2743800,19_19_19_19_19_1_1_19_1_1_19_19_19_19_1_19_1_19_19_19_19_19_19_19_19_19_1
3823,71,1329022260,7,8,7,1329023160,900,2760660,3996240,1235580,29_29_1_1_7_7_1_7_1_7_7_7_7_7_1_7_1_7_7_7_7_7_7_1_1_7_7_7_7
3824,73,1329022380,18,17,18,1329026280,3900,1018380,1303500,285120,1_1_9_9_3_3_3_9_3_9_9_9_18_18_18_18_18_18_18_18
3825,180,1329022680,50,12,50,1329024420,1740,232260,3322080,3089820,50_50_50_50_50_50_1_50_1_50_50_50_50
3826,98,1329022800,5,2,5,1329026400,3600,3283380,7319880,4036500,34_34_2_2_35_35_34_34_2_2_3_3_3_3_3_3_18_18_3_3_3_18_3_3_3_18_18_18_18_3_3_18_18_18_18_18_18_18_18_3_3_18_39_3_3_39_3_3_3_3_4_4_5_5_5_5_5_5_4_4_4_5_3_5_5_3_5_4_4_4_5_5_5_5_6_6_6_6_5_5_5_5_5_5_5_5_5_5_5_5_6_6_5
3827,130,1329023100,15,18,15,1329055740,32640,2299440,3083940,784500,26_26_26_26_26_26_8_8_26_26_26_26_26_26_26_26_26_26_26_8_26_8_17_17_1_1_17_1_17_17_1_17_17_17_17_17_17_17_17_1_17_17_1_17_17_1_17_1_17_17_1_17_1_3_3_1_1_17_17_17_18_17_1_18_4_18_1_4_4_18_18_3_17_1_3_1_15_4_4_3_3_18_15_18_4_18_4_4_15_4_18_18_4_15_4_4_4_4_4_4_15_15_15_15_15_15_15
3828,71,1329023160,7,8,7,1329030000,6840,2761560,3996240,1234680,29_29_1_1_7_7_1_7_1_7_7_7_7_7_1_7_1_7_7_7_7_7_7_1_1_7_7_7_7_7
3829,188,1329023220,0,1,0,1329033600,10380,351180,4327560,3976380,0_0_0_0_0_1_1_0_0_0_0_0_0_0
3830,151,1329023340,19,1,19,1329026400,3060,901140,3643800,2742660,19_19_19_19_19_1_1_19_1_1_19_19_19_19_1_19_1_19_19_19_19_19_19_19_19_19_1_19
3831,180,1329024420,50,12,50,1329030240,5820,234000,3322080,3088080,50_50_50_50_50_50_1_50_1_50_50_50_50_50
3832,203,1329026220,4,19,4,1329027060,840,1030920,1897500,866580,7_7_7_7_7_7_7_7_7_7_7_1_1_7_7_7_7_7_7_7_7_7_17_17_17_17_4_17_4_4_4_17_17_1_1_2_2_13_9_9_3_9_3_13_4_17_13_9_3_9_3_17_3_3_4_4_9_13_3_4_3_17_17_15_1_26_17_17_9_15_1_15_1_17_4_13_13_15_1_1_15_4_4_13_9_3_1_13_4_15_1_3_13_1_26_3_13_6_6_15_26_15_5_26_25_26_26_5_25_3_3_3_4
3833,73,1329026280,18,5,18,1329054660,28380,1022280,1303500,281220,1_1_9_9_3_3_3_9_3_9_9_9_18_18_18_18_18_18_18_18_18
3834,98,1329026400,5,2,34,1329036780,10380,3286980,7319880,4032900,34_34_2_2_35_35_34_34_2_2_3_3_3_3_3_3_18_18_3_3_3_18_3_3_3_18_18_18_18_3_3_18_18_18_18_18_18_18_18_3_3_18_39_3_3_39_3_3_3_3_4_4_5_5_5_5_5_5_4_4_4_5_3_5_5_3_5_4_4_4_5_5_5_5_6_6_6_6_5_5_5_5_5_5_5_5_5_5_5_5_6_6_5_5
3835,151,1329026400,19,1,1,1329032940,6540,904200,3643800,2739600,19_19_19_19_19_1_1_19_1_1_19_19_19_19_1_19_1_19_19_19_19_19_19_19_19_19_1_19_19
3836,203,1329027060,4,19,4,1329027120,60,1031760,1897500,865740,7_7_7_7_7_7_7_7_7_7_7_1_1_7_7_7_7_7_7_7_7_7_17_17_17_17_4_17_4_4_4_17_17_1_1_2_2_13_9_9_3_9_3_13_4_17_13_9_3_9_3_17_3_3_4_4_9_13_3_4_3_17_17_15_1_26_17_17_9_15_1_15_1_17_4_13_13_15_1_1_15_4_4_13_9_3_1_13_4_15_1_3_13_1_26_3_13_6_6_15_26_15_5_26_25_26_26_5_25_3_3_3_4_4
3837,203,1329027120,4,19,13,1329027540,420,1031820,1897500,865680,7_7_7_7_7_7_7_7_7_7_7_1_1_7_7_7_7_7_7_7_7_7_17_17_17_17_4_17_4_4_4_17_17_1_1_2_2_13_9_9_3_9_3_13_4_17_13_9_3_9_3_17_3_3_4_4_9_13_3_4_3_17_17_15_1_26_17_17_9_15_1_15_1_17_4_13_13_15_1_1_15_4_4_13_9_3_1_13_4_15_1_3_13_1_26_3_13_6_6_15_26_15_5_26_25_26_26_5_25_3_3_3_4_4_4
3838,203,1329027540,13,15,4,1329033780,6240,1032240,1897500,865260,7_7_7_7_7_7_7_7_7_7_7_1_1_7_7_7_7_7_7_7_7_7_17_17_17_17_4_17_4_4_4_17_17_1_1_2_2_13_9_9_3_9_3_13_4_17_13_9_3_9_3_17_3_3_4_4_9_13_3_4_3_17_17_15_1_26_17_17_9_15_1_15_1_17_4_13_13_15_1_1_15_4_4_13_9_3_1_13_4_15_1_3_13_1_26_3_13_6_6_15_26_15_5_26_25_26_26_5_25_3_3_3_4_4_4_13
3839,114,1329027660,2,3,1,1329033000,5340,968340,1201080,232740,19_19_19_19_19_19_19_19_19_19_19_19_9_9_1_1_2_2_9_9_6_6_19_3_19_19_3_5_5_5_1_1_5_19_2
3840,71,1329030000,7,8,7,1329055140,25140,2768400,3996240,1227840,29_29_1_1_7_7_1_7_1_7_7_7_7_7_1_7_1_7_7_7_7_7_7_1_1_7_7_7_7_7_7
3841,180,1329030240,50,8,50,1329055140,24900,239820,3322080,3082260,50_50_50_50_50_50_1_50_1_50_50_50_50_50_50
3842,184,1329032340,2,3,2,1329035160,2820,535140,1800900,1265760,10_10_10_10_10_10_10_10_10_10_10_10_1_1_10_1_1_10_10_9_10_9_1_1_9_9_2
3843,151,1329032940,1,9,1,1329195720,162780,910740,3643800,2733060,19_19_19_19_19_1_1_19_1_1_19_19_19_19_1_19_1_19_19_19_19_19_19_19_19_19_1_19_19_1
3844,114,1329033000,1,9,1,1329033180,180,973680,1201080,227400,19_19_19_19_19_19_19_19_19_19_19_19_9_9_1_1_2_2_9_9_6_6_19_3_19_19_3_5_5_5_1_1_5_19_2_1
3845,114,1329033180,1,9,9,1329034560,1380,973860,1201080,227220,19_19_19_19_19_19_19_19_19_19_19_19_9_9_1_1_2_2_9_9_6_6_19_3_19_19_3_5_5_5_1_1_5_19_2_1_1
3846,188,1329033600,0,1,0,1329036300,2700,361560,4327560,3966000,0_0_0_0_0_1_1_0_0_0_0_0_0_0_0
3847,203,1329033780,4,19,4,1329033900,120,1038480,1897500,859020,7_7_7_7_7_7_7_7_7_7_7_1_1_7_7_7_7_7_7_7_7_7_17_17_17_17_4_17_4_4_4_17_17_1_1_2_2_13_9_9_3_9_3_13_4_17_13_9_3_9_3_17_3_3_4_4_9_13_3_4_3_17_17_15_1_26_17_17_9_15_1_15_1_17_4_13_13_15_1_1_15_4_4_13_9_3_1_13_4_15_1_3_13_1_26_3_13_6_6_15_26_15_5_26_25_26_26_5_25_3_3_3_4_4_4_13_4
3848,203,1329033900,4,19,13,1329036780,2880,1038600,1897500,858900,7_7_7_7_7_7_7_7_7_7_7_1_1_7_7_7_7_7_7_7_7_7_17_17_17_17_4_17_4_4_4_17_17_1_1_2_2_13_9_9_3_9_3_13_4_17_13_9_3_9_3_17_3_3_4_4_9_13_3_4_3_17_17_15_1_26_17_17_9_15_1_15_1_17_4_13_13_15_1_1_15_4_4_13_9_3_1_13_4_15_1_3_13_1_26_3_13_6_6_15_26_15_5_26_25_26_26_5_25_3_3_3_4_4_4_13_4_4
3849,116,1329033960,19,16,2,1329035400,1440,356760,786600,429840,19_19_19_19_19_19_19_19_19_19_1_1_1_1_3_3_19
3850,114,1329034560,9,4,2,1329035160,600,975240,1201080,225840,19_19_19_19_19_19_19_19_19_19_19_19_9_9_1_1_2_2_9_9_6_6_19_3_19_19_3_5_5_5_1_1_5_19_2_1_1_9
3851,114,1329035160,2,3,9,1329040260,5100,975840,1201080,225240,19_19_19_19_19_19_19_19_19_19_19_19_9_9_1_1_2_2_9_9_6_6_19_3_19_19_3_5_5_5_1_1_5_19_2_1_1_9_2
3852,184,1329035160,2,3,5,1329144000,108840,537960,1800900,1262940,10_10_10_10_10_10_10_10_10_10_10_10_1_1_10_1_1_10_10_9_10_9_1_1_9_9_2_2
3853,116,1329035400,2,3,2,1329036360,960,358200,786600,428400,19_19_19_19_19_19_19_19_19_19_1_1_1_1_3_3_19_2
3854,188,1329036300,0,0,1,1329132000,95700,364260,4327560,3963300,0_0_0_0_0_1_1_0_0_0_0_0_0_0_0_0
3855,198,1329036360,9,3,9,1329036420,60,529080,708660,179580,10_10_10_10_1_1_9_9_9
3856,116,1329036360,2,3,19,1329046260,9900,359160,786600,427440,19_19_19_19_19_19_19_19_19_19_1_1_1_1_3_3_19_2_2
3857,198,1329036420,2,3,9,1329048720,12300,529140,708660,179520,10_10_10_10_1_1_9_9_9_9_2
3858,198,1329036420,9,3,2,1329036420,0,529140,708660,179520,10_10_10_10_1_1_9_9_9_9
3859,213,1329036420,0,1,0,1329062100,25680,0,3206820,3206820,0
3860,98,1329036780,34,15,34,1329046920,10140,3297360,7319880,4022520,34_34_2_2_35_35_34_34_2_2_3_3_3_3_3_3_18_18_3_3_3_18_3_3_3_18_18_18_18_3_3_18_18_18_18_18_18_18_18_3_3_18_39_3_3_39_3_3_3_3_4_4_5_5_5_5_5_5_4_4_4_5_3_5_5_3_5_4_4_4_5_5_5_5_6_6_6_6_5_5_5_5_5_5_5_5_5_5_5_5_6_6_5_5_34
3861,203,1329036780,13,15,4,1329047880,11100,1041480,1897500,856020,7_7_7_7_7_7_7_7_7_7_7_1_1_7_7_7_7_7_7_7_7_7_17_17_17_17_4_17_4_4_4_17_17_1_1_2_2_13_9_9_3_9_3_13_4_17_13_9_3_9_3_17_3_3_4_4_9_13_3_4_3_17_17_15_1_26_17_17_9_15_1_15_1_17_4_13_13_15_1_1_15_4_4_13_9_3_1_13_4_15_1_3_13_1_26_3_13_6_6_15_26_15_5_26_25_26_26_5_25_3_3_3_4_4_4_13_4_4_13
3862,114,1329040260,9,4,3,1329084000,43740,980940,1201080,220140,19_19_19_19_19_19_19_19_19_19_19_19_9_9_1_1_2_2_9_9_6_6_19_3_19_19_3_5_5_5_1_1_5_19_2_1_1_9_2_9
3863,161,1329041160,3,3,3,1329053160,12000,1131540,1955580,824040,10_24_24_10_10_10_10_10_10_10_10_10_10_10_10_10_9_9_1_1_4_4_3
3864,116,1329046260,19,16,3,1329055680,9420,369060,786600,417540,19_19_19_19_19_19_19_19_19_19_1_1_1_1_3_3_19_2_2_19
3865,98,1329046920,34,15,6,1329084000,37080,3307500,7319880,4012380,34_34_2_2_35_35_34_34_2_2_3_3_3_3_3_3_18_18_3_3_3_18_3_3_3_18_18_18_18_3_3_18_18_18_18_18_18_18_18_3_3_18_39_3_3_39_3_3_3_3_4_4_5_5_5_5_5_5_4_4_4_5_3_5_5_3_5_4_4_4_5_5_5_5_6_6_6_6_5_5_5_5_5_5_5_5_5_5_5_5_6_6_5_5_34_34
3866,60,1329046920,34,15,34,1329051300,4380,3388920,7401300,4012380,3_3_18_18_18_18_18_18_5_5_5_5_5_5_5_5_34
3867,203,1329047880,4,19,4,1329047940,60,1052580,1897500,844920,7_7_7_7_7_7_7_7_7_7_7_1_1_7_7_7_7_7_7_7_7_7_17_17_17_17_4_17_4_4_4_17_17_1_1_2_2_13_9_9_3_9_3_13_4_17_13_9_3_9_3_17_3_3_4_4_9_13_3_4_3_17_17_15_1_26_17_17_9_15_1_15_1_17_4_13_13_15_1_1_15_4_4_13_9_3_1_13_4_15_1_3_13_1_26_3_13_6_6_15_26_15_5_26_25_26_26_5_25_3_3_3_4_4_4_13_4_4_13_4
3868,203,1329047940,4,19,4,1329054720,6780,1052640,1897500,844860,7_7_7_7_7_7_7_7_7_7_7_1_1_7_7_7_7_7_7_7_7_7_17_17_17_17_4_17_4_4_4_17_17_1_1_2_2_13_9_9_3_9_3_13_4_17_13_9_3_9_3_17_3_3_4_4_9_13_3_4_3_17_17_15_1_26_17_17_9_15_1_15_1_17_4_13_13_15_1_1_15_4_4_13_9_3_1_13_4_15_1_3_13_1_26_3_13_6_6_15_26_15_5_26_25_26_26_5_25_3_3_3_4_4_4_13_4_4_13_4_4
3869,198,1329048720,9,4,2,1329048780,60,541440,708660,167220,10_10_10_10_1_1_9_9_9_9_2_9
3870,198,1329048780,2,3,9,1329053220,4440,541500,708660,167160,10_10_10_10_1_1_9_9_9_9_2_9_2
3871,60,1329051300,34,15,6,1329084000,32700,3393300,7401300,4008000,3_3_18_18_18_18_18_18_5_5_5_5_5_5_5_5_34_34
3872,161,1329053160,3,3,4,1329069600,16440,1143540,1955580,812040,10_24_24_10_10_10_10_10_10_10_10_10_10_10_10_10_9_9_1_1_4_4_3_3
3873,143,1329053220,3,3,3,1329055620,2400,1582140,1898460,316320,10_10_10_1_10_1_10_1_1_10_10_10_10_10_1_1_10_1_10_1_10_10_10_10_1_1_1_1_1_1_9_9_3
3874,198,1329053220,9,4,6,1329170400,117180,545940,708660,162720,10_10_10_10_1_1_9_9_9_9_2_9_2_9
3875,73,1329054660,18,5,15,1329055920,1260,1050660,1303500,252840,1_1_9_9_3_3_3_9_3_9_9_9_18_18_18_18_18_18_18_18_18_18
3876,203,1329054720,4,19,4,1329056280,1560,1059420,1897500,838080,7_7_7_7_7_7_7_7_7_7_7_1_1_7_7_7_7_7_7_7_7_7_17_17_17_17_4_17_4_4_4_17_17_1_1_2_2_13_9_9_3_9_3_13_4_17_13_9_3_9_3_17_3_3_4_4_9_13_3_4_3_17_17_15_1_26_17_17_9_15_1_15_1_17_4_13_13_15_1_1_15_4_4_13_9_3_1_13_4_15_1_3_13_1_26_3_13_6_6_15_26_15_5_26_25_26_26_5_25_3_3_3_4_4_4_13_4_4_13_4_4_4
3877,71,1329055140,7,8,7,1329055620,480,2793540,3996240,1202700,29_29_1_1_7_7_1_7_1_7_7_7_7_7_1_7_1_7_7_7_7_7_7_1_1_7_7_7_7_7_7_7
3878,180,1329055140,50,8,50,1329055560,420,264720,3322080,3057360,50_50_50_50_50_50_1_50_1_50_50_50_50_50_50_50
3879,180,1329055560,50,10,50,1329079440,23880,265140,3322080,3056940,50_50_50_50_50_50_1_50_1_50_50_50_50_50_50_50_50
3880,71,1329055620,7,10,1,1329061320,5700,2794020,3996240,1202220,29_29_1_1_7_7_1_7_1_7_7_7_7_7_1_7_1_7_7_7_7_7_7_1_1_7_7_7_7_7_7_7_7
3881,143,1329055620,3,3,4,1329154800,99180,1584540,1898460,313920,10_10_10_1_10_1_10_1_1_10_10_10_10_10_1_1_10_1_10_1_10_10_10_10_1_1_1_1_1_1_9_9_3_3
3882,116,1329055680,3,3,3,1329061620,5940,378480,786600,408120,19_19_19_19_19_19_19_19_19_19_1_1_1_1_3_3_19_2_2_19_3
3883,130,1329055740,15,18,2,1329122280,66540,2332080,3083940,751860,26_26_26_26_26_26_8_8_26_26_26_26_26_26_26_26_26_26_26_8_26_8_17_17_1_1_17_1_17_17_1_17_17_17_17_17_17_17_17_1_17_17_1_17_17_1_17_1_17_17_1_17_1_3_3_1_1_17_17_17_18_17_1_18_4_18_1_4_4_18_18_3_17_1_3_1_15_4_4_3_3_18_15_18_4_18_4_4_15_4_18_18_4_15_4_4_4_4_4_4_15_15_15_15_15_15_15_15
3884,73,1329055920,15,18,15,1329061200,5280,1051920,1303500,251580,1_1_9_9_3_3_3_9_3_9_9_9_18_18_18_18_18_18_18_18_18_18_15
3885,203,1329056280,4,23,4,1329060120,3840,1060980,1897500,836520,7_7_7_7_7_7_7_7_7_7_7_1_1_7_7_7_7_7_7_7_7_7_17_17_17_17_4_17_4_4_4_17_17_1_1_2_2_13_9_9_3_9_3_13_4_17_13_9_3_9_3_17_3_3_4_4_9_13_3_4_3_17_17_15_1_26_17_17_9_15_1_15_1_17_4_13_13_15_1_1_15_4_4_13_9_3_1_13_4_15_1_3_13_1_26_3_13_6_6_15_26_15_5_26_25_26_26_5_25_3_3_3_4_4_4_13_4_4_13_4_4_4_4
3886,141,1329060120,18,23,3,1329061320,1200,3406920,7406100,3999180,1_1_16_16_16_16_16_1_16_16_1_1_1_16_16_16_16_16_16_16_16_16_16_16_16_16_16_16_1_1_1_1_1_1_1_1_1_1_1_1_16_2_2_16_3_3_3_3_3_3_18_18_18_18_18_3_18_3_3_3_5_5_5_5_5_5_3_3_4_4_4_4_4_3_1_3_1_4_18
3887,203,1329060120,4,23,4,1329108900,48780,1064820,1897500,832680,7_7_7_7_7_7_7_7_7_7_7_1_1_7_7_7_7_7_7_7_7_7_17_17_17_17_4_17_4_4_4_17_17_1_1_2_2_13_9_9_3_9_3_13_4_17_13_9_3_9_3_17_3_3_4_4_9_13_3_4_3_17_17_15_1_26_17_17_9_15_1_15_1_17_4_13_13_15_1_1_15_4_4_13_9_3_1_13_4_15_1_3_13_1_26_3_13_6_6_15_26_15_5_26_25_26_26_5_25_3_3_3_4_4_4_13_4_4_13_4_4_4_4_4
3888,73,1329061200,15,18,6,1329256800,195600,1057200,1303500,246300,1_1_9_9_3_3_3_9_3_9_9_9_18_18_18_18_18_18_18_18_18_18_15_15
3889,71,1329061320,1,18,1,1329062580,1260,2799720,3996240,1196520,29_29_1_1_7_7_1_7_1_7_7_7_7_7_1_7_1_7_7_7_7_7_7_1_1_7_7_7_7_7_7_7_7_1
3890,141,1329061320,3,4,3,1329065820,4500,3408120,7406100,3997980,1_1_16_16_16_16_16_1_16_16_1_1_1_16_16_16_16_16_16_16_16_16_16_16_16_16_16_16_1_1_1_1_1_1_1_1_1_1_1_1_16_2_2_16_3_3_3_3_3_3_18_18_18_18_18_3_18_3_3_3_5_5_5_5_5_5_3_3_4_4_4_4_4_3_1_3_1_4_18_3
3891,116,1329061620,3,3,19,1329070200,8580,384420,786600,402180,19_19_19_19_19_19_19_19_19_19_1_1_1_1_3_3_19_2_2_19_3_3
3892,213,1329062100,0,1,0,1329069300,7200,25680,3206820,3181140,0_0
3893,71,1329062580,1,18,7,1329081840,19260,2800980,3996240,1195260,29_29_1_1_7_7_1_7_1_7_7_7_7_7_1_7_1_7_7_7_7_7_7_1_1_7_7_7_7_7_7_7_7_1_1
3894,141,1329065820,3,4,18,1329068880,3060,3412620,7406100,3993480,1_1_16_16_16_16_16_1_16_16_1_1_1_16_16_16_16_16_16_16_16_16_16_16_16_16_16_16_1_1_1_1_1_1_1_1_1_1_1_1_16_2_2_16_3_3_3_3_3_3_18_18_18_18_18_3_18_3_3_3_5_5_5_5_5_5_3_3_4_4_4_4_4_3_1_3_1_4_18_3_3
3895,141,1329068880,18,23,18,1329069600,720,3415680,7406100,3990420,1_1_16_16_16_16_16_1_16_16_1_1_1_16_16_16_16_16_16_16_16_16_16_16_16_16_16_16_1_1_1_1_1_1_1_1_1_1_1_1_16_2_2_16_3_3_3_3_3_3_18_18_18_18_18_3_18_3_3_3_5_5_5_5_5_5_3_3_4_4_4_4_4_3_1_3_1_4_18_3_3_18
3896,213,1329069300,0,0,0,1329087960,18660,32880,3206820,3173940,0_0_0
3897,161,1329069600,4,23,4,1329078600,9000,1159980,1955580,795600,10_24_24_10_10_10_10_10_10_10_10_10_10_10_10_10_9_9_1_1_4_4_3_3_4
3898,141,1329069600,18,22,1,1329069780,180,3416400,7406100,3989700,1_1_16_16_16_16_16_1_16_16_1_1_1_16_16_16_16_16_16_16_16_16_16_16_16_16_16_16_1_1_1_1_1_1_1_1_1_1_1_1_16_2_2_16_3_3_3_3_3_3_18_18_18_18_18_3_18_3_3_3_5_5_5_5_5_5_3_3_4_4_4_4_4_3_1_3_1_4_18_3_3_18_18
3899,141,1329069780,1,22,1,1329070080,300,3416580,7406100,3989520,1_1_16_16_16_16_16_1_16_16_1_1_1_16_16_16_16_16_16_16_16_16_16_16_16_16_16_16_1_1_1_1_1_1_1_1_1_1_1_1_16_2_2_16_3_3_3_3_3_3_18_18_18_18_18_3_18_3_3_3_5_5_5_5_5_5_3_3_4_4_4_4_4_3_1_3_1_4_18_3_3_18_18_1
3900,141,1329070080,1,22,18,1329108600,38520,3416880,7406100,3989220,1_1_16_16_16_16_16_1_16_16_1_1_1_16_16_16_16_16_16_16_16_16_16_16_16_16_16_16_1_1_1_1_1_1_1_1_1_1_1_1_16_2_2_16_3_3_3_3_3_3_18_18_18_18_18_3_18_3_3_3_5_5_5_5_5_5_3_3_4_4_4_4_4_3_1_3_1_4_18_3_3_18_18_1_1
3901,116,1329070200,19,11,14,1329070500,300,393000,786600,393600,19_19_19_19_19_19_19_19_19_19_1_1_1_1_3_3_19_2_2_19_3_3_19
3902,116,1329070500,14,17,14,1329076800,6300,393300,786600,393300,19_19_19_19_19_19_19_19_19_19_1_1_1_1_3_3_19_2_2_19_3_3_19_14
3903,116,1329076800,14,17,19,1329078480,1680,399600,786600,387000,19_19_19_19_19_19_19_19_19_19_1_1_1_1_3_3_19_2_2_19_3_3_19_14_14_14
3904,116,1329076800,14,17,14,1329076800,0,399600,786600,387000,19_19_19_19_19_19_19_19_19_19_1_1_1_1_3_3_19_2_2_19_3_3_19_14_14
3905,116,1329078480,19,11,19,1329078540,60,401280,786600,385320,19_19_19_19_19_19_19_19_19_19_1_1_1_1_3_3_19_2_2_19_3_3_19_14_14_14_19
3906,116,1329078540,19,11,13,1329084000,5460,401340,786600,385260,19_19_19_19_19_19_19_19_19_19_1_1_1_1_3_3_19_2_2_19_3_3_19_14_14_14_19_19
3907,161,1329078600,4,23,4,1329082200,3600,1168980,1955580,786600,10_24_24_10_10_10_10_10_10_10_10_10_10_10_10_10_9_9_1_1_4_4_3_3_4_4_4
3908,161,1329078600,4,23,4,1329078600,0,1168980,1955580,786600,10_24_24_10_10_10_10_10_10_10_10_10_10_10_10_10_9_9_1_1_4_4_3_3_4_4
3909,180,1329079440,50,10,1,1329634800,555360,289020,3322080,3033060,50_50_50_50_50_50_1_50_1_50_50_50_50_50_50_50_50_50
3910,71,1329081840,7,10,7,1329083280,1440,2820240,3996240,1176000,29_29_1_1_7_7_1_7_1_7_7_7_7_7_1_7_1_7_7_7_7_7_7_1_1_7_7_7_7_7_7_7_7_1_1_7
3911,161,1329082200,4,23,4,1329109200,27000,1172580,1955580,783000,10_24_24_10_10_10_10_10_10_10_10_10_10_10_10_10_9_9_1_1_4_4_3_3_4_4_4_4
3912,71,1329083280,7,11,7,1329108060,24780,2821680,3996240,1174560,29_29_1_1_7_7_1_7_1_7_7_7_7_7_1_7_1_7_7_7_7_7_7_1_1_7_7_7_7_7_7_7_7_1_1_7_7
3913,173,1329084000,6,7,6,1329087600,3600,1092780,3215700,2122920,0_0_0_0_0_0_1_1_0_0_1_1_2_2_3_3_14_14_14_14_14_14_14_18_14_18_18_14_18_18_18_18_13_13_13_14_13_14_18_18_18_14_13_18_13_18_6_6_5_13_5_13_6
3914,98,1329084000,6,7,6,1329087600,3600,3344580,7319880,3975300,34_34_2_2_35_35_34_34_2_2_3_3_3_3_3_3_18_18_3_3_3_18_3_3_3_18_18_18_18_3_3_18_18_18_18_18_18_18_18_3_3_18_39_3_3_39_3_3_3_3_4_4_5_5_5_5_5_5_4_4_4_5_3_5_5_3_5_4_4_4_5_5_5_5_6_6_6_6_5_5_5_5_5_5_5_5_5_5_5_5_6_6_5_5_34_34_6
3915,70,1329084000,5,6,5,1329088500,4500,2937600,3064200,126600,6_6_5_5_1_1_5
3916,60,1329084000,6,7,6,1329087600,3600,3426000,7401300,3975300,3_3_18_18_18_18_18_18_5_5_5_5_5_5_5_5_34_34_6
3917,116,1329084000,13,25,13,1329088500,4500,406800,786600,379800,19_19_19_19_19_19_19_19_19_19_1_1_1_1_3_3_19_2_2_19_3_3_19_14_14_14_19_19_13
3918,114,1329084000,3,4,3,1329088500,4500,1024680,1201080,176400,19_19_19_19_19_19_19_19_19_19_19_19_9_9_1_1_2_2_9_9_6_6_19_3_19_19_3_5_5_5_1_1_5_19_2_1_1_9_2_9_3
3919,166,1329084000,6,7,6,1329087600,3600,1614600,1666080,51480,7_7_7_1_7_7_1_7_7_7_21_21_1_1_2_2_3_3_4_4_4_4_6
3920,173,1329087600,6,7,5,1329108780,21180,1096380,3215700,2119320,0_0_0_0_0_0_1_1_0_0_1_1_2_2_3_3_14_14_14_14_14_14_14_18_14_18_18_14_18_18_18_18_13_13_13_14_13_14_18_18_18_14_13_18_13_18_6_6_5_13_5_13_6_6
3921,60,1329087600,6,7,5,1329117300,29700,3429600,7401300,3971700,3_3_18_18_18_18_18_18_5_5_5_5_5_5_5_5_34_34_6_6
3922,98,1329087600,6,7,5,1329124200,36600,3348180,7319880,3971700,34_34_2_2_35_35_34_34_2_2_3_3_3_3_3_3_18_18_3_3_3_18_3_3_3_18_18_18_18_3_3_18_18_18_18_18_18_18_18_3_3_18_39_3_3_39_3_3_3_3_4_4_5_5_5_5_5_5_4_4_4_5_3_5_5_3_5_4_4_4_5_5_5_5_6_6_6_6_5_5_5_5_5_5_5_5_5_5_5_5_6_6_5_5_34_34_6_6
3923,166,1329087600,6,7,5,1329119700,32100,1618200,1666080,47880,7_7_7_1_7_7_1_7_7_7_21_21_1_1_2_2_3_3_4_4_4_4_6_6
3924,213,1329087960,0,0,0,1329088020,60,51540,3206820,3155280,0_0_0_0
3925,213,1329088020,0,0,1,1329108600,20580,51600,3206820,3155220,0_0_0_0_0
3926,116,1329088500,13,25,19,1329100260,11760,411300,786600,375300,19_19_19_19_19_19_19_19_19_19_1_1_1_1_3_3_19_2_2_19_3_3_19_14_14_14_19_19_13_13
3927,70,1329088500,5,6,1,1329203880,115380,2942100,3064200,122100,6_6_5_5_1_1_5_5
3928,114,1329088500,3,4,3,1329116460,27960,1029180,1201080,171900,19_19_19_19_19_19_19_19_19_19_19_19_9_9_1_1_2_2_9_9_6_6_19_3_19_19_3_5_5_5_1_1_5_19_2_1_1_9_2_9_3_3
3929,116,1329100260,19,11,14,1329108000,7740,423060,786600,363540,19_19_19_19_19_19_19_19_19_19_1_1_1_1_3_3_19_2_2_19_3_3_19_14_14_14_19_19_13_13_19
3930,218,1329100320,19,11,19,1329108180,7860,0,1974480,1974480,19
3931,116,1329108000,14,17,1,1329109200,1200,430800,786600,355800,19_19_19_19_19_19_19_19_19_19_1_1_1_1_3_3_19_2_2_19_3_3_19_14_14_14_19_19_13_13_19_14
3932,71,1329108060,7,11,7,1329110160,2100,2846460,3996240,1149780,29_29_1_1_7_7_1_7_1_7_7_7_7_7_1_7_1_7_7_7_7_7_7_1_1_7_7_7_7_7_7_7_7_1_1_7_7_7
3933,218,1329108180,19,11,19,1329157920,49740,7860,1974480,1966620,19_19
3934,213,1329108600,1,9,0,1329108720,120,72180,3206820,3134640,0_0_0_0_0_1
3935,141,1329108600,18,22,18,1329108840,240,3455400,7406100,3950700,1_1_16_16_16_16_16_1_16_16_1_1_1_16_16_16_16_16_16_16_16_16_16_16_16_16_16_16_1_1_1_1_1_1_1_1_1_1_1_1_16_2_2_16_3_3_3_3_3_3_18_18_18_18_18_3_18_3_3_3_5_5_5_5_5_5_3_3_4_4_4_4_4_3_1_3_1_4_18_3_3_18_18_1_1_18
3936,213,1329108720,0,0,1,1329112860,4140,72300,3206820,3134520,0_0_0_0_0_1_0
3937,173,1329108780,5,6,5,1329118020,9240,1117560,3215700,2098140,0_0_0_0_0_0_1_1_0_0_1_1_2_2_3_3_14_14_14_14_14_14_14_18_14_18_18_14_18_18_18_18_13_13_13_14_13_14_18_18_18_14_13_18_13_18_6_6_5_13_5_13_6_6_5
3938,141,1329108840,18,5,5,1329128400,19560,3455640,7406100,3950460,1_1_16_16_16_16_16_1_16_16_1_1_1_16_16_16_16_16_16_16_16_16_16_16_16_16_16_16_1_1_1_1_1_1_1_1_1_1_1_1_16_2_2_16_3_3_3_3_3_3_18_18_18_18_18_3_18_3_3_3_5_5_5_5_5_5_3_3_4_4_4_4_4_3_1_3_1_4_18_3_3_18_18_1_1_18_18
3939,203,1329108900,4,19,4,1329109380,480,1113600,1897500,783900,7_7_7_7_7_7_7_7_7_7_7_1_1_7_7_7_7_7_7_7_7_7_17_17_17_17_4_17_4_4_4_17_17_1_1_2_2_13_9_9_3_9_3_13_4_17_13_9_3_9_3_17_3_3_4_4_9_13_3_4_3_17_17_15_1_26_17_17_9_15_1_15_1_17_4_13_13_15_1_1_15_4_4_13_9_3_1_13_4_15_1_3_13_1_26_3_13_6_6_15_26_15_5_26_25_26_26_5_25_3_3_3_4_4_4_13_4_4_13_4_4_4_4_4_4
3940,161,1329109200,4,19,4,1329116880,7680,1199580,1955580,756000,10_24_24_10_10_10_10_10_10_10_10_10_10_10_10_10_9_9_1_1_4_4_3_3_4_4_4_4_4
3941,155,1329109200,1,2,1,1329115200,6000,519000,3225180,2706180,0_0_0_0_0_0_0_0_1
3942,116,1329109200,14,15,1,1329111000,1800,432000,786600,354600,19_19_19_19_19_19_19_19_19_19_1_1_1_1_3_3_19_2_2_19_3_3_19_14_14_14_19_19_13_13_19_14_1_13_14
3943,116,1329109200,1,18,13,1329109200,0,432000,786600,354600,19_19_19_19_19_19_19_19_19_19_1_1_1_1_3_3_19_2_2_19_3_3_19_14_14_14_19_19_13_13_19_14_1
3944,116,1329109200,13,15,14,1329109200,0,432000,786600,354600,19_19_19_19_19_19_19_19_19_19_1_1_1_1_3_3_19_2_2_19_3_3_19_14_14_14_19_19_13_13_19_14_1_13
3945,203,1329109380,4,19,26,1329114360,4980,1114080,1897500,783420,7_7_7_7_7_7_7_7_7_7_7_1_1_7_7_7_7_7_7_7_7_7_17_17_17_17_4_17_4_4_4_17_17_1_1_2_2_13_9_9_3_9_3_13_4_17_13_9_3_9_3_17_3_3_4_4_9_13_3_4_3_17_17_15_1_26_17_17_9_15_1_15_1_17_4_13_13_15_1_1_15_4_4_13_9_3_1_13_4_15_1_3_13_1_26_3_13_6_6_15_26_15_5_26_25_26_26_5_25_3_3_3_4_4_4_13_4_4_13_4_4_4_4_4_4_4
3946,71,1329110160,7,8,1,1329111000,840,2848560,3996240,1147680,29_29_1_1_7_7_1_7_1_7_7_7_7_7_1_7_1_7_7_7_7_7_7_1_1_7_7_7_7_7_7_7_7_1_1_7_7_7_7
3947,71,1329111000,1,18,1,1329118800,7800,2849400,3996240,1146840,29_29_1_1_7_7_1_7_1_7_7_7_7_7_1_7_1_7_7_7_7_7_7_1_1_7_7_7_7_7_7_7_7_1_1_7_7_7_7_1
3948,116,1329111000,1,18,2,1329114240,3240,433800,786600,352800,19_19_19_19_19_19_19_19_19_19_1_1_1_1_3_3_19_2_2_19_3_3_19_14_14_14_19_19_13_13_19_14_1_13_14_1
3949,163,1329111540,17,12,17,1329139320,27780,0,548880,548880,17
3950,123,1329112800,15,2,15,1329115200,2400,2158020,3545820,1387800,16_16_16_16_16_16_16_16_16_16_16_16_1_1_2_2_3_3_3_14_14_3_3_3_14_14_14_14_14_14_14_14_14_15_14_15_15
3951,213,1329112860,1,9,0,1329141420,28560,76440,3206820,3130380,0_0_0_0_0_1_0_1
3952,135,1329113340,1,9,1,1329119700,6360,3038940,5649480,2610540,19_19_19_19_19_19_19_19_19_19_19_19_1_19_1_19_19_19_1_1_1_1_19_19_19_19_19_19_1_1_1_1_19_19_19_19_19_19_19_19_19_19_19_19_1_19_1_19_19_19_19_19_19_1_19_1_1_1_2_2_1
3953,116,1329114240,2,3,2,1329116940,2700,437040,786600,349560,19_19_19_19_19_19_19_19_19_19_1_1_1_1_3_3_19_2_2_19_3_3_19_14_14_14_19_19_13_13_19_14_1_13_14_1_2
3954,203,1329114360,26,13,4,1329116940,2580,1119060,1897500,778440,7_7_7_7_7_7_7_7_7_7_7_1_1_7_7_7_7_7_7_7_7_7_17_17_17_17_4_17_4_4_4_17_17_1_1_2_2_13_9_9_3_9_3_13_4_17_13_9_3_9_3_17_3_3_4_4_9_13_3_4_3_17_17_15_1_26_17_17_9_15_1_15_1_17_4_13_13_15_1_1_15_4_4_13_9_3_1_13_4_15_1_3_13_1_26_3_13_6_6_15_26_15_5_26_25_26_26_5_25_3_3_3_4_4_4_13_4_4_13_4_4_4_4_4_4_4_26
3955,123,1329115200,15,2,15,1329116400,1200,2160420,3545820,1385400,16_16_16_16_16_16_16_16_16_16_16_16_1_1_2_2_3_3_3_14_14_3_3_3_14_14_14_14_14_14_14_14_14_15_14_15_15_15
3956,155,1329115200,1,2,1,1329116400,1200,525000,3225180,2700180,0_0_0_0_0_0_0_0_1_1
3957,79,1329115500,1,6,1,1329122700,7200,3487500,4151700,664200,15_1_15_1_26_26_26_26_26_26_26_26_26_26_26_26_26_26_26_26_8_8_1_1_10_10_10_10_10_10_41_1_1_41_6_6_41_41_41_41_18_14_15_18_15_14_1_1_14_14_14_14_1_1_1_1_1
3958,155,1329116400,1,2,1,1329117300,900,526200,3225180,2698980,0_0_0_0_0_0_0_0_1_1_1
3959,123,1329116400,15,2,15,1329121800,5400,2161620,3545820,1384200,16_16_16_16_16_16_16_16_16_16_16_16_1_1_2_2_3_3_3_14_14_3_3_3_14_14_14_14_14_14_14_14_14_15_14_15_15_15_15
3960,114,1329116460,3,4,3,1329119280,2820,1057140,1201080,143940,19_19_19_19_19_19_19_19_19_19_19_19_9_9_1_1_2_2_9_9_6_6_19_3_19_19_3_5_5_5_1_1_5_19_2_1_1_9_2_9_3_3_3
3961,161,1329116880,4,19,2,1329775200,658320,1207260,1955580,748320,10_24_24_10_10_10_10_10_10_10_10_10_10_10_10_10_9_9_1_1_4_4_3_3_4_4_4_4_4_4
3962,116,1329116940,2,3,3,1329117000,60,439740,786600,346860,19_19_19_19_19_19_19_19_19_19_1_1_1_1_3_3_19_2_2_19_3_3_19_14_14_14_19_19_13_13_19_14_1_13_14_1_2_2
3963,203,1329116940,4,19,5,1329132000,15060,1121640,1897500,775860,7_7_7_7_7_7_7_7_7_7_7_1_1_7_7_7_7_7_7_7_7_7_17_17_17_17_4_17_4_4_4_17_17_1_1_2_2_13_9_9_3_9_3_13_4_17_13_9_3_9_3_17_3_3_4_4_9_13_3_4_3_17_17_15_1_26_17_17_9_15_1_15_1_17_4_13_13_15_1_1_15_4_4_13_9_3_1_13_4_15_1_3_13_1_26_3_13_6_6_15_26_15_5_26_25_26_26_5_25_3_3_3_4_4_4_13_4_4_13_4_4_4_4_4_4_4_26_4
3964,116,1329117000,3,3,5,1329120000,3000,439800,786600,346800,19_19_19_19_19_19_19_19_19_19_1_1_1_1_3_3_19_2_2_19_3_3_19_14_14_14_19_19_13_13_19_14_1_13_14_1_2_2_3
3965,60,1329117300,5,2,5,1329120900,3600,3459300,7401300,3942000,3_3_18_18_18_18_18_18_5_5_5_5_5_5_5_5_34_34_6_6_5
3966,155,1329117300,1,2,2,1329127800,10500,527100,3225180,2698080,0_0_0_0_0_0_0_0_1_1_1_1
3967,173,1329118020,5,6,34,1331097300,1979280,1126800,3215700,2088900,0_0_0_0_0_0_1_1_0_0_1_1_2_2_3_3_14_14_14_14_14_14_14_18_14_18_18_14_18_18_18_18_13_13_13_14_13_14_18_18_18_14_13_18_13_18_6_6_5_13_5_13_6_6_5_5
3968,71,1329118800,1,18,1,1329119340,540,2857200,3996240,1139040,29_29_1_1_7_7_1_7_1_7_7_7_7_7_1_7_1_7_7_7_7_7_7_1_1_7_7_7_7_7_7_7_7_1_1_7_7_7_7_1_1
3969,114,1329119280,3,4,3,1329121920,2640,1059960,1201080,141120,19_19_19_19_19_19_19_19_19_19_19_19_9_9_1_1_2_2_9_9_6_6_19_3_19_19_3_5_5_5_1_1_5_19_2_1_1_9_2_9_3_3_3_3
3970,71,1329119340,1,18,1,1329120120,780,2857740,3996240,1138500,29_29_1_1_7_7_1_7_1_7_7_7_7_7_1_7_1_7_7_7_7_7_7_1_1_7_7_7_7_7_7_7_7_1_1_7_7_7_7_1_1_1
3971,166,1329119700,5,9,5,1329135480,15780,1650300,1666080,15780,7_7_7_1_7_7_1_7_7_7_21_21_1_1_2_2_3_3_4_4_4_4_6_6_5
3972,135,1329119700,1,9,2,1329147000,27300,3045300,5649480,2604180,19_19_19_19_19_19_19_19_19_19_19_19_1_19_1_19_19_19_1_1_1_1_19_19_19_19_19_19_1_1_1_1_19_19_19_19_19_19_19_19_19_19_19_19_1_19_1_19_19_19_19_19_19_1_19_1_1_1_2_2_1_1
3973,116,1329120000,5,18,3,1329121320,1320,442800,786600,343800,19_19_19_19_19_19_19_19_19_19_1_1_1_1_3_3_19_2_2_19_3_3_19_14_14_14_19_19_13_13_19_14_1_13_14_1_2_2_3_5
3974,71,1329120120,1,18,7,1329136440,16320,2858520,3996240,1137720,29_29_1_1_7_7_1_7_1_7_7_7_7_7_1_7_1_7_7_7_7_7_7_1_1_7_7_7_7_7_7_7_7_1_1_7_7_7_7_1_1_1_1
3975,60,1329120900,5,2,3,1333054800,3933900,3462900,7401300,3938400,3_3_18_18_18_18_18_18_5_5_5_5_5_5_5_5_34_34_6_6_5_5
3976,116,1329121320,3,3,5,1329127200,5880,444120,786600,342480,19_19_19_19_19_19_19_19_19_19_1_1_1_1_3_3_19_2_2_19_3_3_19_14_14_14_19_19_13_13_19_14_1_13_14_1_2_2_3_5_3
3977,123,1329121800,15,2,3,1330241580,1119780,2167020,3545820,1378800,16_16_16_16_16_16_16_16_16_16_16_16_1_1_2_2_3_3_3_14_14_3_3_3_14_14_14_14_14_14_14_14_14_15_14_15_15_15_15_15
3978,63,1329121800,1,2,1,1329130200,8400,2270340,6232860,3962520,16_16_16_16_16_16_16_16_16_0_0_16_16_0_16_16_0_16_16_0_0_16_16_16_0_0_16_0_0_16_0_16_0_0_0_16_1_1_1_16_16_16_0_1_1_1_16_0_0_16_16_0_16_0_16_0_0_2_2_1_1_0_0_0_0_2_2_2_2_2_2_0_1_0_1_1_0_0_0_1_1_0_0_1_1_1_0_0_0_0_0_2_2_2_2_0_0_0_0_0_0_1_1_1_1_0_0_16_0_16_16_16_16_16_0_0_1_1_2_2_1_1_16_0_2_16_2_2_2_0_1_1_1_1_1_16_16_1_1
3979,114,1329121920,3,4,3,1329125580,3660,1062600,1201080,138480,19_19_19_19_19_19_19_19_19_19_19_19_9_9_1_1_2_2_9_9_6_6_19_3_19_19_3_5_5_5_1_1_5_19_2_1_1_9_2_9_3_3_3_3_3
3980,130,1329122280,2,3,15,1329127200,4920,2398620,3083940,685320,26_26_26_26_26_26_8_8_26_26_26_26_26_26_26_26_26_26_26_8_26_8_17_17_1_1_17_1_17_17_1_17_17_17_17_17_17_17_17_1_17_17_1_17_17_1_17_1_17_17_1_17_1_3_3_1_1_17_17_17_18_17_1_18_4_18_1_4_4_18_18_3_17_1_3_1_15_4_4_3_3_18_15_18_4_18_4_4_15_4_18_18_4_15_4_4_4_4_4_4_15_15_15_15_15_15_15_15_2
3981,79,1329122700,1,6,1,1329775200,652500,3494700,4151700,657000,15_1_15_1_26_26_26_26_26_26_26_26_26_26_26_26_26_26_26_26_8_8_1_1_10_10_10_10_10_10_41_1_1_41_6_6_41_41_41_41_18_14_15_18_15_14_1_1_14_14_14_14_1_1_1_1_1_1
3982,98,1329124200,5,2,5,1329127200,3000,3384780,7319880,3935100,34_34_2_2_35_35_34_34_2_2_3_3_3_3_3_3_18_18_3_3_3_18_3_3_3_18_18_18_18_3_3_18_18_18_18_18_18_18_18_3_3_18_39_3_3_39_3_3_3_3_4_4_5_5_5_5_5_5_4_4_4_5_3_5_5_3_5_4_4_4_5_5_5_5_6_6_6_6_5_5_5_5_5_5_5_5_5_5_5_5_6_6_5_5_34_34_6_6_5
3983,114,1329125580,3,4,5,1329135540,9960,1066260,1201080,134820,19_19_19_19_19_19_19_19_19_19_19_19_9_9_1_1_2_2_9_9_6_6_19_3_19_19_3_5_5_5_1_1_5_19_2_1_1_9_2_9_3_3_3_3_3_3
3984,98,1329127200,5,2,5,1329736800,609600,3387780,7319880,3932100,34_34_2_2_35_35_34_34_2_2_3_3_3_3_3_3_18_18_3_3_3_18_3_3_3_18_18_18_18_3_3_18_18_18_18_18_18_18_18_3_3_18_39_3_3_39_3_3_3_3_4_4_5_5_5_5_5_5_4_4_4_5_3_5_5_3_5_4_4_4_5_5_5_5_6_6_6_6_5_5_5_5_5_5_5_5_5_5_5_5_6_6_5_5_34_34_6_6_5_5
3985,116,1329127200,5,18,14,1329142020,14820,450000,786600,336600,19_19_19_19_19_19_19_19_19_19_1_1_1_1_3_3_19_2_2_19_3_3_19_14_14_14_19_19_13_13_19_14_1_13_14_1_2_2_3_5_3_5
3986,130,1329127200,15,18,2,1329127740,540,2403540,3083940,680400,26_26_26_26_26_26_8_8_26_26_26_26_26_26_26_26_26_26_26_8_26_8_17_17_1_1_17_1_17_17_1_17_17_17_17_17_17_17_17_1_17_17_1_17_17_1_17_1_17_17_1_17_1_3_3_1_1_17_17_17_18_17_1_18_4_18_1_4_4_18_18_3_17_1_3_1_15_4_4_3_3_18_15_18_4_18_4_4_15_4_18_18_4_15_4_4_4_4_4_4_15_15_15_15_15_15_15_15_2_15
3987,130,1329127740,2,3,15,1329138000,10260,2404080,3083940,679860,26_26_26_26_26_26_8_8_26_26_26_26_26_26_26_26_26_26_26_8_26_8_17_17_1_1_17_1_17_17_1_17_17_17_17_17_17_17_17_1_17_17_1_17_17_1_17_1_17_17_1_17_1_3_3_1_1_17_17_17_18_17_1_18_4_18_1_4_4_18_18_3_17_1_3_1_15_4_4_3_3_18_15_18_4_18_4_4_15_4_18_18_4_15_4_4_4_4_4_4_15_15_15_15_15_15_15_15_2_15_2
3988,155,1329127800,2,3,2,1329129420,1620,537600,3225180,2687580,0_0_0_0_0_0_0_0_1_1_1_1_2
3989,141,1329128400,5,2,5,1329130200,1800,3475200,7406100,3930900,1_1_16_16_16_16_16_1_16_16_1_1_1_16_16_16_16_16_16_16_16_16_16_16_16_16_16_16_1_1_1_1_1_1_1_1_1_1_1_1_16_2_2_16_3_3_3_3_3_3_18_18_18_18_18_3_18_3_3_3_5_5_5_5_5_5_3_3_4_4_4_4_4_3_1_3_1_4_18_3_3_18_18_1_1_18_18_5
3990,155,1329129420,2,3,9,1330466400,1336980,539220,3225180,2685960,0_0_0_0_0_0_0_0_1_1_1_1_2_2
3991,131,1329129480,3,3,3,1329133620,4140,2869380,6825900,3956520,16_16_16_16_16_16_16_16_16_16_16_16_16_16_16_16_16_16_16_16_16_16_16_16_16_16_1_1_1_1_2_2_3
3992,63,1329130200,1,2,3,1329316980,186780,2278740,6232860,3954120,16_16_16_16_16_16_16_16_16_0_0_16_16_0_16_16_0_16_16_0_0_16_16_16_0_0_16_0_0_16_0_16_0_0_0_16_1_1_1_16_16_16_0_1_1_1_16_0_0_16_16_0_16_0_16_0_0_2_2_1_1_0_0_0_0_2_2_2_2_2_2_0_1_0_1_1_0_0_0_1_1_0_0_1_1_1_0_0_0_0_0_2_2_2_2_0_0_0_0_0_0_1_1_1_1_0_0_16_0_16_16_16_16_16_0_0_1_1_2_2_1_1_16_0_2_16_2_2_2_0_1_1_1_1_1_16_16_1_1_1
3993,141,1329130200,5,2,18,1329140820,10620,3477000,7406100,3929100,1_1_16_16_16_16_16_1_16_16_1_1_1_16_16_16_16_16_16_16_16_16_16_16_16_16_16_16_1_1_1_1_1_1_1_1_1_1_1_1_16_2_2_16_3_3_3_3_3_3_18_18_18_18_18_3_18_3_3_3_5_5_5_5_5_5_3_3_4_4_4_4_4_3_1_3_1_4_18_3_3_18_18_1_1_18_18_5_5
3994,188,1329132000,1,2,1,1329141960,9960,459960,4327560,3867600,0_0_0_0_0_1_1_0_0_0_0_0_0_0_0_0_1
3995,203,1329132000,5,2,4,1329142380,10380,1136700,1897500,760800,7_7_7_7_7_7_7_7_7_7_7_1_1_7_7_7_7_7_7_7_7_7_17_17_17_17_4_17_4_4_4_17_17_1_1_2_2_13_9_9_3_9_3_13_4_17_13_9_3_9_3_17_3_3_4_4_9_13_3_4_3_17_17_15_1_26_17_17_9_15_1_15_1_17_4_13_13_15_1_1_15_4_4_13_9_3_1_13_4_15_1_3_13_1_26_3_13_6_6_15_26_15_5_26_25_26_26_5_25_3_3_3_4_4_4_13_4_4_13_4_4_4_4_4_4_4_26_4_5
3996,131,1329133620,3,4,3,1329146100,12480,2873520,6825900,3952380,16_16_16_16_16_16_16_16_16_16_16_16_16_16_16_16_16_16_16_16_16_16_16_16_16_16_1_1_1_1_2_2_3_3
3997,166,1329135480,5,9,99,1329135480,0,1666080,1666080,0,7_7_7_1_7_7_1_7_7_7_21_21_1_1_2_2_3_3_4_4_4_4_6_6_5_5
3998,114,1329135540,5,9,5,1329138840,3300,1076220,1201080,124860,19_19_19_19_19_19_19_19_19_19_19_19_9_9_1_1_2_2_9_9_6_6_19_3_19_19_3_5_5_5_1_1_5_19_2_1_1_9_2_9_3_3_3_3_3_3_5
3999,71,1329136440,7,8,7,1329136620,180,2874840,3996240,1121400,29_29_1_1_7_7_1_7_1_7_7_7_7_7_1_7_1_7_7_7_7_7_7_1_1_7_7_7_7_7_7_7_7_1_1_7_7_7_7_1_1_1_1_7
4000,71,1329136620,7,8,1,1329138000,1380,2875020,3996240,1121220,29_29_1_1_7_7_1_7_1_7_7_7_7_7_1_7_1_7_7_7_7_7_7_1_1_7_7_7_7_7_7_7_7_1_1_7_7_7_7_1_1_1_1_7_7
4001,71,1329138000,1,18,7,1329141480,3480,2876400,3996240,1119840,29_29_1_1_7_7_1_7_1_7_7_7_7_7_1_7_1_7_7_7_7_7_7_1_1_7_7_7_7_7_7_7_7_1_1_7_7_7_7_1_1_1_1_7_7_1
4002,130,1329138000,15,18,15,1329197400,59400,2414340,3083940,669600,26_26_26_26_26_26_8_8_26_26_26_26_26_26_26_26_26_26_26_8_26_8_17_17_1_1_17_1_17_17_1_17_17_17_17_17_17_17_17_1_17_17_1_17_17_1_17_1_17_17_1_17_1_3_3_1_1_17_17_17_18_17_1_18_4_18_1_4_4_18_18_3_17_1_3_1_15_4_4_3_3_18_15_18_4_18_4_4_15_4_18_18_4_15_4_4_4_4_4_4_15_15_15_15_15_15_15_15_2_15_2_15
4003,114,1329138840,5,9,5,1329215520,76680,1079520,1201080,121560,19_19_19_19_19_19_19_19_19_19_19_19_9_9_1_1_2_2_9_9_6_6_19_3_19_19_3_5_5_5_1_1_5_19_2_1_1_9_2_9_3_3_3_3_3_3_5_5
4004,163,1329139320,17,12,17,1329198780,59460,27780,548880,521100,17_17
4005,141,1329140820,18,5,5,1329195600,54780,3487620,7406100,3918480,1_1_16_16_16_16_16_1_16_16_1_1_1_16_16_16_16_16_16_16_16_16_16_16_16_16_16_16_1_1_1_1_1_1_1_1_1_1_1_1_16_2_2_16_3_3_3_3_3_3_18_18_18_18_18_3_18_3_3_3_5_5_5_5_5_5_3_3_4_4_4_4_4_3_1_3_1_4_18_3_3_18_18_1_1_18_18_5_5_18
4006,23,1329141000,5,9,5,1329148200,7200,1602720,1894920,292200,24_24_24_24_8_8_24_24_24_24_24_24_24_24_24_24_24_24_24_24_8_8_7_7_3_3_9_9_9_9_2_2_9_9_9_9_5_2_9_9_9_9_5_2_5
4007,213,1329141420,0,16,0,1329143160,1740,105000,3206820,3101820,0_0_0_0_0_1_0_1_0
4008,71,1329141480,7,8,1,1329141720,240,2879880,3996240,1116360,29_29_1_1_7_7_1_7_1_7_7_7_7_7_1_7_1_7_7_7_7_7_7_1_1_7_7_7_7_7_7_7_7_1_1_7_7_7_7_1_1_1_1_7_7_1_7
4009,107,1329141600,16,20,16,1329169380,27780,1215000,4991760,3776760,8_8_8_8_28_28_28_28_28_28_8_8_8_8_16
4010,71,1329141720,1,18,7,1329142740,1020,2880120,3996240,1116120,29_29_1_1_7_7_1_7_1_7_7_7_7_7_1_7_1_7_7_7_7_7_7_1_1_7_7_7_7_7_7_7_7_1_1_7_7_7_7_1_1_1_1_7_7_1_7_1
4011,188,1329141960,1,2,2,1329293940,151980,469920,4327560,3857640,0_0_0_0_0_1_1_0_0_0_0_0_0_0_0_0_1_1
4012,116,1329142020,13,15,14,1329156540,14520,464820,786600,321780,19_19_19_19_19_19_19_19_19_19_1_1_1_1_3_3_19_2_2_19_3_3_19_14_14_14_19_19_13_13_19_14_1_13_14_1_2_2_3_5_3_5_14_13
4013,116,1329142020,14,15,13,1329142020,0,464820,786600,321780,19_19_19_19_19_19_19_19_19_19_1_1_1_1_3_3_19_2_2_19_3_3_19_14_14_14_19_19_13_13_19_14_1_13_14_1_2_2_3_5_3_5_14
4014,203,1329142380,4,23,4,1329144540,2160,1147080,1897500,750420,7_7_7_7_7_7_7_7_7_7_7_1_1_7_7_7_7_7_7_7_7_7_17_17_17_17_4_17_4_4_4_17_17_1_1_2_2_13_9_9_3_9_3_13_4_17_13_9_3_9_3_17_3_3_4_4_9_13_3_4_3_17_17_15_1_26_17_17_9_15_1_15_1_17_4_13_13_15_1_1_15_4_4_13_9_3_1_13_4_15_1_3_13_1_26_3_13_6_6_15_26_15_5_26_25_26_26_5_25_3_3_3_4_4_4_13_4_4_13_4_4_4_4_4_4_4_26_4_5_4
4015,71,1329142740,7,10,7,1329148680,5940,2881140,3996240,1115100,29_29_1_1_7_7_1_7_1_7_7_7_7_7_1_7_1_7_7_7_7_7_7_1_1_7_7_7_7_7_7_7_7_1_1_7_7_7_7_1_1_1_1_7_7_1_7_1_7
4016,213,1329143160,0,20,0,1329145920,2760,106740,3206820,3100080,0_0_0_0_0_1_0_1_0_0
4017,184,1329144000,5,9,5,1329144060,60,646800,1800900,1154100,10_10_10_10_10_10_10_10_10_10_10_10_1_1_10_1_1_10_10_9_10_9_1_1_9_9_2_2_5
4018,184,1329144060,5,9,6,1329170400,26340,646860,1800900,1154040,10_10_10_10_10_10_10_10_10_10_10_10_1_1_10_1_1_10_10_9_10_9_1_1_9_9_2_2_5_5
4019,203,1329144540,4,19,5,1329148800,4260,1149240,1897500,748260,7_7_7_7_7_7_7_7_7_7_7_1_1_7_7_7_7_7_7_7_7_7_17_17_17_17_4_17_4_4_4_17_17_1_1_2_2_13_9_9_3_9_3_13_4_17_13_9_3_9_3_17_3_3_4_4_9_13_3_4_3_17_17_15_1_26_17_17_9_15_1_15_1_17_4_13_13_15_1_1_15_4_4_13_9_3_1_13_4_15_1_3_13_1_26_3_13_6_6_15_26_15_5_26_25_26_26_5_25_3_3_3_4_4_4_13_4_4_13_4_4_4_4_4_4_4_26_4_5_4_4
4020,213,1329145920,0,16,0,1329155340,9420,109500,3206820,3097320,0_0_0_0_0_1_0_1_0_0_0
4021,131,1329146100,3,4,3,1329146880,780,2886000,6825900,3939900,16_16_16_16_16_16_16_16_16_16_16_16_16_16_16_16_16_16_16_16_16_16_16_16_16_16_1_1_1_1_2_2_3_3_3
4022,131,1329146880,3,3,18,1329156540,9660,2886780,6825900,3939120,16_16_16_16_16_16_16_16_16_16_16_16_16_16_16_16_16_16_16_16_16_16_16_16_16_16_1_1_1_1_2_2_3_3_3_3
4023,135,1329147000,2,4,2,1329147780,780,3072600,5649480,2576880,19_19_19_19_19_19_19_19_19_19_19_19_1_19_1_19_19_19_1_1_1_1_19_19_19_19_19_19_1_1_1_1_19_19_19_19_19_19_19_19_19_19_19_19_1_19_1_19_19_19_19_19_19_1_19_1_1_1_2_2_1_1_2
4024,135,1329147780,2,4,9,1329256800,109020,3073380,5649480,2576100,19_19_19_19_19_19_19_19_19_19_19_19_1_19_1_19_19_19_1_1_1_1_19_19_19_19_19_19_1_1_1_1_19_19_19_19_19_19_19_19_19_19_19_19_1_19_1_19_19_19_19_19_19_1_19_1_1_1_2_2_1_1_2_2
4025,23,1329148200,5,9,5,1329209760,61560,1609920,1894920,285000,24_24_24_24_8_8_24_24_24_24_24_24_24_24_24_24_24_24_24_24_8_8_7_7_3_3_9_9_9_9_2_2_9_9_9_9_5_2_9_9_9_9_5_2_5_5
4026,71,1329148680,7,10,7,1329148860,180,2887080,3996240,1109160,29_29_1_1_7_7_1_7_1_7_7_7_7_7_1_7_1_7_7_7_7_7_7_1_1_7_7_7_7_7_7_7_7_1_1_7_7_7_7_1_1_1_1_7_7_1_7_1_7_7
4027,203,1329148800,5,2,4,1329154380,5580,1153500,1897500,744000,7_7_7_7_7_7_7_7_7_7_7_1_1_7_7_7_7_7_7_7_7_7_17_17_17_17_4_17_4_4_4_17_17_1_1_2_2_13_9_9_3_9_3_13_4_17_13_9_3_9_3_17_3_3_4_4_9_13_3_4_3_17_17_15_1_26_17_17_9_15_1_15_1_17_4_13_13_15_1_1_15_4_4_13_9_3_1_13_4_15_1_3_13_1_26_3_13_6_6_15_26_15_5_26_25_26_26_5_25_3_3_3_4_4_4_13_4_4_13_4_4_4_4_4_4_4_26_4_5_4_4_5
4028,71,1329148860,7,10,7,1329168180,19320,2887260,3996240,1108980,29_29_1_1_7_7_1_7_1_7_7_7_7_7_1_7_1_7_7_7_7_7_7_1_1_7_7_7_7_7_7_7_7_1_1_7_7_7_7_1_1_1_1_7_7_1_7_1_7_7_7
4029,203,1329154380,4,23,26,1329157620,3240,1159080,1897500,738420,7_7_7_7_7_7_7_7_7_7_7_1_1_7_7_7_7_7_7_7_7_7_17_17_17_17_4_17_4_4_4_17_17_1_1_2_2_13_9_9_3_9_3_13_4_17_13_9_3_9_3_17_3_3_4_4_9_13_3_4_3_17_17_15_1_26_17_17_9_15_1_15_1_17_4_13_13_15_1_1_15_4_4_13_9_3_1_13_4_15_1_3_13_1_26_3_13_6_6_15_26_15_5_26_25_26_26_5_25_3_3_3_4_4_4_13_4_4_13_4_4_4_4_4_4_4_26_4_5_4_4_5_4
4030,143,1329154800,4,23,4,1329168600,13800,1683720,1898460,214740,10_10_10_1_10_1_10_1_1_10_10_10_10_10_1_1_10_1_10_1_10_10_10_10_1_1_1_1_1_1_9_9_3_3_4
4031,213,1329155340,0,0,0,1329156000,660,118920,3206820,3087900,0_0_0_0_0_1_0_1_0_0_0_0
4032,213,1329156000,0,20,0,1329169380,13380,119580,3206820,3087240,0_0_0_0_0_1_0_1_0_0_0_0_0
4033,131,1329156540,18,22,18,1329167100,10560,2896440,6825900,3929460,16_16_16_16_16_16_16_16_16_16_16_16_16_16_16_16_16_16_16_16_16_16_16_16_16_16_1_1_1_1_2_2_3_3_3_3_18
4034,116,1329156540,14,17,13,1329157980,1440,479340,786600,307260,19_19_19_19_19_19_19_19_19_19_1_1_1_1_3_3_19_2_2_19_3_3_19_14_14_14_19_19_13_13_19_14_1_13_14_1_2_2_3_5_3_5_14_13_14
4035,203,1329157620,26,13,15,1329218400,60780,1162320,1897500,735180,7_7_7_7_7_7_7_7_7_7_7_1_1_7_7_7_7_7_7_7_7_7_17_17_17_17_4_17_4_4_4_17_17_1_1_2_2_13_9_9_3_9_3_13_4_17_13_9_3_9_3_17_3_3_4_4_9_13_3_4_3_17_17_15_1_26_17_17_9_15_1_15_1_17_4_13_13_15_1_1_15_4_4_13_9_3_1_13_4_15_1_3_13_1_26_3_13_6_6_15_26_15_5_26_25_26_26_5_25_3_3_3_4_4_4_13_4_4_13_4_4_4_4_4_4_4_26_4_5_4_4_5_4_26
4036,218,1329157920,19,11,19,1329169200,11280,57600,1974480,1916880,19_19_19
4037,116,1329157980,13,17,6,1329170400,12420,480780,786600,305820,19_19_19_19_19_19_19_19_19_19_1_1_1_1_3_3_19_2_2_19_3_3_19_14_14_14_19_19_13_13_19_14_1_13_14_1_2_2_3_5_3_5_14_13_14_13
4038,131,1329167100,18,22,18,1329167160,60,2907000,6825900,3918900,16_16_16_16_16_16_16_16_16_16_16_16_16_16_16_16_16_16_16_16_16_16_16_16_16_16_1_1_1_1_2_2_3_3_3_3_18_18
4039,131,1329167160,18,22,18,1329194940,27780,2907060,6825900,3918840,16_16_16_16_16_16_16_16_16_16_16_16_16_16_16_16_16_16_16_16_16_16_16_16_16_16_1_1_1_1_2_2_3_3_3_3_18_18_18
4040,71,1329168180,7,10,7,1329169560,1380,2906580,3996240,1089660,29_29_1_1_7_7_1_7_1_7_7_7_7_7_1_7_1_7_7_7_7_7_7_1_1_7_7_7_7_7_7_7_7_1_1_7_7_7_7_1_1_1_1_7_7_1_7_1_7_7_7_7
4041,143,1329168600,4,23,4,1329168600,0,1697520,1898460,200940,10_10_10_1_10_1_10_1_1_10_10_10_10_10_1_1_10_1_10_1_10_10_10_10_1_1_1_1_1_1_9_9_3_3_4_4
4042,143,1329168600,4,22,4,1329195000,26400,1697520,1898460,200940,10_10_10_1_10_1_10_1_1_10_10_10_10_10_1_1_10_1_10_1_10_10_10_10_1_1_1_1_1_1_9_9_3_3_4_4_4
4043,218,1329169200,19,11,19,1329169260,60,68880,1974480,1905600,19_19_19_19
4044,218,1329169260,19,11,19,1329173160,3900,68940,1974480,1905540,19_19_19_19_19
4045,107,1329169380,16,20,16,1329169440,60,1242780,4991760,3748980,8_8_8_8_28_28_28_28_28_28_8_8_8_8_16_16
4046,213,1329169380,0,11,0,1329169440,60,132960,3206820,3073860,0_0_0_0_0_1_0_1_0_0_0_0_0_0
4047,213,1329169440,0,0,0,1329194460,25020,133020,3206820,3073800,0_0_0_0_0_1_0_1_0_0_0_0_0_0_0
4048,107,1329169440,16,0,16,1329194760,25320,1242840,4991760,3748920,8_8_8_8_28_28_28_28_28_28_8_8_8_8_16_16_16
4049,71,1329169560,7,0,7,1329194760,25200,2907960,3996240,1088280,29_29_1_1_7_7_1_7_1_7_7_7_7_7_1_7_1_7_7_7_7_7_7_1_1_7_7_7_7_7_7_7_7_1_1_7_7_7_7_1_1_1_1_7_7_1_7_1_7_7_7_7_7
4050,116,1329170400,6,7,6,1329174000,3600,493200,786600,293400,19_19_19_19_19_19_19_19_19_19_1_1_1_1_3_3_19_2_2_19_3_3_19_14_14_14_19_19_13_13_19_14_1_13_14_1_2_2_3_5_3_5_14_13_14_13_6
4051,0,1329170400,3,4,3,1329170400,0,1298160,1560960,262800,0_0_0_0_0_0_0_0_1_1_2_2_3
4052,184,1329170400,6,7,6,1329170400,0,673200,1800900,1127700,10_10_10_10_10_10_10_10_10_10_10_10_1_1_10_1_1_10_10_9_10_9_1_1_9_9_2_2_5_5_6
4053,198,1329170400,6,7,6,1329174000,3600,663120,708660,45540,10_10_10_10_1_1_9_9_9_9_2_9_2_9_6_6
4054,165,1329170400,6,7,6,1329174000,3600,1220100,1262880,42780,24_24_24_24_24_24_24_24_24_24_24_24_8_8_9_9_2_2_6
4055,184,1329170400,6,7,6,1329174000,3600,673200,1800900,1127700,10_10_10_10_10_10_10_10_10_10_10_10_1_1_10_1_1_10_10_9_10_9_1_1_9_9_2_2_5_5_6_6
4056,0,1329170400,3,4,3,1329174900,4500,1298160,1560960,262800,0_0_0_0_0_0_0_0_1_1_2_2_3_3
4057,136,1329170400,6,7,6,1329174000,3600,616920,646380,29460,10_10_10_10_1_1_10_10_1_1_9_9_2_2_9_9_6
4058,198,1329170400,6,7,6,1329170400,0,663120,708660,45540,10_10_10_10_1_1_9_9_9_9_2_9_2_9_6
4059,218,1329173160,19,11,1,1329198420,25260,72840,1974480,1901640,19_19_19_19_19_19
4060,85,1329173220,19,11,19,1329194400,21180,0,778380,778380,19
4061,198,1329174000,6,7,5,1329215880,41880,666720,708660,41940,10_10_10_10_1_1_9_9_9_9_2_9_2_9_6_6_6_6
4062,116,1329174000,6,7,14,1329187980,13980,496800,786600,289800,19_19_19_19_19_19_19_19_19_19_1_1_1_1_3_3_19_2_2_19_3_3_19_14_14_14_19_19_13_13_19_14_1_13_14_1_2_2_3_5_3_5_14_13_14_13_6_6
4063,198,1329174000,6,7,6,1329174000,0,666720,708660,41940,10_10_10_10_1_1_9_9_9_9_2_9_2_9_6_6_6
4064,119,1329174000,14,17,3,1329188040,14040,2224380,2742780,518400,7_7_7_1_1_7_7_7_7_7_7_7_7_7_1_1_2_2_3_3_14
4065,165,1329174000,6,7,5,1329213120,39120,1223700,1262880,39180,24_24_24_24_24_24_24_24_24_24_24_24_8_8_9_9_2_2_6_6
4066,184,1329174000,6,7,6,1329174000,0,676800,1800900,1124100,10_10_10_10_10_10_10_10_10_10_10_10_1_1_10_1_1_10_10_9_10_9_1_1_9_9_2_2_5_5_6_6_6
4067,184,1329174000,6,7,2,1330293600,1119600,676800,1800900,1124100,10_10_10_10_10_10_10_10_10_10_10_10_1_1_10_1_1_10_10_9_10_9_1_1_9_9_2_2_5_5_6_6_6_6
4068,136,1329174000,6,7,5,1329199800,25800,620520,646380,25860,10_10_10_10_1_1_10_10_1_1_9_9_2_2_9_9_6_6
4069,0,1329174900,3,4,3,1329203100,28200,1302660,1560960,258300,0_0_0_0_0_0_0_0_1_1_2_2_3_3_3_3
4070,0,1329174900,3,4,3,1329174900,0,1302660,1560960,258300,0_0_0_0_0_0_0_0_1_1_2_2_3_3_3
4071,116,1329187980,13,17,5,1329195600,7620,510780,786600,275820,19_19_19_19_19_19_19_19_19_19_1_1_1_1_3_3_19_2_2_19_3_3_19_14_14_14_19_19_13_13_19_14_1_13_14_1_2_2_3_5_3_5_14_13_14_13_6_6_14_13
4072,116,1329187980,14,17,13,1329187980,0,510780,786600,275820,19_19_19_19_19_19_19_19_19_19_1_1_1_1_3_3_19_2_2_19_3_3_19_14_14_14_19_19_13_13_19_14_1_13_14_1_2_2_3_5_3_5_14_13_14_13_6_6_14
4073,119,1329188040,3,17,3,1329194280,6240,2238420,2742780,504360,7_7_7_1_1_7_7_7_7_7_7_7_7_7_1_1_2_2_3_3_14_3
4074,119,1329194280,3,17,14,1329194400,120,2244660,2742780,498120,7_7_7_1_1_7_7_7_7_7_7_7_7_7_1_1_2_2_3_3_14_3_3
4075,85,1329194400,19,11,19,1329199440,5040,21180,778380,757200,19_19
4076,119,1329194400,14,17,14,1329253200,58800,2244780,2742780,498000,7_7_7_1_1_7_7_7_7_7_7_7_7_7_1_1_2_2_3_3_14_3_3_14
4077,213,1329194460,0,11,1,1329197280,2820,158040,3206820,3048780,0_0_0_0_0_1_0_1_0_0_0_0_0_0_0_0
4078,71,1329194760,7,0,7,1329195720,960,2933160,3996240,1063080,29_29_1_1_7_7_1_7_1_7_7_7_7_7_1_7_1_7_7_7_7_7_7_1_1_7_7_7_7_7_7_7_7_1_1_7_7_7_7_1_1_1_1_7_7_1_7_1_7_7_7_7_7_7
4079,107,1329194760,16,0,16,1329197220,2460,1268160,4991760,3723600,8_8_8_8_28_28_28_28_28_28_8_8_8_8_16_16_16_16
4080,131,1329194940,18,22,18,1329195600,660,2934840,6825900,3891060,16_16_16_16_16_16_16_16_16_16_16_16_16_16_16_16_16_16_16_16_16_16_16_16_16_16_1_1_1_1_2_2_3_3_3_3_18_18_18_18
4081,143,1329195000,4,22,4,1329195240,240,1723920,1898460,174540,10_10_10_1_10_1_10_1_1_10_10_10_10_10_1_1_10_1_10_1_10_10_10_10_1_1_1_1_1_1_9_9_3_3_4_4_4_4
4082,143,1329195240,4,5,4,1329203400,8160,1724160,1898460,174300,10_10_10_1_10_1_10_1_1_10_10_10_10_10_1_1_10_1_10_1_10_10_10_10_1_1_1_1_1_1_9_9_3_3_4_4_4_4_4
4083,131,1329195600,18,15,3,1329200820,5220,2935500,6825900,3890400,16_16_16_16_16_16_16_16_16_16_16_16_16_16_16_16_16_16_16_16_16_16_16_16_16_16_1_1_1_1_2_2_3_3_3_3_18_18_18_18_18
4084,116,1329195600,5,18,5,1329196740,1140,518400,786600,268200,19_19_19_19_19_19_19_19_19_19_1_1_1_1_3_3_19_2_2_19_3_3_19_14_14_14_19_19_13_13_19_14_1_13_14_1_2_2_3_5_3_5_14_13_14_13_6_6_14_13_5
4085,141,1329195600,5,2,5,1329201600,6000,3542400,7406100,3863700,1_1_16_16_16_16_16_1_16_16_1_1_1_16_16_16_16_16_16_16_16_16_16_16_16_16_16_16_1_1_1_1_1_1_1_1_1_1_1_1_16_2_2_16_3_3_3_3_3_3_18_18_18_18_18_3_18_3_3_3_5_5_5_5_5_5_3_3_4_4_4_4_4_3_1_3_1_4_18_3_3_18_18_1_1_18_18_5_5_18_5
4086,71,1329195720,7,8,1,1329209040,13320,2934120,3996240,1062120,29_29_1_1_7_7_1_7_1_7_7_7_7_7_1_7_1_7_7_7_7_7_7_1_1_7_7_7_7_7_7_7_7_1_1_7_7_7_7_1_1_1_1_7_7_1_7_1_7_7_7_7_7_7_7
4087,151,1329195720,1,9,1,1329196920,1200,1073520,3643800,2570280,19_19_19_19_19_1_1_19_1_1_19_19_19_19_1_19_1_19_19_19_19_19_19_19_19_19_1_19_19_1_1
4088,116,1329196740,5,18,5,1329391800,195060,519540,786600,267060,19_19_19_19_19_19_19_19_19_19_1_1_1_1_3_3_19_2_2_19_3_3_19_14_14_14_19_19_13_13_19_14_1_13_14_1_2_2_3_5_3_5_14_13_14_13_6_6_14_13_5_5
4089,151,1329196920,1,9,1,1329196980,60,1074720,3643800,2569080,19_19_19_19_19_1_1_19_1_1_19_19_19_19_1_19_1_19_19_19_19_19_19_19_19_19_1_19_19_1_1_1
4090,151,1329196980,1,9,1,1329197160,180,1074780,3643800,2569020,19_19_19_19_19_1_1_19_1_1_19_19_19_19_1_19_1_19_19_19_19_19_19_19_19_19_1_19_19_1_1_1_1
4091,151,1329197160,1,9,19,1329299100,101940,1074960,3643800,2568840,19_19_19_19_19_1_1_19_1_1_19_19_19_19_1_19_1_19_19_19_19_19_19_19_19_19_1_19_19_1_1_1_1_1
4092,107,1329197220,16,1,1,1329224940,27720,1270620,4991760,3721140,8_8_8_8_28_28_28_28_28_28_8_8_8_8_16_16_16_16_16
4093,213,1329197280,1,9,1,1329198360,1080,160860,3206820,3045960,0_0_0_0_0_1_0_1_0_0_0_0_0_0_0_0_1
4094,130,1329197400,15,18,15,1329201600,4200,2473740,3083940,610200,26_26_26_26_26_26_8_8_26_26_26_26_26_26_26_26_26_26_26_8_26_8_17_17_1_1_17_1_17_17_1_17_17_17_17_17_17_17_17_1_17_17_1_17_17_1_17_1_17_17_1_17_1_3_3_1_1_17_17_17_18_17_1_18_4_18_1_4_4_18_18_3_17_1_3_1_15_4_4_3_3_18_15_18_4_18_4_4_15_4_18_18_4_15_4_4_4_4_4_4_15_15_15_15_15_15_15_15_2_15_2_15_15
4095,213,1329198360,1,9,0,1329199380,1020,161940,3206820,3044880,0_0_0_0_0_1_0_1_0_0_0_0_0_0_0_0_1_1
4096,218,1329198420,1,9,1,1329209160,10740,98100,1974480,1876380,19_19_19_19_19_19_1
4097,163,1329198780,17,12,1,1329202800,4020,87240,548880,461640,17_17_17
4098,213,1329199380,0,16,0,1329234360,34980,162960,3206820,3043860,0_0_0_0_0_1_0_1_0_0_0_0_0_0_0_0_1_1_0
4099,85,1329199440,19,16,19,1329212460,13020,26220,778380,752160,19_19_19
4100,136,1329199800,5,9,5,1329199860,60,646320,646380,60,10_10_10_10_1_1_10_10_1_1_9_9_2_2_9_9_6_6_5
4101,136,1329199860,5,9,99,1329199860,0,646380,646380,0,10_10_10_10_1_1_10_10_1_1_9_9_2_2_9_9_6_6_5_5
4102,131,1329200820,3,3,3,1329209280,8460,2940720,6825900,3885180,16_16_16_16_16_16_16_16_16_16_16_16_16_16_16_16_16_16_16_16_16_16_16_16_16_16_1_1_1_1_2_2_3_3_3_3_18_18_18_18_18_3
4103,130,1329201600,15,18,2,1329219660,18060,2477940,3083940,606000,26_26_26_26_26_26_8_8_26_26_26_26_26_26_26_26_26_26_26_8_26_8_17_17_1_1_17_1_17_17_1_17_17_17_17_17_17_17_17_1_17_17_1_17_17_1_17_1_17_17_1_17_1_3_3_1_1_17_17_17_18_17_1_18_4_18_1_4_4_18_18_3_17_1_3_1_15_4_4_3_3_18_15_18_4_18_4_4_15_4_18_18_4_15_4_4_4_4_4_4_15_15_15_15_15_15_15_15_2_15_2_15_15_15
4104,141,1329201600,5,2,5,1329202800,1200,3548400,7406100,3857700,1_1_16_16_16_16_16_1_16_16_1_1_1_16_16_16_16_16_16_16_16_16_16_16_16_16_16_16_1_1_1_1_1_1_1_1_1_1_1_1_16_2_2_16_3_3_3_3_3_3_18_18_18_18_18_3_18_3_3_3_5_5_5_5_5_5_3_3_4_4_4_4_4_3_1_3_1_4_18_3_3_18_18_1_1_18_18_5_5_18_5_5
4105,163,1329202800,1,18,1,1329207180,4380,91260,548880,457620,17_17_17_1
4106,141,1329202800,5,2,5,1329216600,13800,3549600,7406100,3856500,1_1_16_16_16_16_16_1_16_16_1_1_1_16_16_16_16_16_16_16_16_16_16_16_16_16_16_16_1_1_1_1_1_1_1_1_1_1_1_1_16_2_2_16_3_3_3_3_3_3_18_18_18_18_18_3_18_3_3_3_5_5_5_5_5_5_3_3_4_4_4_4_4_3_1_3_1_4_18_3_3_18_18_1_1_18_18_5_5_18_5_5_5
4107,0,1329203100,3,4,3,1329203100,0,1330860,1560960,230100,0_0_0_0_0_0_0_0_1_1_2_2_3_3_3_3_3
4108,0,1329203100,3,4,4,1329203580,480,1330860,1560960,230100,0_0_0_0_0_0_0_0_1_1_2_2_3_3_3_3_3_3
4109,143,1329203400,4,5,2,1329309660,106260,1732320,1898460,166140,10_10_10_1_10_1_10_1_1_10_10_10_10_10_1_1_10_1_10_1_10_10_10_10_1_1_1_1_1_1_9_9_3_3_4_4_4_4_4_4
4110,0,1329203580,4,5,3,1329205080,1500,1331340,1560960,229620,0_0_0_0_0_0_0_0_1_1_2_2_3_3_3_3_3_3_4
4111,70,1329203880,1,6,1,1329210600,6720,3057480,3064200,6720,6_6_5_5_1_1_5_5_1
4112,0,1329205080,3,4,3,1329207600,2520,1332840,1560960,228120,0_0_0_0_0_0_0_0_1_1_2_2_3_3_3_3_3_3_4_3
4113,163,1329207180,1,18,17,1329210060,2880,95640,548880,453240,17_17_17_1_1
4114,96,1329207300,5,18,5,1329214320,7020,1897500,2123400,225900,10_1_10_10_10_10_1_10_10_10_10_10_1_1_2_2_9_9_9_9_9_9_3_3_5_5_9_9_9_9_9_9_5_5_6_6_9_9_3_3_5
4115,0,1329207600,3,4,4,1329219420,11820,1335360,1560960,225600,0_0_0_0_0_0_0_0_1_1_2_2_3_3_3_3_3_3_4_3_3
4116,71,1329209040,1,18,7,1329219060,10020,2947440,3996240,1048800,29_29_1_1_7_7_1_7_1_7_7_7_7_7_1_7_1_7_7_7_7_7_7_1_1_7_7_7_7_7_7_7_7_1_1_7_7_7_7_1_1_1_1_7_7_1_7_1_7_7_7_7_7_7_7_1
4117,218,1329209160,1,9,1,1329209340,180,108840,1974480,1865640,19_19_19_19_19_19_1_1
4118,131,1329209280,3,4,3,1329215820,6540,2949180,6825900,3876720,16_16_16_16_16_16_16_16_16_16_16_16_16_16_16_16_16_16_16_16_16_16_16_16_16_16_1_1_1_1_2_2_3_3_3_3_18_18_18_18_18_3_3
4119,218,1329209340,1,9,1,1329213840,4500,109020,1974480,1865460,19_19_19_19_19_19_1_1_1
4120,23,1329209760,5,9,5,1329215940,6180,1671480,1894920,223440,24_24_24_24_8_8_24_24_24_24_24_24_24_24_24_24_24_24_24_24_8_8_7_7_3_3_9_9_9_9_2_2_9_9_9_9_5_2_9_9_9_9_5_2_5_5_5
4121,163,1329210060,17,12,17,1329210120,60,98520,548880,450360,17_17_17_1_1_17
4122,163,1329210120,17,12,1,1329218400,8280,98580,548880,450300,17_17_17_1_1_17_17
4123,70,1329210600,1,6,99,1329210600,0,3064200,3064200,0,6_6_5_5_1_1_5_5_1_1
4124,85,1329212460,19,16,19,1329234300,21840,39240,778380,739140,19_19_19_19_19
4125,85,1329212460,19,16,19,1329212460,0,39240,778380,739140,19_19_19_19
4126,165,1329213120,5,9,5,1329213180,60,1262820,1262880,60,24_24_24_24_24_24_24_24_24_24_24_24_8_8_9_9_2_2_6_6_5
4127,165,1329213180,5,9,99,1329213180,0,1262880,1262880,0,24_24_24_24_24_24_24_24_24_24_24_24_8_8_9_9_2_2_6_6_5_5
4128,218,1329213840,1,9,1,1330318200,1104360,113520,1974480,1860960,19_19_19_19_19_19_1_1_1_1
4129,96,1329214320,5,18,5,1329391200,176880,1904520,2123400,218880,10_1_10_10_10_10_1_10_10_10_10_10_1_1_2_2_9_9_9_9_9_9_3_3_5_5_9_9_9_9_9_9_5_5_6_6_9_9_3_3_5_5
4130,114,1329215520,5,9,5,1329220020,4500,1156200,1201080,44880,19_19_19_19_19_19_19_19_19_19_19_19_9_9_1_1_2_2_9_9_6_6_19_3_19_19_3_5_5_5_1_1_5_19_2_1_1_9_2_9_3_3_3_3_3_3_5_5_5
4131,131,1329215820,3,4,3,1329216060,240,2955720,6825900,3870180,16_16_16_16_16_16_16_16_16_16_16_16_16_16_16_16_16_16_16_16_16_16_16_16_16_16_1_1_1_1_2_2_3_3_3_3_18_18_18_18_18_3_3_3
4132,198,1329215880,5,9,5,1329215940,60,708600,708660,60,10_10_10_10_1_1_9_9_9_9_2_9_2_9_6_6_6_6_5
4133,198,1329215940,5,9,99,1329215940,0,708660,708660,0,10_10_10_10_1_1_9_9_9_9_2_9_2_9_6_6_6_6_5_5
4134,23,1329215940,5,9,5,1329399120,183180,1677660,1894920,217260,24_24_24_24_8_8_24_24_24_24_24_24_24_24_24_24_24_24_24_24_8_8_7_7_3_3_9_9_9_9_2_2_9_9_9_9_5_2_9_9_9_9_5_2_5_5_5_5
4135,131,1329216060,3,3,18,1329228480,12420,2955960,6825900,3869940,16_16_16_16_16_16_16_16_16_16_16_16_16_16_16_16_16_16_16_16_16_16_16_16_16_16_1_1_1_1_2_2_3_3_3_3_18_18_18_18_18_3_3_3_3
4136,153,1329216120,3,3,3,1329219600,3480,1401480,1618560,217080,16_1_16_1_0_0_1_1_2_2_3
4137,141,1329216600,5,2,6,1329256800,40200,3563400,7406100,3842700,1_1_16_16_16_16_16_1_16_16_1_1_1_16_16_16_16_16_16_16_16_16_16_16_16_16_16_16_1_1_1_1_1_1_1_1_1_1_1_1_16_2_2_16_3_3_3_3_3_3_18_18_18_18_18_3_18_3_3_3_5_5_5_5_5_5_3_3_4_4_4_4_4_3_1_3_1_4_18_3_3_18_18_1_1_18_18_5_5_18_5_5_5_5
4138,163,1329218400,1,18,17,1329221400,3000,106860,548880,442020,17_17_17_1_1_17_17_1
4139,203,1329218400,15,2,15,1329235320,16920,1223100,1897500,674400,7_7_7_7_7_7_7_7_7_7_7_1_1_7_7_7_7_7_7_7_7_7_17_17_17_17_4_17_4_4_4_17_17_1_1_2_2_13_9_9_3_9_3_13_4_17_13_9_3_9_3_17_3_3_4_4_9_13_3_4_3_17_17_15_1_26_17_17_9_15_1_15_1_17_4_13_13_15_1_1_15_4_4_13_9_3_1_13_4_15_1_3_13_1_26_3_13_6_6_15_26_15_5_26_25_26_26_5_25_3_3_3_4_4_4_13_4_4_13_4_4_4_4_4_4_4_26_4_5_4_4_5_4_26_15
4140,71,1329219060,7,8,7,1329219120,60,2957460,3996240,1038780,29_29_1_1_7_7_1_7_1_7_7_7_7_7_1_7_1_7_7_7_7_7_7_1_1_7_7_7_7_7_7_7_7_1_1_7_7_7_7_1_1_1_1_7_7_1_7_1_7_7_7_7_7_7_7_1_7
4141,71,1329219120,7,8,7,1329219180,60,2957520,3996240,1038720,29_29_1_1_7_7_1_7_1_7_7_7_7_7_1_7_1_7_7_7_7_7_7_1_1_7_7_7_7_7_7_7_7_1_1_7_7_7_7_1_1_1_1_7_7_1_7_1_7_7_7_7_7_7_7_1_7_7
4142,71,1329219180,7,8,1,1329219300,120,2957580,3996240,1038660,29_29_1_1_7_7_1_7_1_7_7_7_7_7_1_7_1_7_7_7_7_7_7_1_1_7_7_7_7_7_7_7_7_1_1_7_7_7_7_1_1_1_1_7_7_1_7_1_7_7_7_7_7_7_7_1_7_7_7
4143,71,1329219300,1,18,7,1329223620,4320,2957700,3996240,1038540,29_29_1_1_7_7_1_7_1_7_7_7_7_7_1_7_1_7_7_7_7_7_7_1_1_7_7_7_7_7_7_7_7_1_1_7_7_7_7_1_1_1_1_7_7_1_7_1_7_7_7_7_7_7_7_1_7_7_7_1
4144,0,1329219420,4,5,4,1329226020,6600,1347180,1560960,213780,0_0_0_0_0_0_0_0_1_1_2_2_3_3_3_3_3_3_4_3_3_4_4
4145,0,1329219420,4,5,4,1329219420,0,1347180,1560960,213780,0_0_0_0_0_0_0_0_1_1_2_2_3_3_3_3_3_3_4_3_3_4
4146,153,1329219600,3,3,4,1329226020,6420,1404960,1618560,213600,16_1_16_1_0_0_1_1_2_2_3_3
4147,130,1329219660,2,3,2,1329225060,5400,2496000,3083940,587940,26_26_26_26_26_26_8_8_26_26_26_26_26_26_26_26_26_26_26_8_26_8_17_17_1_1_17_1_17_17_1_17_17_17_17_17_17_17_17_1_17_17_1_17_17_1_17_1_17_17_1_17_1_3_3_1_1_17_17_17_18_17_1_18_4_18_1_4_4_18_18_3_17_1_3_1_15_4_4_3_3_18_15_18_4_18_4_4_15_4_18_18_4_15_4_4_4_4_4_4_15_15_15_15_15_15_15_15_2_15_2_15_15_15_2
4148,114,1329220020,5,9,5,1329223500,3480,1160700,1201080,40380,19_19_19_19_19_19_19_19_19_19_19_19_9_9_1_1_2_2_9_9_6_6_19_3_19_19_3_5_5_5_1_1_5_19_2_1_1_9_2_9_3_3_3_3_3_3_5_5_5_5
4149,163,1329221400,17,12,17,1329227580,6180,109860,548880,439020,17_17_17_1_1_17_17_1_17_1_17
4150,163,1329221400,1,18,17,1329221400,0,109860,548880,439020,17_17_17_1_1_17_17_1_17_1
4151,163,1329221400,17,12,1,1329221400,0,109860,548880,439020,17_17_17_1_1_17_17_1_17
4152,114,1329223500,5,9,5,1329228000,4500,1164180,1201080,36900,19_19_19_19_19_19_19_19_19_19_19_19_9_9_1_1_2_2_9_9_6_6_19_3_19_19_3_5_5_5_1_1_5_19_2_1_1_9_2_9_3_3_3_3_3_3_5_5_5_5_5
4153,71,1329223620,7,8,7,1329232860,9240,2962020,3996240,1034220,29_29_1_1_7_7_1_7_1_7_7_7_7_7_1_7_1_7_7_7_7_7_7_1_1_7_7_7_7_7_7_7_7_1_1_7_7_7_7_1_1_1_1_7_7_1_7_1_7_7_7_7_7_7_7_1_7_7_7_1_7
4154,125,1329224820,3,4,3,1329226020,1200,3196980,3969060,772080,16_16_16_16_16_16_1_1_2_2_1_1_3
4155,107,1329224940,1,18,16,1329227880,2940,1298340,4991760,3693420,8_8_8_8_28_28_28_28_28_28_8_8_8_8_16_16_16_16_16_1
4156,130,1329225060,2,3,5,1329472200,247140,2501400,3083940,582540,26_26_26_26_26_26_8_8_26_26_26_26_26_26_26_26_26_26_26_8_26_8_17_17_1_1_17_1_17_17_1_17_17_17_17_17_17_17_17_1_17_17_1_17_17_1_17_1_17_17_1_17_1_3_3_1_1_17_17_17_18_17_1_18_4_18_1_4_4_18_18_3_17_1_3_1_15_4_4_3_3_18_15_18_4_18_4_4_15_4_18_18_4_15_4_4_4_4_4_4_15_15_15_15_15_15_15_15_2_15_2_15_15_15_2_2
4157,215,1329225180,3,3,3,1329232680,7500,1298100,1851720,553620,24_24_24_24_24_24_8_8_3_3_3
4158,0,1329226020,4,5,5,1329368340,142320,1353780,1560960,207180,0_0_0_0_0_0_0_0_1_1_2_2_3_3_3_3_3_3_4_3_3_4_4_4
4159,153,1329226020,4,5,4,1329228000,1980,1411380,1618560,207180,16_1_16_1_0_0_1_1_2_2_3_3_4
4160,125,1329226020,3,4,48,1329680520,454500,3198180,3969060,770880,16_16_16_16_16_16_1_1_2_2_1_1_3_3
4161,163,1329227580,17,12,17,1329229380,1800,116040,548880,432840,17_17_17_1_1_17_17_1_17_1_17_17
4162,107,1329227880,16,1,16,1329229620,1740,1301280,4991760,3690480,8_8_8_8_28_28_28_28_28_28_8_8_8_8_16_16_16_16_16_1_16
4163,114,1329228000,5,9,6,1329256800,28800,1168680,1201080,32400,19_19_19_19_19_19_19_19_19_19_19_19_9_9_1_1_2_2_9_9_6_6_19_3_19_19_3_5_5_5_1_1_5_19_2_1_1_9_2_9_3_3_3_3_3_3_5_5_5_5_5_5
4164,153,1329228000,4,23,4,1329228480,480,1413360,1618560,205200,16_1_16_1_0_0_1_1_2_2_3_3_4_4
4165,131,1329228480,18,15,18,1329242820,14340,2968380,6825900,3857520,16_16_16_16_16_16_16_16_16_16_16_16_16_16_16_16_16_16_16_16_16_16_16_16_16_16_1_1_1_1_2_2_3_3_3_3_18_18_18_18_18_3_3_3_3_18
4166,153,1329228480,4,5,4,1329233400,4920,1413840,1618560,204720,16_1_16_1_0_0_1_1_2_2_3_3_4_4_4
4167,163,1329229380,17,10,17,1329247380,18000,117840,548880,431040,17_17_17_1_1_17_17_1_17_1_17_17_17
4168,107,1329229620,16,20,16,1329235020,5400,1303020,4991760,3688740,8_8_8_8_28_28_28_28_28_28_8_8_8_8_16_16_16_16_16_1_16_16
4169,215,1329232680,3,3,14,1329368280,135600,1305600,1851720,546120,24_24_24_24_24_24_8_8_3_3_3_3
4170,71,1329232860,7,8,7,1329235260,2400,2971260,3996240,1024980,29_29_1_1_7_7_1_7_1_7_7_7_7_7_1_7_1_7_7_7_7_7_7_1_1_7_7_7_7_7_7_7_7_1_1_7_7_7_7_1_1_1_1_7_7_1_7_1_7_7_7_7_7_7_7_1_7_7_7_1_7_7
4171,153,1329233400,4,23,4,1329234300,900,1418760,1618560,199800,16_1_16_1_0_0_1_1_2_2_3_3_4_4_4_4
4172,153,1329234300,4,23,4,1329248040,13740,1419660,1618560,198900,16_1_16_1_0_0_1_1_2_2_3_3_4_4_4_4_4
4173,85,1329234300,19,16,19,1329238800,4500,61080,778380,717300,19_19_19_19_19_19
4174,213,1329234360,0,16,0,1329235140,780,197940,3206820,3008880,0_0_0_0_0_1_0_1_0_0_0_0_0_0_0_0_1_1_0_0
4175,107,1329235020,16,20,1,1329235440,420,1308420,4991760,3683340,8_8_8_8_28_28_28_28_28_28_8_8_8_8_16_16_16_16_16_1_16_16_16
4176,213,1329235140,0,20,0,1329241920,6780,198720,3206820,3008100,0_0_0_0_0_1_0_1_0_0_0_0_0_0_0_0_1_1_0_0_0
4177,71,1329235260,7,10,7,1329242280,7020,2973660,3996240,1022580,29_29_1_1_7_7_1_7_1_7_7_7_7_7_1_7_1_7_7_7_7_7_7_1_1_7_7_7_7_7_7_7_7_1_1_7_7_7_7_1_1_1_1_7_7_1_7_1_7_7_7_7_7_7_7_1_7_7_7_1_7_7_7
4178,203,1329235320,15,2,26,1329244200,8880,1240020,1897500,657480,7_7_7_7_7_7_7_7_7_7_7_1_1_7_7_7_7_7_7_7_7_7_17_17_17_17_4_17_4_4_4_17_17_1_1_2_2_13_9_9_3_9_3_13_4_17_13_9_3_9_3_17_3_3_4_4_9_13_3_4_3_17_17_15_1_26_17_17_9_15_1_15_1_17_4_13_13_15_1_1_15_4_4_13_9_3_1_13_4_15_1_3_13_1_26_3_13_6_6_15_26_15_5_26_25_26_26_5_25_3_3_3_4_4_4_13_4_4_13_4_4_4_4_4_4_4_26_4_5_4_4_5_4_26_15_15
4179,107,1329235440,1,18,16,1329238680,3240,1308840,4991760,3682920,8_8_8_8_28_28_28_28_28_28_8_8_8_8_16_16_16_16_16_1_16_16_16_1
4180,107,1329238680,16,20,16,1329256440,17760,1312080,4991760,3679680,8_8_8_8_28_28_28_28_28_28_8_8_8_8_16_16_16_16_16_1_16_16_16_1_16
4181,85,1329238800,19,20,19,1329241980,3180,65580,778380,712800,19_19_19_19_19_19_19
4182,213,1329241920,0,20,0,1329242040,120,205500,3206820,3001320,0_0_0_0_0_1_0_1_0_0_0_0_0_0_0_0_1_1_0_0_0_0
4183,85,1329241980,19,20,19,1329242760,780,68760,778380,709620,19_19_19_19_19_19_19_19
4184,213,1329242040,0,0,0,1329280920,38880,205620,3206820,3001200,0_0_0_0_0_1_0_1_0_0_0_0_0_0_0_0_1_1_0_0_0_0_0
4185,71,1329242280,7,10,7,1329242340,60,2980680,3996240,1015560,29_29_1_1_7_7_1_7_1_7_7_7_7_7_1_7_1_7_7_7_7_7_7_1_1_7_7_7_7_7_7_7_7_1_1_7_7_7_7_1_1_1_1_7_7_1_7_1_7_7_7_7_7_7_7_1_7_7_7_1_7_7_7_7
4186,71,1329242340,7,0,7,1329280800,38460,2980740,3996240,1015500,29_29_1_1_7_7_1_7_1_7_7_7_7_7_1_7_1_7_7_7_7_7_7_1_1_7_7_7_7_7_7_7_7_1_1_7_7_7_7_1_1_1_1_7_7_1_7_1_7_7_7_7_7_7_7_1_7_7_7_1_7_7_7_7_7
4187,85,1329242760,19,11,19,1329281160,38400,69540,778380,708840,19_19_19_19_19_19_19_19_19
4188,131,1329242820,18,22,18,1329281820,39000,2982720,6825900,3843180,16_16_16_16_16_16_16_16_16_16_16_16_16_16_16_16_16_16_16_16_16_16_16_16_16_16_1_1_1_1_2_2_3_3_3_3_18_18_18_18_18_3_3_3_3_18_18
4189,84,1329243840,34,17,34,1329253140,9300,3584940,3714840,129900,17_17_17_17_17_17_17_17_17_17_17_17_17_17_17_17_1_1_2_2_3_3_18_18_18_18_18_18_5_5_34_34_34_34_34_34_34
4190,203,1329244200,26,13,26,1329244260,60,1248900,1897500,648600,7_7_7_7_7_7_7_7_7_7_7_1_1_7_7_7_7_7_7_7_7_7_17_17_17_17_4_17_4_4_4_17_17_1_1_2_2_13_9_9_3_9_3_13_4_17_13_9_3_9_3_17_3_3_4_4_9_13_3_4_3_17_17_15_1_26_17_17_9_15_1_15_1_17_4_13_13_15_1_1_15_4_4_13_9_3_1_13_4_15_1_3_13_1_26_3_13_6_6_15_26_15_5_26_25_26_26_5_25_3_3_3_4_4_4_13_4_4_13_4_4_4_4_4_4_4_26_4_5_4_4_5_4_26_15_15_26
4191,203,1329244260,26,13,15,1329282000,37740,1248960,1897500,648540,7_7_7_7_7_7_7_7_7_7_7_1_1_7_7_7_7_7_7_7_7_7_17_17_17_17_4_17_4_4_4_17_17_1_1_2_2_13_9_9_3_9_3_13_4_17_13_9_3_9_3_17_3_3_4_4_9_13_3_4_3_17_17_15_1_26_17_17_9_15_1_15_1_17_4_13_13_15_1_1_15_4_4_13_9_3_1_13_4_15_1_3_13_1_26_3_13_6_6_15_26_15_5_26_25_26_26_5_25_3_3_3_4_4_4_13_4_4_13_4_4_4_4_4_4_4_26_4_5_4_4_5_4_26_15_15_26_26
4192,163,1329247380,17,10,17,1329284940,37560,135840,548880,413040,17_17_17_1_1_17_17_1_17_1_17_17_17_17
4193,152,1329247440,17,10,17,1329255060,7620,0,3766500,3766500,17
4194,153,1329248040,4,23,4,1329253080,5040,1433400,1618560,185160,16_1_16_1_0_0_1_1_2_2_3_3_4_4_4_4_4_4_4
4195,153,1329248040,4,23,4,1329248040,0,1433400,1618560,185160,16_1_16_1_0_0_1_1_2_2_3_3_4_4_4_4_4_4
4196,153,1329253080,4,23,4,1329253080,0,1438440,1618560,180120,16_1_16_1_0_0_1_1_2_2_3_3_4_4_4_4_4_4_4_4
4197,153,1329253080,4,23,4,1329255960,2880,1438440,1618560,180120,16_1_16_1_0_0_1_1_2_2_3_3_4_4_4_4_4_4_4_4_4
4198,84,1329253140,34,17,6,1329343200,90060,3594240,3714840,120600,17_17_17_17_17_17_17_17_17_17_17_17_17_17_17_17_1_1_2_2_3_3_18_18_18_18_18_18_5_5_34_34_34_34_34_34_34_34
4199,119,1329253200,14,17,14,1329260400,7200,2303580,2742780,439200,7_7_7_1_1_7_7_7_7_7_7_7_7_7_1_1_2_2_3_3_14_3_3_14_14
4200,152,1329255060,17,10,17,1329385200,130140,7620,3766500,3758880,17_17
4201,153,1329255960,4,23,4,1329256020,60,1441320,1618560,177240,16_1_16_1_0_0_1_1_2_2_3_3_4_4_4_4_4_4_4_4_4_4
4202,153,1329256020,4,22,4,1329277260,21240,1441380,1618560,177180,16_1_16_1_0_0_1_1_2_2_3_3_4_4_4_4_4_4_4_4_4_4_4
4203,107,1329256440,16,20,16,1329256560,120,1329840,4991760,3661920,8_8_8_8_28_28_28_28_28_28_8_8_8_8_16_16_16_16_16_1_16_16_16_1_16_16
4204,107,1329256560,16,11,16,1329281160,24600,1329960,4991760,3661800,8_8_8_8_28_28_28_28_28_28_8_8_8_8_16_16_16_16_16_1_16_16_16_1_16_16_16
4205,114,1329256800,6,7,6,1329260400,3600,1197480,1201080,3600,19_19_19_19_19_19_19_19_19_19_19_19_9_9_1_1_2_2_9_9_6_6_19_3_19_19_3_5_5_5_1_1_5_19_2_1_1_9_2_9_3_3_3_3_3_3_5_5_5_5_5_5_6
4206,135,1329256800,3,4,3,1329256800,0,3182400,5649480,2467080,19_19_19_19_19_19_19_19_19_19_19_19_1_19_1_19_19_19_1_1_1_1_19_19_19_19_19_19_1_1_1_1_19_19_19_19_19_19_19_19_19_19_19_19_1_19_1_19_19_19_19_19_19_1_19_1_1_1_2_2_1_1_2_2_9_3
4207,135,1329256800,3,4,9,1329261300,4500,3182400,5649480,2467080,19_19_19_19_19_19_19_19_19_19_19_19_1_19_1_19_19_19_1_1_1_1_19_19_19_19_19_19_1_1_1_1_19_19_19_19_19_19_19_19_19_19_19_19_1_19_1_19_19_19_19_19_19_1_19_1_1_1_2_2_1_1_2_2_9_3_3
4208,73,1329256800,6,7,6,1329260400,3600,1252800,1303500,50700,1_1_9_9_3_3_3_9_3_9_9_9_18_18_18_18_18_18_18_18_18_18_15_15_6
4209,141,1329256800,6,7,6,1329260400,3600,3603600,7406100,3802500,1_1_16_16_16_16_16_1_16_16_1_1_1_16_16_16_16_16_16_16_16_16_16_16_16_16_16_16_1_1_1_1_1_1_1_1_1_1_1_1_16_2_2_16_3_3_3_3_3_3_18_18_18_18_18_3_18_3_3_3_5_5_5_5_5_5_3_3_4_4_4_4_4_3_1_3_1_4_18_3_3_18_18_1_1_18_18_5_5_18_5_5_5_5_6
4210,135,1329256800,9,4,3,1329256800,0,3182400,5649480,2467080,19_19_19_19_19_19_19_19_19_19_19_19_1_19_1_19_19_19_1_1_1_1_19_19_19_19_19_19_1_1_1_1_19_19_19_19_19_19_19_19_19_19_19_19_1_19_1_19_19_19_19_19_19_1_19_1_1_1_2_2_1_1_2_2_9
4211,141,1329260400,6,7,5,1329308400,48000,3607200,7406100,3798900,1_1_16_16_16_16_16_1_16_16_1_1_1_16_16_16_16_16_16_16_16_16_16_16_16_16_16_16_1_1_1_1_1_1_1_1_1_1_1_1_16_2_2_16_3_3_3_3_3_3_18_18_18_18_18_3_18_3_3_3_5_5_5_5_5_5_3_3_4_4_4_4_4_3_1_3_1_4_18_3_3_18_18_1_1_18_18_5_5_18_5_5_5_5_6_6
4212,119,1329260400,14,17,14,1329329940,69540,2310780,2742780,432000,7_7_7_1_1_7_7_7_7_7_7_7_7_7_1_1_2_2_3_3_14_3_3_14_14_14
4213,73,1329260400,6,7,5,1329304800,44400,1256400,1303500,47100,1_1_9_9_3_3_3_9_3_9_9_9_18_18_18_18_18_18_18_18_18_18_15_15_6_6
4214,114,1329260400,6,7,99,1329260400,0,1201080,1201080,0,19_19_19_19_19_19_19_19_19_19_19_19_9_9_1_1_2_2_9_9_6_6_19_3_19_19_3_5_5_5_1_1_5_19_2_1_1_9_2_9_3_3_3_3_3_3_5_5_5_5_5_5_6_6
4215,135,1329261300,9,4,3,1329261300,0,3186900,5649480,2462580,19_19_19_19_19_19_19_19_19_19_19_19_1_19_1_19_19_19_1_1_1_1_19_19_19_19_19_19_1_1_1_1_19_19_19_19_19_19_19_19_19_19_19_19_1_19_1_19_19_19_19_19_19_1_19_1_1_1_2_2_1_1_2_2_9_3_3_9
4216,135,1329261300,3,4,3,1329261300,0,3186900,5649480,2462580,19_19_19_19_19_19_19_19_19_19_19_19_1_19_1_19_19_19_1_1_1_1_19_19_19_19_19_19_1_1_1_1_19_19_19_19_19_19_19_19_19_19_19_19_1_19_1_19_19_19_19_19_19_1_19_1_1_1_2_2_1_1_2_2_9_3_3_9_3
4217,135,1329261300,3,4,2,1329284280,22980,3186900,5649480,2462580,19_19_19_19_19_19_19_19_19_19_19_19_1_19_1_19_19_19_1_1_1_1_19_19_19_19_19_19_1_1_1_1_19_19_19_19_19_19_19_19_19_19_19_19_1_19_1_19_19_19_19_19_19_1_19_1_1_1_2_2_1_1_2_2_9_3_3_9_3_3
4218,153,1329277260,4,22,5,1329373320,96060,1462620,1618560,155940,16_1_16_1_0_0_1_1_2_2_3_3_4_4_4_4_4_4_4_4_4_4_4_4
4219,71,1329280800,7,0,7,1329281640,840,3019200,3996240,977040,29_29_1_1_7_7_1_7_1_7_7_7_7_7_1_7_1_7_7_7_7_7_7_1_1_7_7_7_7_7_7_7_7_1_1_7_7_7_7_1_1_1_1_7_7_1_7_1_7_7_7_7_7_7_7_1_7_7_7_1_7_7_7_7_7_7
4220,213,1329280920,0,0,0,1329281340,420,244500,3206820,2962320,0_0_0_0_0_1_0_1_0_0_0_0_0_0_0_0_1_1_0_0_0_0_0_0
4221,107,1329281160,16,11,1,1329282000,840,1354560,4991760,3637200,8_8_8_8_28_28_28_28_28_28_8_8_8_8_16_16_16_16_16_1_16_16_16_1_16_16_16_16
4222,85,1329281160,19,11,19,1329283080,1920,107940,778380,670440,19_19_19_19_19_19_19_19_19_19
4223,213,1329281340,0,1,1,1329281640,300,244920,3206820,2961900,0_0_0_0_0_1_0_1_0_0_0_0_0_0_0_0_1_1_0_0_0_0_0_0_0
4224,213,1329281640,1,9,1,1329283560,1920,245220,3206820,2961600,0_0_0_0_0_1_0_1_0_0_0_0_0_0_0_0_1_1_0_0_0_0_0_0_0_1
4225,71,1329281640,7,8,1,1329310680,29040,3020040,3996240,976200,29_29_1_1_7_7_1_7_1_7_7_7_7_7_1_7_1_7_7_7_7_7_7_1_1_7_7_7_7_7_7_7_7_1_1_7_7_7_7_1_1_1_1_7_7_1_7_1_7_7_7_7_7_7_7_1_7_7_7_1_7_7_7_7_7_7_7
4226,131,1329281820,18,22,18,1329281880,60,3021720,6825900,3804180,16_16_16_16_16_16_16_16_16_16_16_16_16_16_16_16_16_16_16_16_16_16_16_16_16_16_1_1_1_1_2_2_3_3_3_3_18_18_18_18_18_3_3_3_3_18_18_18
4227,131,1329281880,18,15,18,1329282000,120,3021780,6825900,3804120,16_16_16_16_16_16_16_16_16_16_16_16_16_16_16_16_16_16_16_16_16_16_16_16_16_16_1_1_1_1_2_2_3_3_3_3_18_18_18_18_18_3_3_3_3_18_18_18_18
4228,203,1329282000,15,2,15,1329288000,6000,1286700,1897500,610800,7_7_7_7_7_7_7_7_7_7_7_1_1_7_7_7_7_7_7_7_7_7_17_17_17_17_4_17_4_4_4_17_17_1_1_2_2_13_9_9_3_9_3_13_4_17_13_9_3_9_3_17_3_3_4_4_9_13_3_4_3_17_17_15_1_26_17_17_9_15_1_15_1_17_4_13_13_15_1_1_15_4_4_13_9_3_1_13_4_15_1_3_13_1_26_3_13_6_6_15_26_15_5_26_25_26_26_5_25_3_3_3_4_4_4_13_4_4_13_4_4_4_4_4_4_4_26_4_5_4_4_5_4_26_15_15_26_26_15
4229,107,1329282000,1,18,16,1329283020,1020,1355400,4991760,3636360,8_8_8_8_28_28_28_28_28_28_8_8_8_8_16_16_16_16_16_1_16_16_16_1_16_16_16_16_1
4230,131,1329282000,18,5,18,1329283680,1680,3021900,6825900,3804000,16_16_16_16_16_16_16_16_16_16_16_16_16_16_16_16_16_16_16_16_16_16_16_16_16_16_1_1_1_1_2_2_3_3_3_3_18_18_18_18_18_3_3_3_3_18_18_18_18_18
4231,107,1329283020,16,14,1,1329292800,9780,1356420,4991760,3635340,8_8_8_8_28_28_28_28_28_28_8_8_8_8_16_16_16_16_16_1_16_16_16_1_16_16_16_16_1_16
4232,85,1329283080,19,14,19,1329298920,15840,109860,778380,668520,19_19_19_19_19_19_19_19_19_19_19
4233,219,1329283260,26,16,26,1329300480,17220,0,3797940,3797940,26
4234,213,1329283560,1,9,0,1329320940,37380,247140,3206820,2959680,0_0_0_0_0_1_0_1_0_0_0_0_0_0_0_0_1_1_0_0_0_0_0_0_0_1_1
4235,131,1329283680,18,5,18,1329292920,9240,3023580,6825900,3802320,16_16_16_16_16_16_16_16_16_16_16_16_16_16_16_16_16_16_16_16_16_16_16_16_16_16_1_1_1_1_2_2_3_3_3_3_18_18_18_18_18_3_3_3_3_18_18_18_18_18_18
4236,135,1329284280,2,5,9,1329288000,3720,3209880,5649480,2439600,19_19_19_19_19_19_19_19_19_19_19_19_1_19_1_19_19_19_1_1_1_1_19_19_19_19_19_19_1_1_1_1_19_19_19_19_19_19_19_19_19_19_19_19_1_19_1_19_19_19_19_19_19_1_19_1_1_1_2_2_1_1_2_2_9_3_3_9_3_3_2
4237,163,1329284940,17,12,17,1329286320,1380,173400,548880,375480,17_17_17_1_1_17_17_1_17_1_17_17_17_17_17
4238,163,1329286320,17,12,17,1329292020,5700,174780,548880,374100,17_17_17_1_1_17_17_1_17_1_17_17_17_17_17_17
4239,133,1329286380,17,12,17,1329292020,5640,2495580,6181200,3685620,17_17_17_17_17_17_17_17_17_17_17_17_17_17_17_17_17_17_17_17_17_17_17_17_17_17_17_17_17_17_1_1_17_17_17_17_1_1_1_1_17_17_17_17_17_17_17_17_17_17_17_17_17_17_17_17_17
4240,203,1329288000,15,2,15,1329289200,1200,1292700,1897500,604800,7_7_7_7_7_7_7_7_7_7_7_1_1_7_7_7_7_7_7_7_7_7_17_17_17_17_4_17_4_4_4_17_17_1_1_2_2_13_9_9_3_9_3_13_4_17_13_9_3_9_3_17_3_3_4_4_9_13_3_4_3_17_17_15_1_26_17_17_9_15_1_15_1_17_4_13_13_15_1_1_15_4_4_13_9_3_1_13_4_15_1_3_13_1_26_3_13_6_6_15_26_15_5_26_25_26_26_5_25_3_3_3_4_4_4_13_4_4_13_4_4_4_4_4_4_4_26_4_5_4_4_5_4_26_15_15_26_26_15_15
4241,135,1329288000,9,3,9,1329289680,1680,3213600,5649480,2435880,19_19_19_19_19_19_19_19_19_19_19_19_1_19_1_19_19_19_1_1_1_1_19_19_19_19_19_19_1_1_1_1_19_19_19_19_19_19_19_19_19_19_19_19_1_19_1_19_19_19_19_19_19_1_19_1_1_1_2_2_1_1_2_2_9_3_3_9_3_3_2_9
4242,203,1329289200,25,28,15,1329303000,13800,1293900,1897500,603600,7_7_7_7_7_7_7_7_7_7_7_1_1_7_7_7_7_7_7_7_7_7_17_17_17_17_4_17_4_4_4_17_17_1_1_2_2_13_9_9_3_9_3_13_4_17_13_9_3_9_3_17_3_3_4_4_9_13_3_4_3_17_17_15_1_26_17_17_9_15_1_15_1_17_4_13_13_15_1_1_15_4_4_13_9_3_1_13_4_15_1_3_13_1_26_3_13_6_6_15_26_15_5_26_25_26_26_5_25_3_3_3_4_4_4_13_4_4_13_4_4_4_4_4_4_4_26_4_5_4_4_5_4_26_15_15_26_26_15_15_15_25
4243,203,1329289200,15,2,25,1329289200,0,1293900,1897500,603600,7_7_7_7_7_7_7_7_7_7_7_1_1_7_7_7_7_7_7_7_7_7_17_17_17_17_4_17_4_4_4_17_17_1_1_2_2_13_9_9_3_9_3_13_4_17_13_9_3_9_3_17_3_3_4_4_9_13_3_4_3_17_17_15_1_26_17_17_9_15_1_15_1_17_4_13_13_15_1_1_15_4_4_13_9_3_1_13_4_15_1_3_13_1_26_3_13_6_6_15_26_15_5_26_25_26_26_5_25_3_3_3_4_4_4_13_4_4_13_4_4_4_4_4_4_4_26_4_5_4_4_5_4_26_15_15_26_26_15_15_15
4244,135,1329289680,9,3,9,1329289740,60,3215280,5649480,2434200,19_19_19_19_19_19_19_19_19_19_19_19_1_19_1_19_19_19_1_1_1_1_19_19_19_19_19_19_1_1_1_1_19_19_19_19_19_19_19_19_19_19_19_19_1_19_1_19_19_19_19_19_19_1_19_1_1_1_2_2_1_1_2_2_9_3_3_9_3_3_2_9_9
4245,135,1329289740,9,3,2,1329289980,240,3215340,5649480,2434140,19_19_19_19_19_19_19_19_19_19_19_19_1_19_1_19_19_19_1_1_1_1_19_19_19_19_19_19_1_1_1_1_19_19_19_19_19_19_19_19_19_19_19_19_1_19_1_19_19_19_19_19_19_1_19_1_1_1_2_2_1_1_2_2_9_3_3_9_3_3_2_9_9_9
4246,135,1329289980,2,5,4,1329295800,5820,3215580,5649480,2433900,19_19_19_19_19_19_19_19_19_19_19_19_1_19_1_19_19_19_1_1_1_1_19_19_19_19_19_19_1_1_1_1_19_19_19_19_19_19_19_19_19_19_19_19_1_19_1_19_19_19_19_19_19_1_19_1_1_1_2_2_1_1_2_2_9_3_3_9_3_3_2_9_9_9_2
4247,163,1329292020,17,12,1,1329297360,5340,180480,548880,368400,17_17_17_1_1_17_17_1_17_1_17_17_17_17_17_17_17
4248,133,1329292020,17,12,17,1329321300,29280,2501220,6181200,3679980,17_17_17_17_17_17_17_17_17_17_17_17_17_17_17_17_17_17_17_17_17_17_17_17_17_17_17_17_17_17_1_1_17_17_17_17_1_1_1_1_17_17_17_17_17_17_17_17_17_17_17_17_17_17_17_17_17_17
4249,107,1329292800,1,18,16,1329313920,21120,1366200,4991760,3625560,8_8_8_8_28_28_28_28_28_28_8_8_8_8_16_16_16_16_16_1_16_16_16_1_16_16_16_16_1_16_1
4250,131,1329292920,18,15,18,1329297960,5040,3032820,6825900,3793080,16_16_16_16_16_16_16_16_16_16_16_16_16_16_16_16_16_16_16_16_16_16_16_16_16_16_1_1_1_1_2_2_3_3_3_3_18_18_18_18_18_3_3_3_3_18_18_18_18_18_18_18
4251,188,1329293940,2,15,2,1329297960,4020,621900,4327560,3705660,0_0_0_0_0_1_1_0_0_0_0_0_0_0_0_0_1_1_2
4252,135,1329295800,4,5,4,1329298620,2820,3221400,5649480,2428080,19_19_19_19_19_19_19_19_19_19_19_19_1_19_1_19_19_19_1_1_1_1_19_19_19_19_19_19_1_1_1_1_19_19_19_19_19_19_19_19_19_19_19_19_1_19_1_19_19_19_19_19_19_1_19_1_1_1_2_2_1_1_2_2_9_3_3_9_3_3_2_9_9_9_2_4
4253,163,1329297360,1,18,1,1329303000,5640,185820,548880,363060,17_17_17_1_1_17_17_1_17_1_17_17_17_17_17_17_17_1
4254,188,1329297960,2,15,2,1329386040,88080,625920,4327560,3701640,0_0_0_0_0_1_1_0_0_0_0_0_0_0_0_0_1_1_2_2
4255,131,1329297960,18,15,18,1329315000,17040,3037860,6825900,3788040,16_16_16_16_16_16_16_16_16_16_16_16_16_16_16_16_16_16_16_16_16_16_16_16_16_16_1_1_1_1_2_2_3_3_3_3_18_18_18_18_18_3_3_3_3_18_18_18_18_18_18_18_18
4256,135,1329298620,4,5,3,1329298860,240,3224220,5649480,2425260,19_19_19_19_19_19_19_19_19_19_19_19_1_19_1_19_19_19_1_1_1_1_19_19_19_19_19_19_1_1_1_1_19_19_19_19_19_19_19_19_19_19_19_19_1_19_1_19_19_19_19_19_19_1_19_1_1_1_2_2_1_1_2_2_9_3_3_9_3_3_2_9_9_9_2_4_4
4257,135,1329298860,3,4,4,1329298980,120,3224460,5649480,2425020,19_19_19_19_19_19_19_19_19_19_19_19_1_19_1_19_19_19_1_1_1_1_19_19_19_19_19_19_1_1_1_1_19_19_19_19_19_19_19_19_19_19_19_19_1_19_1_19_19_19_19_19_19_1_19_1_1_1_2_2_1_1_2_2_9_3_3_9_3_3_2_9_9_9_2_4_4_3
4258,85,1329298920,19,14,1,1329458280,159360,125700,778380,652680,19_19_19_19_19_19_19_19_19_19_19_19
4259,135,1329298980,4,5,3,1329303360,4380,3224580,5649480,2424900,19_19_19_19_19_19_19_19_19_19_19_19_1_19_1_19_19_19_1_1_1_1_19_19_19_19_19_19_1_1_1_1_19_19_19_19_19_19_19_19_19_19_19_19_1_19_1_19_19_19_19_19_19_1_19_1_1_1_2_2_1_1_2_2_9_3_3_9_3_3_2_9_9_9_2_4_4_3_4
4260,151,1329299100,19,14,19,1329313920,14820,1176900,3643800,2466900,19_19_19_19_19_1_1_19_1_1_19_19_19_19_1_19_1_19_19_19_19_19_19_19_19_19_1_19_19_1_1_1_1_1_19
4261,219,1329300480,26,16,26,1329301080,600,17220,3797940,3780720,26_26
4262,219,1329301080,26,16,26,1329314160,13080,17820,3797940,3780120,26_26_26
4263,163,1329303000,1,18,17,1329312180,9180,191460,548880,357420,17_17_17_1_1_17_17_1_17_1_17_17_17_17_17_17_17_1_1
4264,203,1329303000,15,2,5,1329304800,1800,1307700,1897500,589800,7_7_7_7_7_7_7_7_7_7_7_1_1_7_7_7_7_7_7_7_7_7_17_17_17_17_4_17_4_4_4_17_17_1_1_2_2_13_9_9_3_9_3_13_4_17_13_9_3_9_3_17_3_3_4_4_9_13_3_4_3_17_17_15_1_26_17_17_9_15_1_15_1_17_4_13_13_15_1_1_15_4_4_13_9_3_1_13_4_15_1_3_13_1_26_3_13_6_6_15_26_15_5_26_25_26_26_5_25_3_3_3_4_4_4_13_4_4_13_4_4_4_4_4_4_4_26_4_5_4_4_5_4_26_15_15_26_26_15_15_15_25_15
4265,135,1329303360,3,4,3,1329304560,1200,3228960,5649480,2420520,19_19_19_19_19_19_19_19_19_19_19_19_1_19_1_19_19_19_1_1_1_1_19_19_19_19_19_19_1_1_1_1_19_19_19_19_19_19_19_19_19_19_19_19_1_19_1_19_19_19_19_19_19_1_19_1_1_1_2_2_1_1_2_2_9_3_3_9_3_3_2_9_9_9_2_4_4_3_4_3
4266,135,1329304560,3,4,9,1329314460,9900,3230160,5649480,2419320,19_19_19_19_19_19_19_19_19_19_19_19_1_19_1_19_19_19_1_1_1_1_19_19_19_19_19_19_1_1_1_1_19_19_19_19_19_19_19_19_19_19_19_19_1_19_1_19_19_19_19_19_19_1_19_1_1_1_2_2_1_1_2_2_9_3_3_9_3_3_2_9_9_9_2_4_4_3_4_3_3
4267,203,1329304800,5,2,5,1329308400,3600,1309500,1897500,588000,7_7_7_7_7_7_7_7_7_7_7_1_1_7_7_7_7_7_7_7_7_7_17_17_17_17_4_17_4_4_4_17_17_1_1_2_2_13_9_9_3_9_3_13_4_17_13_9_3_9_3_17_3_3_4_4_9_13_3_4_3_17_17_15_1_26_17_17_9_15_1_15_1_17_4_13_13_15_1_1_15_4_4_13_9_3_1_13_4_15_1_3_13_1_26_3_13_6_6_15_26_15_5_26_25_26_26_5_25_3_3_3_4_4_4_13_4_4_13_4_4_4_4_4_4_4_26_4_5_4_4_5_4_26_15_15_26_26_15_15_15_25_15_5
4268,73,1329304800,5,18,5,1329307500,2700,1300800,1303500,2700,1_1_9_9_3_3_3_9_3_9_9_9_18_18_18_18_18_18_18_18_18_18_15_15_6_6_5
4269,73,1329307500,5,18,99,1329307500,0,1303500,1303500,0,1_1_9_9_3_3_3_9_3_9_9_9_18_18_18_18_18_18_18_18_18_18_15_15_6_6_5_5
4270,199,1329308400,2,3,2,1329309600,1200,631440,975720,344280,0_0_0_0_0_0_0_0_0_0_0_0_0_1_1_0_0_0_0_0_1_1_2
4271,141,1329308400,5,2,5,1329321780,13380,3655200,7406100,3750900,1_1_16_16_16_16_16_1_16_16_1_1_1_16_16_16_16_16_16_16_16_16_16_16_16_16_16_16_1_1_1_1_1_1_1_1_1_1_1_1_16_2_2_16_3_3_3_3_3_3_18_18_18_18_18_3_18_3_3_3_5_5_5_5_5_5_3_3_4_4_4_4_4_3_1_3_1_4_18_3_3_18_18_1_1_18_18_5_5_18_5_5_5_5_6_6_5
4272,203,1329308400,5,2,25,1329313620,5220,1313100,1897500,584400,7_7_7_7_7_7_7_7_7_7_7_1_1_7_7_7_7_7_7_7_7_7_17_17_17_17_4_17_4_4_4_17_17_1_1_2_2_13_9_9_3_9_3_13_4_17_13_9_3_9_3_17_3_3_4_4_9_13_3_4_3_17_17_15_1_26_17_17_9_15_1_15_1_17_4_13_13_15_1_1_15_4_4_13_9_3_1_13_4_15_1_3_13_1_26_3_13_6_6_15_26_15_5_26_25_26_26_5_25_3_3_3_4_4_4_13_4_4_13_4_4_4_4_4_4_4_26_4_5_4_4_5_4_26_15_15_26_26_15_15_15_25_15_5_5
4273,199,1329309600,2,3,18,1329392340,82740,632640,975720,343080,0_0_0_0_0_0_0_0_0_0_0_0_0_1_1_0_0_0_0_0_1_1_2_2
4274,143,1329309660,2,3,2,1329312360,2700,1838580,1898460,59880,10_10_10_1_10_1_10_1_1_10_10_10_10_10_1_1_10_1_10_1_10_10_10_10_1_1_1_1_1_1_9_9_3_3_4_4_4_4_4_4_2
4275,71,1329310680,1,18,7,1329311340,660,3049080,3996240,947160,29_29_1_1_7_7_1_7_1_7_7_7_7_7_1_7_1_7_7_7_7_7_7_1_1_7_7_7_7_7_7_7_7_1_1_7_7_7_7_1_1_1_1_7_7_1_7_1_7_7_7_7_7_7_7_1_7_7_7_1_7_7_7_7_7_7_7_1
4276,71,1329311340,7,8,1,1329314400,3060,3049740,3996240,946500,29_29_1_1_7_7_1_7_1_7_7_7_7_7_1_7_1_7_7_7_7_7_7_1_1_7_7_7_7_7_7_7_7_1_1_7_7_7_7_1_1_1_1_7_7_1_7_1_7_7_7_7_7_7_7_1_7_7_7_1_7_7_7_7_7_7_7_1_7
4277,163,1329312180,17,12,1,1329375600,63420,200640,548880,348240,17_17_17_1_1_17_17_1_17_1_17_17_17_17_17_17_17_1_1_17
4278,143,1329312360,2,3,6,1329343200,30840,1841280,1898460,57180,10_10_10_1_10_1_10_1_1_10_10_10_10_10_1_1_10_1_10_1_10_10_10_10_1_1_1_1_1_1_9_9_3_3_4_4_4_4_4_4_2_2
4279,203,1329313620,25,28,26,1329313860,240,1318320,1897500,579180,7_7_7_7_7_7_7_7_7_7_7_1_1_7_7_7_7_7_7_7_7_7_17_17_17_17_4_17_4_4_4_17_17_1_1_2_2_13_9_9_3_9_3_13_4_17_13_9_3_9_3_17_3_3_4_4_9_13_3_4_3_17_17_15_1_26_17_17_9_15_1_15_1_17_4_13_13_15_1_1_15_4_4_13_9_3_1_13_4_15_1_3_13_1_26_3_13_6_6_15_26_15_5_26_25_26_26_5_25_3_3_3_4_4_4_13_4_4_13_4_4_4_4_4_4_4_26_4_5_4_4_5_4_26_15_15_26_26_15_15_15_25_15_5_5_25
4280,203,1329313860,26,16,26,1329313920,60,1318560,1897500,578940,7_7_7_7_7_7_7_7_7_7_7_1_1_7_7_7_7_7_7_7_7_7_17_17_17_17_4_17_4_4_4_17_17_1_1_2_2_13_9_9_3_9_3_13_4_17_13_9_3_9_3_17_3_3_4_4_9_13_3_4_3_17_17_15_1_26_17_17_9_15_1_15_1_17_4_13_13_15_1_1_15_4_4_13_9_3_1_13_4_15_1_3_13_1_26_3_13_6_6_15_26_15_5_26_25_26_26_5_25_3_3_3_4_4_4_13_4_4_13_4_4_4_4_4_4_4_26_4_5_4_4_5_4_26_15_15_26_26_15_15_15_25_15_5_5_25_26
4281,107,1329313920,16,14,16,1329321240,7320,1387320,4991760,3604440,8_8_8_8_28_28_28_28_28_28_8_8_8_8_16_16_16_16_16_1_16_16_16_1_16_16_16_16_1_16_1_16
4282,151,1329313920,19,14,19,1329314160,240,1191720,3643800,2452080,19_19_19_19_19_1_1_19_1_1_19_19_19_19_1_19_1_19_19_19_19_19_19_19_19_19_1_19_19_1_1_1_1_1_19_19
4283,203,1329313920,26,16,6,1329343200,29280,1318620,1897500,578880,7_7_7_7_7_7_7_7_7_7_7_1_1_7_7_7_7_7_7_7_7_7_17_17_17_17_4_17_4_4_4_17_17_1_1_2_2_13_9_9_3_9_3_13_4_17_13_9_3_9_3_17_3_3_4_4_9_13_3_4_3_17_17_15_1_26_17_17_9_15_1_15_1_17_4_13_13_15_1_1_15_4_4_13_9_3_1_13_4_15_1_3_13_1_26_3_13_6_6_15_26_15_5_26_25_26_26_5_25_3_3_3_4_4_4_13_4_4_13_4_4_4_4_4_4_4_26_4_5_4_4_5_4_26_15_15_26_26_15_15_15_25_15_5_5_25_26_26
4284,219,1329314160,26,16,26,1329317100,2940,30900,3797940,3767040,26_26_26_26
4285,151,1329314160,19,20,19,1329328320,14160,1191960,3643800,2451840,19_19_19_19_19_1_1_19_1_1_19_19_19_19_1_19_1_19_19_19_19_19_19_19_19_19_1_19_19_1_1_1_1_1_19_19_19
4286,71,1329314400,1,18,7,1329315360,960,3052800,3996240,943440,29_29_1_1_7_7_1_7_1_7_7_7_7_7_1_7_1_7_7_7_7_7_7_1_1_7_7_7_7_7_7_7_7_1_1_7_7_7_7_1_1_1_1_7_7_1_7_1_7_7_7_7_7_7_7_1_7_7_7_1_7_7_7_7_7_7_7_1_7_1
4287,135,1329314460,9,3,3,1329314880,420,3240060,5649480,2409420,19_19_19_19_19_19_19_19_19_19_19_19_1_19_1_19_19_19_1_1_1_1_19_19_19_19_19_19_1_1_1_1_19_19_19_19_19_19_19_19_19_19_19_19_1_19_1_19_19_19_19_19_19_1_19_1_1_1_2_2_1_1_2_2_9_3_3_9_3_3_2_9_9_9_2_4_4_3_4_3_3_9
4288,135,1329314880,3,4,4,1329320820,5940,3240480,5649480,2409000,19_19_19_19_19_19_19_19_19_19_19_19_1_19_1_19_19_19_1_1_1_1_19_19_19_19_19_19_1_1_1_1_19_19_19_19_19_19_19_19_19_19_19_19_1_19_1_19_19_19_19_19_19_1_19_1_1_1_2_2_1_1_2_2_9_3_3_9_3_3_2_9_9_9_2_4_4_3_4_3_3_9_3
4289,131,1329315000,18,15,18,1329317700,2700,3054900,6825900,3771000,16_16_16_16_16_16_16_16_16_16_16_16_16_16_16_16_16_16_16_16_16_16_16_16_16_16_1_1_1_1_2_2_3_3_3_3_18_18_18_18_18_3_3_3_3_18_18_18_18_18_18_18_18_18
4290,71,1329315360,7,10,7,1329341340,25980,3053760,3996240,942480,29_29_1_1_7_7_1_7_1_7_7_7_7_7_1_7_1_7_7_7_7_7_7_1_1_7_7_7_7_7_7_7_7_1_1_7_7_7_7_1_1_1_1_7_7_1_7_1_7_7_7_7_7_7_7_1_7_7_7_1_7_7_7_7_7_7_7_1_7_1_7
4291,63,1329316980,3,3,3,1329319560,2580,2465520,6232860,3767340,16_16_16_16_16_16_16_16_16_0_0_16_16_0_16_16_0_16_16_0_0_16_16_16_0_0_16_0_0_16_0_16_0_0_0_16_1_1_1_16_16_16_0_1_1_1_16_0_0_16_16_0_16_0_16_0_0_2_2_1_1_0_0_0_0_2_2_2_2_2_2_0_1_0_1_1_0_0_0_1_1_0_0_1_1_1_0_0_0_0_0_2_2_2_2_0_0_0_0_0_0_1_1_1_1_0_0_16_0_16_16_16_16_16_0_0_1_1_2_2_1_1_16_0_2_16_2_2_2_0_1_1_1_1_1_16_16_1_1_1_3
4292,219,1329317100,26,13,26,1329326220,9120,33840,3797940,3764100,26_26_26_26_26
4293,131,1329317700,18,23,18,1329319140,1440,3057600,6825900,3768300,16_16_16_16_16_16_16_16_16_16_16_16_16_16_16_16_16_16_16_16_16_16_16_16_16_16_1_1_1_1_2_2_3_3_3_3_18_18_18_18_18_3_3_3_3_18_18_18_18_18_18_18_18_18_18
4294,131,1329319140,18,23,18,1329322740,3600,3059040,6825900,3766860,16_16_16_16_16_16_16_16_16_16_16_16_16_16_16_16_16_16_16_16_16_16_16_16_16_16_1_1_1_1_2_2_3_3_3_3_18_18_18_18_18_3_3_3_3_18_18_18_18_18_18_18_18_18_18_18
4295,63,1329319560,3,3,18,1329371940,52380,2468100,6232860,3764760,16_16_16_16_16_16_16_16_16_0_0_16_16_0_16_16_0_16_16_0_0_16_16_16_0_0_16_0_0_16_0_16_0_0_0_16_1_1_1_16_16_16_0_1_1_1_16_0_0_16_16_0_16_0_16_0_0_2_2_1_1_0_0_0_0_2_2_2_2_2_2_0_1_0_1_1_0_0_0_1_1_0_0_1_1_1_0_0_0_0_0_2_2_2_2_0_0_0_0_0_0_1_1_1_1_0_0_16_0_16_16_16_16_16_0_0_1_1_2_2_1_1_16_0_2_16_2_2_2_0_1_1_1_1_1_16_16_1_1_1_3_3
4296,135,1329320820,4,5,4,1329329880,9060,3246420,5649480,2403060,19_19_19_19_19_19_19_19_19_19_19_19_1_19_1_19_19_19_1_1_1_1_19_19_19_19_19_19_1_1_1_1_19_19_19_19_19_19_19_19_19_19_19_19_1_19_1_19_19_19_19_19_19_1_19_1_1_1_2_2_1_1_2_2_9_3_3_9_3_3_2_9_9_9_2_4_4_3_4_3_3_9_3_4
4297,213,1329320940,0,1,0,1329322800,1860,284520,3206820,2922300,0_0_0_0_0_1_0_1_0_0_0_0_0_0_0_0_1_1_0_0_0_0_0_0_0_1_1_0
4298,107,1329321240,16,1,16,1329321600,360,1394640,4991760,3597120,8_8_8_8_28_28_28_28_28_28_8_8_8_8_16_16_16_16_16_1_16_16_16_1_16_16_16_16_1_16_1_16_16
4299,133,1329321300,17,10,17,1329334860,13560,2530500,6181200,3650700,17_17_17_17_17_17_17_17_17_17_17_17_17_17_17_17_17_17_17_17_17_17_17_17_17_17_17_17_17_17_1_1_17_17_17_17_1_1_1_1_17_17_17_17_17_17_17_17_17_17_17_17_17_17_17_17_17_17_17
4300,107,1329321600,16,1,16,1329322560,960,1395000,4991760,3596760,8_8_8_8_28_28_28_28_28_28_8_8_8_8_16_16_16_16_16_1_16_16_16_1_16_16_16_16_1_16_1_16_16_16
4301,141,1329321780,5,2,6,1329343200,21420,3668580,7406100,3737520,1_1_16_16_16_16_16_1_16_16_1_1_1_16_16_16_16_16_16_16_16_16_16_16_16_16_16_16_1_1_1_1_1_1_1_1_1_1_1_1_16_2_2_16_3_3_3_3_3_3_18_18_18_18_18_3_18_3_3_3_5_5_5_5_5_5_3_3_4_4_4_4_4_3_1_3_1_4_18_3_3_18_18_1_1_18_18_5_5_18_5_5_5_5_6_6_5_5
4302,107,1329322560,16,20,16,1329342360,19800,1395960,4991760,3595800,8_8_8_8_28_28_28_28_28_28_8_8_8_8_16_16_16_16_16_1_16_16_16_1_16_16_16_16_1_16_1_16_16_16_16
4303,131,1329322740,18,23,18,1329343020,20280,3062640,6825900,3763260,16_16_16_16_16_16_16_16_16_16_16_16_16_16_16_16_16_16_16_16_16_16_16_16_16_16_1_1_1_1_2_2_3_3_3_3_18_18_18_18_18_3_3_3_3_18_18_18_18_18_18_18_18_18_18_18_18
4304,213,1329322800,0,20,0,1329328260,5460,286380,3206820,2920440,0_0_0_0_0_1_0_1_0_0_0_0_0_0_0_0_1_1_0_0_0_0_0_0_0_1_1_0_0
4305,219,1329326220,26,13,26,1329326280,60,42960,3797940,3754980,26_26_26_26_26_26
4306,219,1329326280,26,13,26,1329330600,4320,43020,3797940,3754920,26_26_26_26_26_26_26
4307,213,1329328260,0,0,0,1329341760,13500,291840,3206820,2914980,0_0_0_0_0_1_0_1_0_0_0_0_0_0_0_0_1_1_0_0_0_0_0_0_0_1_1_0_0_0_0
4308,213,1329328260,0,20,0,1329328260,0,291840,3206820,2914980,0_0_0_0_0_1_0_1_0_0_0_0_0_0_0_0_1_1_0_0_0_0_0_0_0_1_1_0_0_0
4309,151,1329328320,19,20,19,1329329880,1560,1206120,3643800,2437680,19_19_19_19_19_1_1_19_1_1_19_19_19_19_1_19_1_19_19_19_19_19_19_19_19_19_1_19_19_1_1_1_1_1_19_19_19_19
4310,135,1329329880,4,22,4,1329343680,13800,3255480,5649480,2394000,19_19_19_19_19_19_19_19_19_19_19_19_1_19_1_19_19_19_1_1_1_1_19_19_19_19_19_19_1_1_1_1_19_19_19_19_19_19_19_19_19_19_19_19_1_19_1_19_19_19_19_19_19_1_19_1_1_1_2_2_1_1_2_2_9_3_3_9_3_3_2_9_9_9_2_4_4_3_4_3_3_9_3_4_4
4311,151,1329329880,19,11,19,1329362340,32460,1207680,3643800,2436120,19_19_19_19_19_1_1_19_1_1_19_19_19_19_1_19_1_19_19_19_19_19_19_19_19_19_1_19_19_1_1_1_1_1_19_19_19_19_19
4312,119,1329329940,14,17,14,1329368040,38100,2380320,2742780,362460,7_7_7_1_1_7_7_7_7_7_7_7_7_7_1_1_2_2_3_3_14_3_3_14_14_14_14
4313,219,1329330600,26,13,26,1329330600,0,47340,3797940,3750600,26_26_26_26_26_26_26_26
4314,219,1329330600,26,13,26,1329340500,9900,47340,3797940,3750600,26_26_26_26_26_26_26_26_26
4315,133,1329334860,17,10,17,1329334920,60,2544060,6181200,3637140,17_17_17_17_17_17_17_17_17_17_17_17_17_17_17_17_17_17_17_17_17_17_17_17_17_17_17_17_17_17_1_1_17_17_17_17_1_1_1_1_17_17_17_17_17_17_17_17_17_17_17_17_17_17_17_17_17_17_17_17
4316,133,1329334920,17,10,17,1329341400,6480,2544120,6181200,3637080,17_17_17_17_17_17_17_17_17_17_17_17_17_17_17_17_17_17_17_17_17_17_17_17_17_17_17_17_17_17_1_1_17_17_17_17_1_1_1_1_17_17_17_17_17_17_17_17_17_17_17_17_17_17_17_17_17_17_17_17_17
4317,219,1329340500,26,13,8,1329368400,27900,57240,3797940,3740700,26_26_26_26_26_26_26_26_26_26
4318,168,1329340800,10,13,10,1329344940,4140,0,438000,438000,10
4319,71,1329341340,7,10,7,1329341580,240,3079740,3996240,916500,29_29_1_1_7_7_1_7_1_7_7_7_7_7_1_7_1_7_7_7_7_7_7_1_1_7_7_7_7_7_7_7_7_1_1_7_7_7_7_1_1_1_1_7_7_1_7_1_7_7_7_7_7_7_7_1_7_7_7_1_7_7_7_7_7_7_7_1_7_1_7_7
4320,133,1329341400,17,10,19,1329341640,240,2550600,6181200,3630600,17_17_17_17_17_17_17_17_17_17_17_17_17_17_17_17_17_17_17_17_17_17_17_17_17_17_17_17_17_17_1_1_17_17_17_17_1_1_1_1_17_17_17_17_17_17_17_17_17_17_17_17_17_17_17_17_17_17_17_17_17_17
4321,71,1329341580,7,0,7,1329367440,25860,3079980,3996240,916260,29_29_1_1_7_7_1_7_1_7_7_7_7_7_1_7_1_7_7_7_7_7_7_1_1_7_7_7_7_7_7_7_7_1_1_7_7_7_7_1_1_1_1_7_7_1_7_1_7_7_7_7_7_7_7_1_7_7_7_1_7_7_7_7_7_7_7_1_7_1_7_7_7
4322,133,1329341640,19,0,19,1329367440,25800,2550840,6181200,3630360,17_17_17_17_17_17_17_17_17_17_17_17_17_17_17_17_17_17_17_17_17_17_17_17_17_17_17_17_17_17_1_1_17_17_17_17_1_1_1_1_17_17_17_17_17_17_17_17_17_17_17_17_17_17_17_17_17_17_17_17_17_17_19
4323,213,1329341760,0,0,0,1329342420,660,305340,3206820,2901480,0_0_0_0_0_1_0_1_0_0_0_0_0_0_0_0_1_1_0_0_0_0_0_0_0_1_1_0_0_0_0_0
4324,107,1329342360,16,20,16,1329342480,120,1415760,4991760,3576000,8_8_8_8_28_28_28_28_28_28_8_8_8_8_16_16_16_16_16_1_16_16_16_1_16_16_16_16_1_16_1_16_16_16_16_16
4325,213,1329342420,0,11,0,1329367140,24720,306000,3206820,2900820,0_0_0_0_0_1_0_1_0_0_0_0_0_0_0_0_1_1_0_0_0_0_0_0_0_1_1_0_0_0_0_0_0
4326,107,1329342480,16,11,16,1329367140,24660,1415880,4991760,3575880,8_8_8_8_28_28_28_28_28_28_8_8_8_8_16_16_16_16_16_1_16_16_16_1_16_16_16_16_1_16_1_16_16_16_16_16_16
4327,131,1329343020,18,23,18,1329343800,780,3082920,6825900,3742980,16_16_16_16_16_16_16_16_16_16_16_16_16_16_16_16_16_16_16_16_16_16_16_16_16_16_1_1_1_1_2_2_3_3_3_3_18_18_18_18_18_3_3_3_3_18_18_18_18_18_18_18_18_18_18_18_18_18
4328,203,1329343200,6,7,6,1329346800,3600,1347900,1897500,549600,7_7_7_7_7_7_7_7_7_7_7_1_1_7_7_7_7_7_7_7_7_7_17_17_17_17_4_17_4_4_4_17_17_1_1_2_2_13_9_9_3_9_3_13_4_17_13_9_3_9_3_17_3_3_4_4_9_13_3_4_3_17_17_15_1_26_17_17_9_15_1_15_1_17_4_13_13_15_1_1_15_4_4_13_9_3_1_13_4_15_1_3_13_1_26_3_13_6_6_15_26_15_5_26_25_26_26_5_25_3_3_3_4_4_4_13_4_4_13_4_4_4_4_4_4_4_26_4_5_4_4_5_4_26_15_15_26_26_15_15_15_25_15_5_5_25_26_26_6
4329,141,1329343200,6,7,6,1329346800,3600,3690000,7406100,3716100,1_1_16_16_16_16_16_1_16_16_1_1_1_16_16_16_16_16_16_16_16_16_16_16_16_16_16_16_1_1_1_1_1_1_1_1_1_1_1_1_16_2_2_16_3_3_3_3_3_3_18_18_18_18_18_3_18_3_3_3_5_5_5_5_5_5_3_3_4_4_4_4_4_3_1_3_1_4_18_3_3_18_18_1_1_18_18_5_5_18_5_5_5_5_6_6_5_5_6_6
4330,141,1329343200,6,7,6,1329343200,0,3690000,7406100,3716100,1_1_16_16_16_16_16_1_16_16_1_1_1_16_16_16_16_16_16_16_16_16_16_16_16_16_16_16_1_1_1_1_1_1_1_1_1_1_1_1_16_2_2_16_3_3_3_3_3_3_18_18_18_18_18_3_18_3_3_3_5_5_5_5_5_5_3_3_4_4_4_4_4_3_1_3_1_4_18_3_3_18_18_1_1_18_18_5_5_18_5_5_5_5_6_6_5_5_6
4331,143,1329343200,6,30,6,1329346800,3600,1872120,1898460,26340,10_10_10_1_10_1_10_1_1_10_10_10_10_10_1_1_10_1_10_1_10_10_10_10_1_1_1_1_1_1_9_9_3_3_4_4_4_4_4_4_2_2_6
4332,84,1329343200,6,7,6,1329346800,3600,3684300,3714840,30540,17_17_17_17_17_17_17_17_17_17_17_17_17_17_17_17_1_1_2_2_3_3_18_18_18_18_18_18_5_5_34_34_34_34_34_34_34_34_6
4333,111,1329343200,18,9,18,1329347700,4500,3884400,3974400,90000,0_0_0_0_0_0_0_0_0_0_0_1_0_1_0_0_0_0_1_0_1_0_0_0_0_0_0_1_1_0_1_1_2_2_4_4_4_4_4_1_4_4_1_4_4_4_4_4_4_4_4_4_18_18_18_18_18_18_18_18_18_18_18
4334,135,1329343680,4,22,4,1329368220,24540,3269280,5649480,2380200,19_19_19_19_19_19_19_19_19_19_19_19_1_19_1_19_19_19_1_1_1_1_19_19_19_19_19_19_1_1_1_1_19_19_19_19_19_19_19_19_19_19_19_19_1_19_1_19_19_19_19_19_19_1_19_1_1_1_2_2_1_1_2_2_9_3_3_9_3_3_2_9_9_9_2_4_4_3_4_3_3_9_3_4_4_4
4335,131,1329343800,18,22,18,1329367680,23880,3083700,6825900,3742200,16_16_16_16_16_16_16_16_16_16_16_16_16_16_16_16_16_16_16_16_16_16_16_16_16_16_1_1_1_1_2_2_3_3_3_3_18_18_18_18_18_3_3_3_3_18_18_18_18_18_18_18_18_18_18_18_18_18_18
4336,168,1329344940,10,13,10,1329376260,31320,4140,438000,433860,10_10
4337,141,1329346800,6,7,5,1329369300,22500,3693600,7406100,3712500,1_1_16_16_16_16_16_1_16_16_1_1_1_16_16_16_16_16_16_16_16_16_16_16_16_16_16_16_1_1_1_1_1_1_1_1_1_1_1_1_16_2_2_16_3_3_3_3_3_3_18_18_18_18_18_3_18_3_3_3_5_5_5_5_5_5_3_3_4_4_4_4_4_3_1_3_1_4_18_3_3_18_18_1_1_18_18_5_5_18_5_5_5_5_6_6_5_5_6_6_6_6
4338,143,1329346800,6,30,5,1329367800,21000,1875720,1898460,22740,10_10_10_1_10_1_10_1_1_10_10_10_10_10_1_1_10_1_10_1_10_10_10_10_1_1_1_1_1_1_9_9_3_3_4_4_4_4_4_4_2_2_6_6
4339,203,1329346800,6,7,5,1329832800,486000,1351500,1897500,546000,7_7_7_7_7_7_7_7_7_7_7_1_1_7_7_7_7_7_7_7_7_7_17_17_17_17_4_17_4_4_4_17_17_1_1_2_2_13_9_9_3_9_3_13_4_17_13_9_3_9_3_17_3_3_4_4_9_13_3_4_3_17_17_15_1_26_17_17_9_15_1_15_1_17_4_13_13_15_1_1_15_4_4_13_9_3_1_13_4_15_1_3_13_1_26_3_13_6_6_15_26_15_5_26_25_26_26_5_25_3_3_3_4_4_4_13_4_4_13_4_4_4_4_4_4_4_26_4_5_4_4_5_4_26_15_15_26_26_15_15_15_25_15_5_5_25_26_26_6_6
4340,84,1329346800,6,7,5,1329370140,23340,3687900,3714840,26940,17_17_17_17_17_17_17_17_17_17_17_17_17_17_17_17_1_1_2_2_3_3_18_18_18_18_18_18_5_5_34_34_34_34_34_34_34_34_6_6
4341,141,1329346800,6,7,6,1329346800,0,3693600,7406100,3712500,1_1_16_16_16_16_16_1_16_16_1_1_1_16_16_16_16_16_16_16_16_16_16_16_16_16_16_16_1_1_1_1_1_1_1_1_1_1_1_1_16_2_2_16_3_3_3_3_3_3_18_18_18_18_18_3_18_3_3_3_5_5_5_5_5_5_3_3_4_4_4_4_4_3_1_3_1_4_18_3_3_18_18_1_1_18_18_5_5_18_5_5_5_5_6_6_5_5_6_6_6
4342,111,1329347700,18,9,5,1329375720,28020,3888900,3974400,85500,0_0_0_0_0_0_0_0_0_0_0_1_0_1_0_0_0_0_1_0_1_0_0_0_0_0_0_1_1_0_1_1_2_2_4_4_4_4_4_1_4_4_1_4_4_4_4_4_4_4_4_4_18_18_18_18_18_18_18_18_18_18_18_18
4343,151,1329362340,19,11,1,1329370560,8220,1240140,3643800,2403660,19_19_19_19_19_1_1_19_1_1_19_19_19_19_1_19_1_19_19_19_19_19_19_19_19_19_1_19_19_1_1_1_1_1_19_19_19_19_19_19
4344,213,1329367140,0,11,0,1329367800,660,330720,3206820,2876100,0_0_0_0_0_1_0_1_0_0_0_0_0_0_0_0_1_1_0_0_0_0_0_0_0_1_1_0_0_0_0_0_0_0
4345,107,1329367140,16,11,1,1329368400,1260,1440540,4991760,3551220,8_8_8_8_28_28_28_28_28_28_8_8_8_8_16_16_16_16_16_1_16_16_16_1_16_16_16_16_1_16_1_16_16_16_16_16_16_16
4346,71,1329367440,7,0,7,1329369000,1560,3105840,3996240,890400,29_29_1_1_7_7_1_7_1_7_7_7_7_7_1_7_1_7_7_7_7_7_7_1_1_7_7_7_7_7_7_7_7_1_1_7_7_7_7_1_1_1_1_7_7_1_7_1_7_7_7_7_7_7_7_1_7_7_7_1_7_7_7_7_7_7_7_1_7_1_7_7_7_7
4347,133,1329367440,19,0,17,1329369360,1920,2576640,6181200,3604560,17_17_17_17_17_17_17_17_17_17_17_17_17_17_17_17_17_17_17_17_17_17_17_17_17_17_17_17_17_17_1_1_17_17_17_17_1_1_1_1_17_17_17_17_17_17_17_17_17_17_17_17_17_17_17_17_17_17_17_17_17_17_19_19
4348,131,1329367680,18,22,18,1329367860,180,3107580,6825900,3718320,16_16_16_16_16_16_16_16_16_16_16_16_16_16_16_16_16_16_16_16_16_16_16_16_16_16_1_1_1_1_2_2_3_3_3_3_18_18_18_18_18_3_3_3_3_18_18_18_18_18_18_18_18_18_18_18_18_18_18_18
4349,213,1329367800,0,9,0,1329368940,1140,331380,3206820,2875440,0_0_0_0_0_1_0_1_0_0_0_0_0_0_0_0_1_1_0_0_0_0_0_0_0_1_1_0_0_0_0_0_0_0_0
4350,143,1329367800,5,6,5,1329369540,1740,1896720,1898460,1740,10_10_10_1_10_1_10_1_1_10_10_10_10_10_1_1_10_1_10_1_10_10_10_10_1_1_1_1_1_1_9_9_3_3_4_4_4_4_4_4_2_2_6_6_5
4351,131,1329367860,18,19,18,1329370140,2280,3107760,6825900,3718140,16_16_16_16_16_16_16_16_16_16_16_16_16_16_16_16_16_16_16_16_16_16_16_16_16_16_1_1_1_1_2_2_3_3_3_3_18_18_18_18_18_3_3_3_3_18_18_18_18_18_18_18_18_18_18_18_18_18_18_18_18
4352,119,1329368040,14,17,14,1329416400,48360,2418420,2742780,324360,7_7_7_1_1_7_7_7_7_7_7_7_7_7_1_1_2_2_3_3_14_3_3_14_14_14_14_14
4353,135,1329368220,4,5,9,1329372720,4500,3293820,5649480,2355660,19_19_19_19_19_19_19_19_19_19_19_19_1_19_1_19_19_19_1_1_1_1_19_19_19_19_19_19_1_1_1_1_19_19_19_19_19_19_19_19_19_19_19_19_1_19_1_19_19_19_19_19_19_1_19_1_1_1_2_2_1_1_2_2_9_3_3_9_3_3_2_9_9_9_2_4_4_3_4_3_3_9_3_4_4_4_4
4354,215,1329368280,14,15,14,1329372540,4260,1441200,1851720,410520,24_24_24_24_24_24_8_8_3_3_3_3_14
4355,0,1329368340,5,6,5,1329371940,3600,1496100,1560960,64860,0_0_0_0_0_0_0_0_1_1_2_2_3_3_3_3_3_3_4_3_3_4_4_4_5
4356,107,1329368400,1,18,16,1329369240,840,1441800,4991760,3549960,8_8_8_8_28_28_28_28_28_28_8_8_8_8_16_16_16_16_16_1_16_16_16_1_16_16_16_16_1_16_1_16_16_16_16_16_16_16_1
4357,219,1329368400,8,2,8,1329369300,900,85140,3797940,3712800,26_26_26_26_26_26_26_26_26_26_8
4358,213,1329368940,0,1,0,1329374160,5220,332520,3206820,2874300,0_0_0_0_0_1_0_1_0_0_0_0_0_0_0_0_1_1_0_0_0_0_0_0_0_1_1_0_0_0_0_0_0_0_0_0
4359,71,1329369000,7,8,7,1329375900,6900,3107400,3996240,888840,29_29_1_1_7_7_1_7_1_7_7_7_7_7_1_7_1_7_7_7_7_7_7_1_1_7_7_7_7_7_7_7_7_1_1_7_7_7_7_1_1_1_1_7_7_1_7_1_7_7_7_7_7_7_7_1_7_7_7_1_7_7_7_7_7_7_7_1_7_1_7_7_7_7_7
4360,107,1329369240,16,14,1,1329374400,5160,1442640,4991760,3549120,8_8_8_8_28_28_28_28_28_28_8_8_8_8_16_16_16_16_16_1_16_16_16_1_16_16_16_16_1_16_1_16_16_16_16_16_16_16_1_16
4361,219,1329369300,38,46,38,1329376500,7200,86040,3797940,3711900,26_26_26_26_26_26_26_26_26_26_8_8_38
4362,141,1329369300,5,2,5,1329374400,5100,3716100,7406100,3690000,1_1_16_16_16_16_16_1_16_16_1_1_1_16_16_16_16_16_16_16_16_16_16_16_16_16_16_16_1_1_1_1_1_1_1_1_1_1_1_1_16_2_2_16_3_3_3_3_3_3_18_18_18_18_18_3_18_3_3_3_5_5_5_5_5_5_3_3_4_4_4_4_4_3_1_3_1_4_18_3_3_18_18_1_1_18_18_5_5_18_5_5_5_5_6_6_5_5_6_6_6_6_5
4363,219,1329369300,8,2,38,1329369300,0,86040,3797940,3711900,26_26_26_26_26_26_26_26_26_26_8_8
4364,133,1329369360,17,12,17,1329385140,15780,2578560,6181200,3602640,17_17_17_17_17_17_17_17_17_17_17_17_17_17_17_17_17_17_17_17_17_17_17_17_17_17_17_17_17_17_1_1_17_17_17_17_1_1_1_1_17_17_17_17_17_17_17_17_17_17_17_17_17_17_17_17_17_17_17_17_17_17_19_19_17
4365,143,1329369540,5,6,99,1329369540,0,1898460,1898460,0,10_10_10_1_10_1_10_1_1_10_10_10_10_10_1_1_10_1_10_1_10_10_10_10_1_1_1_1_1_1_9_9_3_3_4_4_4_4_4_4_2_2_6_6_5_5
4366,84,1329370140,5,6,5,1329373740,3600,3711240,3714840,3600,17_17_17_17_17_17_17_17_17_17_17_17_17_17_17_17_1_1_2_2_3_3_18_18_18_18_18_18_5_5_34_34_34_34_34_34_34_34_6_6_5
4367,131,1329370140,18,19,18,1329370200,60,3110040,6825900,3715860,16_16_16_16_16_16_16_16_16_16_16_16_16_16_16_16_16_16_16_16_16_16_16_16_16_16_1_1_1_1_2_2_3_3_3_3_18_18_18_18_18_3_3_3_3_18_18_18_18_18_18_18_18_18_18_18_18_18_18_18_18_18
4368,131,1329370200,18,19,18,1329371880,1680,3110100,6825900,3715800,16_16_16_16_16_16_16_16_16_16_16_16_16_16_16_16_16_16_16_16_16_16_16_16_16_16_1_1_1_1_2_2_3_3_3_3_18_18_18_18_18_3_3_3_3_18_18_18_18_18_18_18_18_18_18_18_18_18_18_18_18_18_18
4369,151,1329370560,1,9,1,1329374220,3660,1248360,3643800,2395440,19_19_19_19_19_1_1_19_1_1_19_19_19_19_1_19_1_19_19_19_19_19_19_19_19_19_1_19_19_1_1_1_1_1_19_19_19_19_19_19_1
4370,131,1329371880,18,19,5,1329385440,13560,3111780,6825900,3714120,16_16_16_16_16_16_16_16_16_16_16_16_16_16_16_16_16_16_16_16_16_16_16_16_16_16_1_1_1_1_2_2_3_3_3_3_18_18_18_18_18_3_3_3_3_18_18_18_18_18_18_18_18_18_18_18_18_18_18_18_18_18_18_18
4371,63,1329371940,18,19,3,1329392280,20340,2520480,6232860,3712380,16_16_16_16_16_16_16_16_16_0_0_16_16_0_16_16_0_16_16_0_0_16_16_16_0_0_16_0_0_16_0_16_0_0_0_16_1_1_1_16_16_16_0_1_1_1_16_0_0_16_16_0_16_0_16_0_0_2_2_1_1_0_0_0_0_2_2_2_2_2_2_0_1_0_1_1_0_0_0_1_1_0_0_1_1_1_0_0_0_0_0_2_2_2_2_0_0_0_0_0_0_1_1_1_1_0_0_16_0_16_16_16_16_16_0_0_1_1_2_2_1_1_16_0_2_16_2_2_2_0_1_1_1_1_1_16_16_1_1_1_3_3_18
4372,0,1329371940,5,6,5,1329387060,15120,1499700,1560960,61260,0_0_0_0_0_0_0_0_1_1_2_2_3_3_3_3_3_3_4_3_3_4_4_4_5_5
4373,215,1329372540,14,15,14,1329372540,0,1445460,1851720,406260,24_24_24_24_24_24_8_8_3_3_3_3_14_14
4374,215,1329372540,14,15,14,1329383460,10920,1445460,1851720,406260,24_24_24_24_24_24_8_8_3_3_3_3_14_14_14
4375,135,1329372720,9,3,3,1329376500,3780,3298320,5649480,2351160,19_19_19_19_19_19_19_19_19_19_19_19_1_19_1_19_19_19_1_1_1_1_19_19_19_19_19_19_1_1_1_1_19_19_19_19_19_19_19_19_19_19_19_19_1_19_1_19_19_19_19_19_19_1_19_1_1_1_2_2_1_1_2_2_9_3_3_9_3_3_2_9_9_9_2_4_4_3_4_3_3_9_3_4_4_4_4_9
4376,153,1329373320,5,6,5,1329383700,10380,1558680,1618560,59880,16_1_16_1_0_0_1_1_2_2_3_3_4_4_4_4_4_4_4_4_4_4_4_4_5
4377,84,1329373740,5,6,99,1329373740,0,3714840,3714840,0,17_17_17_17_17_17_17_17_17_17_17_17_17_17_17_17_1_1_2_2_3_3_18_18_18_18_18_18_5_5_34_34_34_34_34_34_34_34_6_6_5_5
4378,213,1329374160,0,9,0,1329401160,27000,337740,3206820,2869080,0_0_0_0_0_1_0_1_0_0_0_0_0_0_0_0_1_1_0_0_0_0_0_0_0_1_1_0_0_0_0_0_0_0_0_0_0
4379,151,1329374220,1,9,19,1329416220,42000,1252020,3643800,2391780,19_19_19_19_19_1_1_19_1_1_19_19_19_19_1_19_1_19_19_19_19_19_19_19_19_19_1_19_19_1_1_1_1_1_19_19_19_19_19_19_1_1
4380,107,1329374400,1,18,16,1329400080,25680,1447800,4991760,3543960,8_8_8_8_28_28_28_28_28_28_8_8_8_8_16_16_16_16_16_1_16_16_16_1_16_16_16_16_1_16_1_16_16_16_16_16_16_16_1_16_1
4381,141,1329374400,5,2,5,1329375600,1200,3721200,7406100,3684900,1_1_16_16_16_16_16_1_16_16_1_1_1_16_16_16_16_16_16_16_16_16_16_16_16_16_16_16_1_1_1_1_1_1_1_1_1_1_1_1_16_2_2_16_3_3_3_3_3_3_18_18_18_18_18_3_18_3_3_3_5_5_5_5_5_5_3_3_4_4_4_4_4_3_1_3_1_4_18_3_3_18_18_1_1_18_18_5_5_18_5_5_5_5_6_6_5_5_6_6_6_6_5_5
4382,141,1329375600,5,2,5,1329385440,9840,3722400,7406100,3683700,1_1_16_16_16_16_16_1_16_16_1_1_1_16_16_16_16_16_16_16_16_16_16_16_16_16_16_16_1_1_1_1_1_1_1_1_1_1_1_1_16_2_2_16_3_3_3_3_3_3_18_18_18_18_18_3_18_3_3_3_5_5_5_5_5_5_3_3_4_4_4_4_4_3_1_3_1_4_18_3_3_18_18_1_1_18_18_5_5_18_5_5_5_5_6_6_5_5_6_6_6_6_5_5_5
4383,163,1329375600,1,18,1,1329380940,5340,264060,548880,284820,17_17_17_1_1_17_17_1_17_1_17_17_17_17_17_17_17_1_1_17_1
4384,111,1329375720,5,9,5,1329393840,18120,3916920,3974400,57480,0_0_0_0_0_0_0_0_0_0_0_1_0_1_0_0_0_0_1_0_1_0_0_0_0_0_0_1_1_0_1_1_2_2_4_4_4_4_4_1_4_4_1_4_4_4_4_4_4_4_4_4_18_18_18_18_18_18_18_18_18_18_18_18_5
4385,71,1329375900,7,8,7,1329375960,60,3114300,3996240,881940,29_29_1_1_7_7_1_7_1_7_7_7_7_7_1_7_1_7_7_7_7_7_7_1_1_7_7_7_7_7_7_7_7_1_1_7_7_7_7_1_1_1_1_7_7_1_7_1_7_7_7_7_7_7_7_1_7_7_7_1_7_7_7_7_7_7_7_1_7_1_7_7_7_7_7_7
4386,71,1329375960,7,8,1,1329381000,5040,3114360,3996240,881880,29_29_1_1_7_7_1_7_1_7_7_7_7_7_1_7_1_7_7_7_7_7_7_1_1_7_7_7_7_7_7_7_7_1_1_7_7_7_7_1_1_1_1_7_7_1_7_1_7_7_7_7_7_7_7_1_7_7_7_1_7_7_7_7_7_7_7_1_7_1_7_7_7_7_7_7_7
4387,168,1329376260,10,16,1,1329391200,14940,35460,438000,402540,10_10_10
4388,135,1329376500,3,4,9,1329381600,5100,3302100,5649480,2347380,19_19_19_19_19_19_19_19_19_19_19_19_1_19_1_19_19_19_1_1_1_1_19_19_19_19_19_19_1_1_1_1_19_19_19_19_19_19_19_19_19_19_19_19_1_19_1_19_19_19_19_19_19_1_19_1_1_1_2_2_1_1_2_2_9_3_3_9_3_3_2_9_9_9_2_4_4_3_4_3_3_9_3_4_4_4_4_9_3
4389,219,1329376500,38,46,17,1331627220,2250720,93240,3797940,3704700,26_26_26_26_26_26_26_26_26_26_8_8_38_38
4390,156,1329380760,47,6,47,1329380820,60,1982040,2639280,657240,16_16_16_16_16_16_16_16_16_16_16_1_1_1_16_1_16_16_16_16_16_16_1_1_1_1_16_16_16_16_16_16_16_16_16_16_16_16_16_16_16_16_16_16_16_16_16_16_16_16_16_16_1_1_16_16_16_16_16_16_16_16_1_1_47
4391,156,1329380820,47,6,2,1329381660,840,1982100,2639280,657180,16_16_16_16_16_16_16_16_16_16_16_1_1_1_16_1_16_16_16_16_16_16_1_1_1_1_16_16_16_16_16_16_16_16_16_16_16_16_16_16_16_16_16_16_16_16_16_16_16_16_16_16_1_1_16_16_16_16_16_16_16_16_1_1_47_47
4392,163,1329380940,1,18,2,1329383040,2100,269400,548880,279480,17_17_17_1_1_17_17_1_17_1_17_17_17_17_17_17_17_1_1_17_1_1
4393,71,1329381000,1,18,7,1329381060,60,3119400,3996240,876840,29_29_1_1_7_7_1_7_1_7_7_7_7_7_1_7_1_7_7_7_7_7_7_1_1_7_7_7_7_7_7_7_7_1_1_7_7_7_7_1_1_1_1_7_7_1_7_1_7_7_7_7_7_7_7_1_7_7_7_1_7_7_7_7_7_7_7_1_7_1_7_7_7_7_7_7_7_1
4394,71,1329381060,7,18,7,1329385560,4500,3119460,3996240,876780,29_29_1_1_7_7_1_7_1_7_7_7_7_7_1_7_1_7_7_7_7_7_7_1_1_7_7_7_7_7_7_7_7_1_1_7_7_7_7_1_1_1_1_7_7_1_7_1_7_7_7_7_7_7_7_1_7_7_7_1_7_7_7_7_7_7_7_1_7_1_7_7_7_7_7_7_7_1_7
4395,135,1329381600,9,3,3,1329387240,5640,3307200,5649480,2342280,19_19_19_19_19_19_19_19_19_19_19_19_1_19_1_19_19_19_1_1_1_1_19_19_19_19_19_19_1_1_1_1_19_19_19_19_19_19_19_19_19_19_19_19_1_19_1_19_19_19_19_19_19_1_19_1_1_1_2_2_1_1_2_2_9_3_3_9_3_3_2_9_9_9_2_4_4_3_4_3_3_9_3_4_4_4_4_9_3_9
4396,156,1329381660,2,3,2,1329396660,15000,1982940,2639280,656340,16_16_16_16_16_16_16_16_16_16_16_1_1_1_16_1_16_16_16_16_16_16_1_1_1_1_16_16_16_16_16_16_16_16_16_16_16_16_16_16_16_16_16_16_16_16_16_16_16_16_16_16_1_1_16_16_16_16_16_16_16_16_1_1_47_47_2
4397,163,1329383040,2,3,2,1329384360,1320,271500,548880,277380,17_17_17_1_1_17_17_1_17_1_17_17_17_17_17_17_17_1_1_17_1_1_2
4398,215,1329383460,14,15,2,1329384540,1080,1456380,1851720,395340,24_24_24_24_24_24_8_8_3_3_3_3_14_14_14_14
4399,61,1329383460,34,15,34,1329401400,17940,3928260,6225300,2297040,4_4_18_18_34_34_34_3_3_34_3_3_34_35_34_35_35_35_36_36_35_35_35_35_34_34_34_34_34_34_34_34_34_34_34_34_34_34_34
4400,153,1329383700,5,6,5,1329384120,420,1569060,1618560,49500,16_1_16_1_0_0_1_1_2_2_3_3_4_4_4_4_4_4_4_4_4_4_4_4_5_5
4401,153,1329384120,5,6,5,1329387300,3180,1569480,1618560,49080,16_1_16_1_0_0_1_1_2_2_3_3_4_4_4_4_4_4_4_4_4_4_4_4_5_5_5
4402,163,1329384360,2,3,15,1329656400,272040,272820,548880,276060,17_17_17_1_1_17_17_1_17_1_17_17_17_17_17_17_17_1_1_17_1_1_2_2
4403,215,1329384540,2,3,2,1329384600,60,1457460,1851720,394260,24_24_24_24_24_24_8_8_3_3_3_3_14_14_14_14_2
4404,215,1329384600,2,3,5,1329650400,265800,1457520,1851720,394200,24_24_24_24_24_24_8_8_3_3_3_3_14_14_14_14_2_2
4405,133,1329385140,17,12,2,1329400020,14880,2594340,6181200,3586860,17_17_17_17_17_17_17_17_17_17_17_17_17_17_17_17_17_17_17_17_17_17_17_17_17_17_17_17_17_17_1_1_17_17_17_17_1_1_1_1_17_17_17_17_17_17_17_17_17_17_17_17_17_17_17_17_17_17_17_17_17_17_19_19_17_17
4406,152,1329385200,17,12,17,1329400560,15360,137760,3766500,3628740,17_17_17
4407,131,1329385440,5,2,5,1329389400,3960,3125340,6825900,3700560,16_16_16_16_16_16_16_16_16_16_16_16_16_16_16_16_16_16_16_16_16_16_16_16_16_16_1_1_1_1_2_2_3_3_3_3_18_18_18_18_18_3_3_3_3_18_18_18_18_18_18_18_18_18_18_18_18_18_18_18_18_18_18_18_5
4408,141,1329385440,5,2,5,1329385500,60,3732240,7406100,3673860,1_1_16_16_16_16_16_1_16_16_1_1_1_16_16_16_16_16_16_16_16_16_16_16_16_16_16_16_1_1_1_1_1_1_1_1_1_1_1_1_16_2_2_16_3_3_3_3_3_3_18_18_18_18_18_3_18_3_3_3_5_5_5_5_5_5_3_3_4_4_4_4_4_3_1_3_1_4_18_3_3_18_18_1_1_18_18_5_5_18_5_5_5_5_6_6_5_5_6_6_6_6_5_5_5_5
4409,141,1329385500,5,2,5,1329389940,4440,3732300,7406100,3673800,1_1_16_16_16_16_16_1_16_16_1_1_1_16_16_16_16_16_16_16_16_16_16_16_16_16_16_16_1_1_1_1_1_1_1_1_1_1_1_1_16_2_2_16_3_3_3_3_3_3_18_18_18_18_18_3_18_3_3_3_5_5_5_5_5_5_3_3_4_4_4_4_4_3_1_3_1_4_18_3_3_18_18_1_1_18_18_5_5_18_5_5_5_5_6_6_5_5_6_6_6_6_5_5_5_5_5
4410,71,1329385560,7,18,32,1329386400,840,3123960,3996240,872280,29_29_1_1_7_7_1_7_1_7_7_7_7_7_1_7_1_7_7_7_7_7_7_1_1_7_7_7_7_7_7_7_7_1_1_7_7_7_7_1_1_1_1_7_7_1_7_1_7_7_7_7_7_7_7_1_7_7_7_1_7_7_7_7_7_7_7_1_7_1_7_7_7_7_7_7_7_1_7_7_7
4411,71,1329385560,7,8,7,1329385560,0,3123960,3996240,872280,29_29_1_1_7_7_1_7_1_7_7_7_7_7_1_7_1_7_7_7_7_7_7_1_1_7_7_7_7_7_7_7_7_1_1_7_7_7_7_1_1_1_1_7_7_1_7_1_7_7_7_7_7_7_7_1_7_7_7_1_7_7_7_7_7_7_7_1_7_1_7_7_7_7_7_7_7_1_7_7
4412,186,1329385620,7,8,7,1329398820,13200,0,3636240,3636240,7
4413,201,1329385860,2,3,2,1329385920,60,1218900,1645440,426540,10_10_10_10_10_10_10_10_10_10_10_10_1_1_2
4414,201,1329385920,2,3,3,1329394500,8580,1218960,1645440,426480,10_10_10_10_10_10_10_10_10_10_10_10_1_1_2_2
4415,188,1329386040,2,3,2,1329387900,1860,714000,4327560,3613560,0_0_0_0_0_1_1_0_0_0_0_0_0_0_0_0_1_1_2_2_2
4416,71,1329386400,32,34,1,1329389400,3000,3124800,3996240,871440,29_29_1_1_7_7_1_7_1_7_7_7_7_7_1_7_1_7_7_7_7_7_7_1_1_7_7_7_7_7_7_7_7_1_1_7_7_7_7_1_1_1_1_7_7_1_7_1_7_7_7_7_7_7_7_1_7_7_7_1_7_7_7_7_7_7_7_1_7_1_7_7_7_7_7_7_7_1_7_7_7_32
4417,0,1329387060,5,6,5,1329388980,1920,1514820,1560960,46140,0_0_0_0_0_0_0_0_1_1_2_2_3_3_3_3_3_3_4_3_3_4_4_4_5_5_5
4418,135,1329387240,3,4,4,1329408060,20820,3312840,5649480,2336640,19_19_19_19_19_19_19_19_19_19_19_19_1_19_1_19_19_19_1_1_1_1_19_19_19_19_19_19_1_1_1_1_19_19_19_19_19_19_19_19_19_19_19_19_1_19_1_19_19_19_19_19_19_1_19_1_1_1_2_2_1_1_2_2_9_3_3_9_3_3_2_9_9_9_2_4_4_3_4_3_3_9_3_4_4_4_4_9_3_9_3
4419,153,1329387300,5,6,6,1329429600,42300,1572660,1618560,45900,16_1_16_1_0_0_1_1_2_2_3_3_4_4_4_4_4_4_4_4_4_4_4_4_5_5_5_5
4420,188,1329387900,2,3,3,1331071200,1683300,715860,4327560,3611700,0_0_0_0_0_1_1_0_0_0_0_0_0_0_0_0_1_1_2_2_2_2
4421,0,1329388980,5,6,5,1329393480,4500,1516740,1560960,44220,0_0_0_0_0_0_0_0_1_1_2_2_3_3_3_3_3_3_4_3_3_4_4_4_5_5_5_5
4422,71,1329389400,1,18,32,1329407640,18240,3127800,3996240,868440,29_29_1_1_7_7_1_7_1_7_7_7_7_7_1_7_1_7_7_7_7_7_7_1_1_7_7_7_7_7_7_7_7_1_1_7_7_7_7_1_1_1_1_7_7_1_7_1_7_7_7_7_7_7_7_1_7_7_7_1_7_7_7_7_7_7_7_1_7_1_7_7_7_7_7_7_7_1_7_7_7_32_1
4423,131,1329389400,5,2,5,1329391200,1800,3129300,6825900,3696600,16_16_16_16_16_16_16_16_16_16_16_16_16_16_16_16_16_16_16_16_16_16_16_16_16_16_1_1_1_1_2_2_3_3_3_3_18_18_18_18_18_3_3_3_3_18_18_18_18_18_18_18_18_18_18_18_18_18_18_18_18_18_18_18_5_5
4424,141,1329389940,5,2,5,1329650400,260460,3736740,7406100,3669360,1_1_16_16_16_16_16_1_16_16_1_1_1_16_16_16_16_16_16_16_16_16_16_16_16_16_16_16_1_1_1_1_1_1_1_1_1_1_1_1_16_2_2_16_3_3_3_3_3_3_18_18_18_18_18_3_18_3_3_3_5_5_5_5_5_5_3_3_4_4_4_4_4_3_1_3_1_4_18_3_3_18_18_1_1_18_18_5_5_18_5_5_5_5_6_6_5_5_6_6_6_6_5_5_5_5_5_5
4425,131,1329391200,5,2,5,1329401580,10380,3131100,6825900,3694800,16_16_16_16_16_16_16_16_16_16_16_16_16_16_16_16_16_16_16_16_16_16_16_16_16_16_1_1_1_1_2_2_3_3_3_3_18_18_18_18_18_3_3_3_3_18_18_18_18_18_18_18_18_18_18_18_18_18_18_18_18_18_18_18_5_5_5
4426,96,1329391200,5,18,5,1329392400,1200,2081400,2123400,42000,10_1_10_10_10_10_1_10_10_10_10_10_1_1_2_2_9_9_9_9_9_9_3_3_5_5_9_9_9_9_9_9_5_5_6_6_9_9_3_3_5_5_5
4427,168,1329391200,1,9,10,1329392760,1560,50400,438000,387600,10_10_10_1
4428,116,1329391800,5,18,5,1329399000,7200,714600,786600,72000,19_19_19_19_19_19_19_19_19_19_1_1_1_1_3_3_19_2_2_19_3_3_19_14_14_14_19_19_13_13_19_14_1_13_14_1_2_2_3_5_3_5_14_13_14_13_6_6_14_13_5_5_5
4429,63,1329392280,3,3,18,1329392340,60,2540820,6232860,3692040,16_16_16_16_16_16_16_16_16_0_0_16_16_0_16_16_0_16_16_0_0_16_16_16_0_0_16_0_0_16_0_16_0_0_0_16_1_1_1_16_16_16_0_1_1_1_16_0_0_16_16_0_16_0_16_0_0_2_2_1_1_0_0_0_0_2_2_2_2_2_2_0_1_0_1_1_0_0_0_1_1_0_0_1_1_1_0_0_0_0_0_2_2_2_2_0_0_0_0_0_0_1_1_1_1_0_0_16_0_16_16_16_16_16_0_0_1_1_2_2_1_1_16_0_2_16_2_2_2_0_1_1_1_1_1_16_16_1_1_1_3_3_18_3
4430,63,1329392340,3,3,3,1329632460,240120,2540880,6232860,3691980,16_16_16_16_16_16_16_16_16_0_0_16_16_0_16_16_0_16_16_0_0_16_16_16_0_0_16_0_0_16_0_16_0_0_0_16_1_1_1_16_16_16_0_1_1_1_16_0_0_16_16_0_16_0_16_0_0_2_2_1_1_0_0_0_0_2_2_2_2_2_2_0_1_0_1_1_0_0_0_1_1_0_0_1_1_1_0_0_0_0_0_2_2_2_2_0_0_0_0_0_0_1_1_1_1_0_0_16_0_16_16_16_16_16_0_0_1_1_2_2_1_1_16_0_2_16_2_2_2_0_1_1_1_1_1_16_16_1_1_1_3_3_18_3_18_3
4431,199,1329392340,18,19,18,1329398880,6540,715380,975720,260340,0_0_0_0_0_0_0_0_0_0_0_0_0_1_1_0_0_0_0_0_1_1_2_2_18
4432,63,1329392340,18,19,3,1329392340,0,2540880,6232860,3691980,16_16_16_16_16_16_16_16_16_0_0_16_16_0_16_16_0_16_16_0_0_16_16_16_0_0_16_0_0_16_0_16_0_0_0_16_1_1_1_16_16_16_0_1_1_1_16_0_0_16_16_0_16_0_16_0_0_2_2_1_1_0_0_0_0_2_2_2_2_2_2_0_1_0_1_1_0_0_0_1_1_0_0_1_1_1_0_0_0_0_0_2_2_2_2_0_0_0_0_0_0_1_1_1_1_0_0_16_0_16_16_16_16_16_0_0_1_1_2_2_1_1_16_0_2_16_2_2_2_0_1_1_1_1_1_16_16_1_1_1_3_3_18_3_18
4433,96,1329392400,5,18,6,1329429600,37200,2082600,2123400,40800,10_1_10_10_10_10_1_10_10_10_10_10_1_1_2_2_9_9_9_9_9_9_3_3_5_5_9_9_9_9_9_9_5_5_6_6_9_9_3_3_5_5_5_5
4434,168,1329392760,10,16,1,1329393300,540,51960,438000,386040,10_10_10_1_10
4435,168,1329393300,1,9,10,1329394860,1560,52500,438000,385500,10_10_10_1_10_1
4436,0,1329393480,5,6,5,1329401520,8040,1521240,1560960,39720,0_0_0_0_0_0_0_0_1_1_2_2_3_3_3_3_3_3_4_3_3_4_4_4_5_5_5_5_5
4437,111,1329393840,5,9,5,1329394320,480,3935040,3974400,39360,0_0_0_0_0_0_0_0_0_0_0_1_0_1_0_0_0_0_1_0_1_0_0_0_0_0_0_1_1_0_1_1_2_2_4_4_4_4_4_1_4_4_1_4_4_4_4_4_4_4_4_4_18_18_18_18_18_18_18_18_18_18_18_18_5_5
4438,111,1329394320,5,9,5,1329399120,4800,3935520,3974400,38880,0_0_0_0_0_0_0_0_0_0_0_1_0_1_0_0_0_0_1_0_1_0_0_0_0_0_0_1_1_0_1_1_2_2_4_4_4_4_4_1_4_4_1_4_4_4_4_4_4_4_4_4_18_18_18_18_18_18_18_18_18_18_18_18_5_5_5
4439,201,1329394500,3,4,3,1329396780,2280,1227540,1645440,417900,10_10_10_10_10_10_10_10_10_10_10_10_1_1_2_2_3
4440,168,1329394860,10,16,10,1329400620,5760,54060,438000,383940,10_10_10_1_10_1_10
4441,156,1329396660,2,3,2,1329396720,60,1997940,2639280,641340,16_16_16_16_16_16_16_16_16_16_16_1_1_1_16_1_16_16_16_16_16_16_1_1_1_1_16_16_16_16_16_16_16_16_16_16_16_16_16_16_16_16_16_16_16_16_16_16_16_16_16_16_1_1_16_16_16_16_16_16_16_16_1_1_47_47_2_2
4442,156,1329396720,2,3,3,1329396780,60,1998000,2639280,641280,16_16_16_16_16_16_16_16_16_16_16_1_1_1_16_1_16_16_16_16_16_16_1_1_1_1_16_16_16_16_16_16_16_16_16_16_16_16_16_16_16_16_16_16_16_16_16_16_16_16_16_16_1_1_16_16_16_16_16_16_16_16_1_1_47_47_2_2_2
4443,156,1329396780,3,3,2,1329401220,4440,1998060,2639280,641220,16_16_16_16_16_16_16_16_16_16_16_1_1_1_16_1_16_16_16_16_16_16_1_1_1_1_16_16_16_16_16_16_16_16_16_16_16_16_16_16_16_16_16_16_16_16_16_16_16_16_16_16_1_1_16_16_16_16_16_16_16_16_1_1_47_47_2_2_2_3
4444,201,1329396780,3,4,13,1329454800,58020,1229820,1645440,415620,10_10_10_10_10_10_10_10_10_10_10_10_1_1_2_2_3_3
4445,186,1329398820,7,8,7,1329401100,2280,13200,3636240,3623040,7_7
4446,199,1329398880,18,19,18,1329400920,2040,721920,975720,253800,0_0_0_0_0_0_0_0_0_0_0_0_0_1_1_0_0_0_0_0_1_1_2_2_18_18_18
4447,199,1329398880,18,19,18,1329398880,0,721920,975720,253800,0_0_0_0_0_0_0_0_0_0_0_0_0_1_1_0_0_0_0_0_1_1_2_2_18_18
4448,116,1329399000,5,18,6,1329429600,30600,721800,786600,64800,19_19_19_19_19_19_19_19_19_19_1_1_1_1_3_3_19_2_2_19_3_3_19_14_14_14_19_19_13_13_19_14_1_13_14_1_2_2_3_5_3_5_14_13_14_13_6_6_14_13_5_5_5_5
4449,23,1329399120,5,9,5,1329399180,60,1860840,1894920,34080,24_24_24_24_8_8_24_24_24_24_24_24_24_24_24_24_24_24_24_24_8_8_7_7_3_3_9_9_9_9_2_2_9_9_9_9_5_2_9_9_9_9_5_2_5_5_5_5_5
4450,111,1329399120,5,9,6,1329429600,30480,3940320,3974400,34080,0_0_0_0_0_0_0_0_0_0_0_1_0_1_0_0_0_0_1_0_1_0_0_0_0_0_0_1_1_0_1_1_2_2_4_4_4_4_4_1_4_4_1_4_4_4_4_4_4_4_4_4_18_18_18_18_18_18_18_18_18_18_18_18_5_5_5_5
4451,86,1329399120,5,9,5,1329401100,1980,3053100,3519180,466080,0_0_0_0_1_0_0_0_0_1_0_0_0_0_1_1_0_0_1_1_1_1_1_1_2_2_4_4_4_4_4_4_4_4_4_4_18_18_18_18_1_18_1_18_18_18_5
4452,23,1329399180,5,9,6,1329429600,30420,1860900,1894920,34020,24_24_24_24_8_8_24_24_24_24_24_24_24_24_24_24_24_24_24_24_8_8_7_7_3_3_9_9_9_9_2_2_9_9_9_9_5_2_9_9_9_9_5_2_5_5_5_5_5_5
4453,133,1329400020,2,4,2,1329405780,5760,2609220,6181200,3571980,17_17_17_17_17_17_17_17_17_17_17_17_17_17_17_17_17_17_17_17_17_17_17_17_17_17_17_17_17_17_1_1_17_17_17_17_1_1_1_1_17_17_17_17_17_17_17_17_17_17_17_17_17_17_17_17_17_17_17_17_17_17_19_19_17_17_2
4454,107,1329400080,16,14,16,1329402480,2400,1473480,4991760,3518280,8_8_8_8_28_28_28_28_28_28_8_8_8_8_16_16_16_16_16_1_16_16_16_1_16_16_16_16_1_16_1_16_16_16_16_16_16_16_1_16_1_16
4455,152,1329400560,17,12,17,1329467520,66960,153120,3766500,3613380,17_17_17_17
4456,168,1329400620,10,16,10,1329402420,1800,59820,438000,378180,10_10_10_1_10_1_10_10
4457,199,1329400920,18,19,18,1329400980,60,723960,975720,251760,0_0_0_0_0_0_0_0_0_0_0_0_0_1_1_0_0_0_0_0_1_1_2_2_18_18_18_18
4458,199,1329400980,18,23,18,1329415980,15000,724020,975720,251700,0_0_0_0_0_0_0_0_0_0_0_0_0_1_1_0_0_0_0_0_1_1_2_2_18_18_18_18_18
4459,186,1329401100,7,8,7,1329402420,1320,15480,3636240,3620760,7_7_7
4460,86,1329401100,5,9,5,1329462900,61800,3055080,3519180,464100,0_0_0_0_1_0_0_0_0_1_0_0_0_0_1_1_0_0_1_1_1_1_1_1_2_2_4_4_4_4_4_4_4_4_4_4_18_18_18_18_1_18_1_18_18_18_5_5
4461,213,1329401160,0,1,0,1329415320,14160,364740,3206820,2842080,0_0_0_0_0_1_0_1_0_0_0_0_0_0_0_0_1_1_0_0_0_0_0_0_0_1_1_0_0_0_0_0_0_0_0_0_0_0
4462,156,1329401220,2,3,3,1329407040,5820,2002500,2639280,636780,16_16_16_16_16_16_16_16_16_16_16_1_1_1_16_1_16_16_16_16_16_16_1_1_1_1_16_16_16_16_16_16_16_16_16_16_16_16_16_16_16_16_16_16_16_16_16_16_16_16_16_16_1_1_16_16_16_16_16_16_16_16_1_1_47_47_2_2_2_3_2
4463,61,1329401400,34,15,34,1331126400,1725000,3946200,6225300,2279100,4_4_18_18_34_34_34_3_3_34_3_3_34_35_34_35_35_35_36_36_35_35_35_35_34_34_34_34_34_34_34_34_34_34_34_34_34_34_34_34
4464,0,1329401520,5,6,6,1329429600,28080,1529280,1560960,31680,0_0_0_0_0_0_0_0_1_1_2_2_3_3_3_3_3_3_4_3_3_4_4_4_5_5_5_5_5_5
4465,131,1329401580,5,2,5,1329627600,226020,3141480,6825900,3684420,16_16_16_16_16_16_16_16_16_16_16_16_16_16_16_16_16_16_16_16_16_16_16_16_16_16_1_1_1_1_2_2_3_3_3_3_18_18_18_18_18_3_3_3_3_18_18_18_18_18_18_18_18_18_18_18_18_18_18_18_18_18_18_18_5_5_5_5
4466,168,1329402420,10,13,10,1329418980,16560,61620,438000,376380,10_10_10_1_10_1_10_10_10
4467,186,1329402420,7,8,7,1329402480,60,16800,3636240,3619440,7_7_7_7
4468,186,1329402480,7,8,7,1329406200,3720,16860,3636240,3619380,7_7_7_7_7
4469,107,1329402480,16,20,16,1329428760,26280,1475880,4991760,3515880,8_8_8_8_28_28_28_28_28_28_8_8_8_8_16_16_16_16_16_1_16_16_16_1_16_16_16_16_1_16_1_16_16_16_16_16_16_16_1_16_1_16_16
4470,133,1329405780,2,4,3,1329429600,23820,2614980,6181200,3566220,17_17_17_17_17_17_17_17_17_17_17_17_17_17_17_17_17_17_17_17_17_17_17_17_17_17_17_17_17_17_1_1_17_17_17_17_1_1_1_1_17_17_17_17_17_17_17_17_17_17_17_17_17_17_17_17_17_17_17_17_17_17_19_19_17_17_2_2
4471,186,1329406200,7,8,7,1329419700,13500,20580,3636240,3615660,7_7_7_7_7_7
4472,156,1329407040,3,3,18,1329454500,47460,2008320,2639280,630960,16_16_16_16_16_16_16_16_16_16_16_1_1_1_16_1_16_16_16_16_16_16_1_1_1_1_16_16_16_16_16_16_16_16_16_16_16_16_16_16_16_16_16_16_16_16_16_16_16_16_16_16_1_1_16_16_16_16_16_16_16_16_1_1_47_47_2_2_2_3_2_3
4473,71,1329407640,32,34,32,1329453360,45720,3146040,3996240,850200,29_29_1_1_7_7_1_7_1_7_7_7_7_7_1_7_1_7_7_7_7_7_7_1_1_7_7_7_7_7_7_7_7_1_1_7_7_7_7_1_1_1_1_7_7_1_7_1_7_7_7_7_7_7_7_1_7_7_7_1_7_7_7_7_7_7_7_1_7_1_7_7_7_7_7_7_7_1_7_7_7_32_1_32
4474,135,1329408060,4,5,4,1329416100,8040,3333660,5649480,2315820,19_19_19_19_19_19_19_19_19_19_19_19_1_19_1_19_19_19_1_1_1_1_19_19_19_19_19_19_1_1_1_1_19_19_19_19_19_19_19_19_19_19_19_19_1_19_1_19_19_19_19_19_19_1_19_1_1_1_2_2_1_1_2_2_9_3_3_9_3_3_2_9_9_9_2_4_4_3_4_3_3_9_3_4_4_4_4_9_3_9_3_4
4475,213,1329415320,0,0,0,1329448860,33540,378900,3206820,2827920,0_0_0_0_0_1_0_1_0_0_0_0_0_0_0_0_1_1_0_0_0_0_0_0_0_1_1_0_0_0_0_0_0_0_0_0_0_0_0
4476,199,1329415980,18,23,18,1329415980,0,739020,975720,236700,0_0_0_0_0_0_0_0_0_0_0_0_0_1_1_0_0_0_0_0_1_1_2_2_18_18_18_18_18_18
4477,199,1329415980,18,23,18,1329419220,3240,739020,975720,236700,0_0_0_0_0_0_0_0_0_0_0_0_0_1_1_0_0_0_0_0_1_1_2_2_18_18_18_18_18_18_18
4478,135,1329416100,4,22,4,1329453720,37620,3341700,5649480,2307780,19_19_19_19_19_19_19_19_19_19_19_19_1_19_1_19_19_19_1_1_1_1_19_19_19_19_19_19_1_1_1_1_19_19_19_19_19_19_19_19_19_19_19_19_1_19_1_19_19_19_19_19_19_1_19_1_1_1_2_2_1_1_2_2_9_3_3_9_3_3_2_9_9_9_2_4_4_3_4_3_3_9_3_4_4_4_4_9_3_9_3_4_4
4479,151,1329416220,19,11,19,1329454440,38220,1294020,3643800,2349780,19_19_19_19_19_1_1_19_1_1_19_19_19_19_1_19_1_19_19_19_19_19_19_19_19_19_1_19_19_1_1_1_1_1_19_19_19_19_19_19_1_1_19
4480,119,1329416400,14,17,14,1329454440,38040,2466780,2742780,276000,7_7_7_1_1_7_7_7_7_7_7_7_7_7_1_1_2_2_3_3_14_3_3_14_14_14_14_14_14
4481,168,1329418980,10,13,1,1329459060,40080,78180,438000,359820,10_10_10_1_10_1_10_10_10_10
4482,46,1329419040,26,13,26,1329432120,13080,0,2027040,2027040,26
4483,199,1329419220,18,23,18,1329419700,480,742260,975720,233460,0_0_0_0_0_0_0_0_0_0_0_0_0_1_1_0_0_0_0_0_1_1_2_2_18_18_18_18_18_18_18_18
4484,186,1329419700,7,0,7,1329453960,34260,34080,3636240,3602160,7_7_7_7_7_7_7
4485,199,1329419700,18,23,18,1329427800,8100,742740,975720,232980,0_0_0_0_0_0_0_0_0_0_0_0_0_1_1_0_0_0_0_0_1_1_2_2_18_18_18_18_18_18_18_18_18
4486,199,1329427800,18,23,15,1329472140,44340,750840,975720,224880,0_0_0_0_0_0_0_0_0_0_0_0_0_1_1_0_0_0_0_0_1_1_2_2_18_18_18_18_18_18_18_18_18_18
4487,107,1329428760,16,20,16,1329432420,3660,1502160,4991760,3489600,8_8_8_8_28_28_28_28_28_28_8_8_8_8_16_16_16_16_16_1_16_16_16_1_16_16_16_16_1_16_1_16_16_16_16_16_16_16_1_16_1_16_16_16
4488,96,1329429600,6,7,6,1329429600,0,2119800,2123400,3600,10_1_10_10_10_10_1_10_10_10_10_10_1_1_2_2_9_9_9_9_9_9_3_3_5_5_9_9_9_9_9_9_5_5_6_6_9_9_3_3_5_5_5_5_6
4489,23,1329429600,6,7,6,1329433200,3600,1891320,1894920,3600,24_24_24_24_8_8_24_24_24_24_24_24_24_24_24_24_24_24_24_24_8_8_7_7_3_3_9_9_9_9_2_2_9_9_9_9_5_2_9_9_9_9_5_2_5_5_5_5_5_5_6
4490,116,1329429600,6,7,6,1329433200,3600,752400,786600,34200,19_19_19_19_19_19_19_19_19_19_1_1_1_1_3_3_19_2_2_19_3_3_19_14_14_14_19_19_13_13_19_14_1_13_14_1_2_2_3_5_3_5_14_13_14_13_6_6_14_13_5_5_5_5_6
4491,0,1329429600,6,7,6,1329433200,3600,1557360,1560960,3600,0_0_0_0_0_0_0_0_1_1_2_2_3_3_3_3_3_3_4_3_3_4_4_4_5_5_5_5_5_5_6
4492,96,1329429600,6,7,6,1329433200,3600,2119800,2123400,3600,10_1_10_10_10_10_1_10_10_10_10_10_1_1_2_2_9_9_9_9_9_9_3_3_5_5_9_9_9_9_9_9_5_5_6_6_9_9_3_3_5_5_5_5_6_6
4493,133,1329429600,3,4,3,1329429600,0,2638800,6181200,3542400,17_17_17_17_17_17_17_17_17_17_17_17_17_17_17_17_17_17_17_17_17_17_17_17_17_17_17_17_17_17_1_1_17_17_17_17_1_1_1_1_17_17_17_17_17_17_17_17_17_17_17_17_17_17_17_17_17_17_17_17_17_17_19_19_17_17_2_2_3
4494,133,1329429600,3,4,3,1329434100,4500,2638800,6181200,3542400,17_17_17_17_17_17_17_17_17_17_17_17_17_17_17_17_17_17_17_17_17_17_17_17_17_17_17_17_17_17_1_1_17_17_17_17_1_1_1_1_17_17_17_17_17_17_17_17_17_17_17_17_17_17_17_17_17_17_17_17_17_17_19_19_17_17_2_2_3_3
4495,111,1329429600,6,7,6,1329433200,3600,3970800,3974400,3600,0_0_0_0_0_0_0_0_0_0_0_1_0_1_0_0_0_0_1_0_1_0_0_0_0_0_0_1_1_0_1_1_2_2_4_4_4_4_4_1_4_4_1_4_4_4_4_4_4_4_4_4_18_18_18_18_18_18_18_18_18_18_18_18_5_5_5_5_6
4496,153,1329429600,6,7,6,1329433200,3600,1614960,1618560,3600,16_1_16_1_0_0_1_1_2_2_3_3_4_4_4_4_4_4_4_4_4_4_4_4_5_5_5_5_6
4497,46,1329432120,26,13,26,1329455340,23220,13080,2027040,2013960,26_26
4498,107,1329432420,16,11,16,1329454380,21960,1505820,4991760,3485940,8_8_8_8_28_28_28_28_28_28_8_8_8_8_16_16_16_16_16_1_16_16_16_1_16_16_16_16_1_16_1_16_16_16_16_16_16_16_1_16_1_16_16_16_16
4499,23,1329433200,6,7,99,1329433200,0,1894920,1894920,0,24_24_24_24_8_8_24_24_24_24_24_24_24_24_24_24_24_24_24_24_8_8_7_7_3_3_9_9_9_9_2_2_9_9_9_9_5_2_9_9_9_9_5_2_5_5_5_5_5_5_6_6
4500,111,1329433200,6,7,99,1329433200,0,3974400,3974400,0,0_0_0_0_0_0_0_0_0_0_0_1_0_1_0_0_0_0_1_0_1_0_0_0_0_0_0_1_1_0_1_1_2_2_4_4_4_4_4_1_4_4_1_4_4_4_4_4_4_4_4_4_18_18_18_18_18_18_18_18_18_18_18_18_5_5_5_5_6_6
4501,96,1329433200,6,7,6,1329433200,0,2123400,2123400,0,10_1_10_10_10_10_1_10_10_10_10_10_1_1_2_2_9_9_9_9_9_9_3_3_5_5_9_9_9_9_9_9_5_5_6_6_9_9_3_3_5_5_5_5_6_6_6
4502,153,1329433200,6,7,99,1329433200,0,1618560,1618560,0,16_1_16_1_0_0_1_1_2_2_3_3_4_4_4_4_4_4_4_4_4_4_4_4_5_5_5_5_6_6
4503,0,1329433200,6,7,99,1329433200,0,1560960,1560960,0,0_0_0_0_0_0_0_0_1_1_2_2_3_3_3_3_3_3_4_3_3_4_4_4_5_5_5_5_5_5_6_6
4504,116,1329433200,6,7,5,1329462000,28800,756000,786600,30600,19_19_19_19_19_19_19_19_19_19_1_1_1_1_3_3_19_2_2_19_3_3_19_14_14_14_19_19_13_13_19_14_1_13_14_1_2_2_3_5_3_5_14_13_14_13_6_6_14_13_5_5_5_5_6_6
4505,96,1329433200,6,7,99,1329433200,0,2123400,2123400,0,10_1_10_10_10_10_1_10_10_10_10_10_1_1_2_2_9_9_9_9_9_9_3_3_5_5_9_9_9_9_9_9_5_5_6_6_9_9_3_3_5_5_5_5_6_6_6_6
4506,133,1329434100,3,4,3,1329434100,0,2643300,6181200,3537900,17_17_17_17_17_17_17_17_17_17_17_17_17_17_17_17_17_17_17_17_17_17_17_17_17_17_17_17_17_17_1_1_17_17_17_17_1_1_1_1_17_17_17_17_17_17_17_17_17_17_17_17_17_17_17_17_17_17_17_17_17_17_19_19_17_17_2_2_3_3_3
4507,133,1329434100,3,4,3,1329635100,201000,2643300,6181200,3537900,17_17_17_17_17_17_17_17_17_17_17_17_17_17_17_17_17_17_17_17_17_17_17_17_17_17_17_17_17_17_1_1_17_17_17_17_1_1_1_1_17_17_17_17_17_17_17_17_17_17_17_17_17_17_17_17_17_17_17_17_17_17_19_19_17_17_2_2_3_3_3_3
4508,213,1329448860,0,1,0,1329454260,5400,412440,3206820,2794380,0_0_0_0_0_1_0_1_0_0_0_0_0_0_0_0_1_1_0_0_0_0_0_0_0_1_1_0_0_0_0_0_0_0_0_0_0_0_0_0
4509,71,1329453360,32,34,5,1329463800,10440,3191760,3996240,804480,29_29_1_1_7_7_1_7_1_7_7_7_7_7_1_7_1_7_7_7_7_7_7_1_1_7_7_7_7_7_7_7_7_1_1_7_7_7_7_1_1_1_1_7_7_1_7_1_7_7_7_7_7_7_7_1_7_7_7_1_7_7_7_7_7_7_7_1_7_1_7_7_7_7_7_7_7_1_7_7_7_32_1_32_32
4510,135,1329453720,4,22,4,1329595800,142080,3379320,5649480,2270160,19_19_19_19_19_19_19_19_19_19_19_19_1_19_1_19_19_19_1_1_1_1_19_19_19_19_19_19_1_1_1_1_19_19_19_19_19_19_19_19_19_19_19_19_1_19_1_19_19_19_19_19_19_1_19_1_1_1_2_2_1_1_2_2_9_3_3_9_3_3_2_9_9_9_2_4_4_3_4_3_3_9_3_4_4_4_4_9_3_9_3_4_4_4
4511,186,1329453960,7,0,7,1329455100,1140,68340,3636240,3567900,7_7_7_7_7_7_7_7
4512,213,1329454260,0,0,1,1329454800,540,417840,3206820,2788980,0_0_0_0_0_1_0_1_0_0_0_0_0_0_0_0_1_1_0_0_0_0_0_0_0_1_1_0_0_0_0_0_0_0_0_0_0_0_0_0_0
4513,107,1329454380,16,11,1,1329454800,420,1527780,4991760,3463980,8_8_8_8_28_28_28_28_28_28_8_8_8_8_16_16_16_16_16_1_16_16_16_1_16_16_16_16_1_16_1_16_16_16_16_16_16_16_1_16_1_16_16_16_16_16
4514,151,1329454440,19,11,1,1329454620,180,1332240,3643800,2311560,19_19_19_19_19_1_1_19_1_1_19_19_19_19_1_19_1_19_19_19_19_19_19_19_19_19_1_19_19_1_1_1_1_1_19_19_19_19_19_19_1_1_19_19
4515,119,1329454440,14,17,5,1329627600,173160,2504820,2742780,237960,7_7_7_1_1_7_7_7_7_7_7_7_7_7_1_1_2_2_3_3_14_3_3_14_14_14_14_14_14_14
4516,156,1329454500,18,19,18,1329460200,5700,2055780,2639280,583500,16_16_16_16_16_16_16_16_16_16_16_1_1_1_16_1_16_16_16_16_16_16_1_1_1_1_16_16_16_16_16_16_16_16_16_16_16_16_16_16_16_16_16_16_16_16_16_16_16_16_16_16_1_1_16_16_16_16_16_16_16_16_1_1_47_47_2_2_2_3_2_3_18
4517,151,1329454620,1,9,1,1329460140,5520,1332420,3643800,2311380,19_19_19_19_19_1_1_19_1_1_19_19_19_19_1_19_1_19_19_19_19_19_19_19_19_19_1_19_19_1_1_1_1_1_19_19_19_19_19_19_1_1_19_19_1
4518,201,1329454800,13,15,13,1329460200,5400,1287840,1645440,357600,10_10_10_10_10_10_10_10_10_10_10_10_1_1_2_2_3_3_13
4519,107,1329454800,1,18,1,1329460800,6000,1528200,4991760,3463560,8_8_8_8_28_28_28_28_28_28_8_8_8_8_16_16_16_16_16_1_16_16_16_1_16_16_16_16_1_16_1_16_16_16_16_16_16_16_1_16_1_16_16_16_16_16_1
4520,213,1329454800,1,9,1,1329456900,2100,418380,3206820,2788440,0_0_0_0_0_1_0_1_0_0_0_0_0_0_0_0_1_1_0_0_0_0_0_0_0_1_1_0_0_0_0_0_0_0_0_0_0_0_0_0_0_1
4521,186,1329455100,7,8,1,1329465600,10500,69480,3636240,3566760,7_7_7_7_7_7_7_7_7
4522,46,1329455340,26,16,26,1329475260,19920,36300,2027040,1990740,26_26_26
4523,213,1329456900,1,9,1,1329470220,13320,420480,3206820,2786340,0_0_0_0_0_1_0_1_0_0_0_0_0_0_0_0_1_1_0_0_0_0_0_0_0_1_1_0_0_0_0_0_0_0_0_0_0_0_0_0_0_1_1
4524,85,1329458280,1,9,1,1329458820,540,285060,778380,493320,19_19_19_19_19_19_19_19_19_19_19_19_1
4525,85,1329458820,1,9,2,1329729720,270900,285600,778380,492780,19_19_19_19_19_19_19_19_19_19_19_19_1_1
4526,168,1329459060,1,9,1,1329459720,660,118260,438000,319740,10_10_10_1_10_1_10_10_10_10_1
4527,168,1329459720,1,9,2,1329654480,194760,118920,438000,319080,10_10_10_1_10_1_10_10_10_10_1_1
4528,151,1329460140,1,9,19,1329464940,4800,1337940,3643800,2305860,19_19_19_19_19_1_1_19_1_1_19_19_19_19_1_19_1_19_19_19_19_19_19_19_19_19_1_19_19_1_1_1_1_1_19_19_19_19_19_19_1_1_19_19_1_1
4529,201,1329460200,13,15,13,1329460200,0,1293240,1645440,352200,10_10_10_10_10_10_10_10_10_10_10_10_1_1_2_2_3_3_13_13
4530,201,1329460200,13,15,13,1329474600,14400,1293240,1645440,352200,10_10_10_10_10_10_10_10_10_10_10_10_1_1_2_2_3_3_13_13_13
4531,156,1329460200,18,19,18,1329460260,60,2061480,2639280,577800,16_16_16_16_16_16_16_16_16_16_16_1_1_1_16_1_16_16_16_16_16_16_1_1_1_1_16_16_16_16_16_16_16_16_16_16_16_16_16_16_16_16_16_16_16_16_16_16_16_16_16_16_1_1_16_16_16_16_16_16_16_16_1_1_47_47_2_2_2_3_2_3_18_18
4532,156,1329460260,18,19,3,1329463140,2880,2061540,2639280,577740,16_16_16_16_16_16_16_16_16_16_16_1_1_1_16_1_16_16_16_16_16_16_1_1_1_1_16_16_16_16_16_16_16_16_16_16_16_16_16_16_16_16_16_16_16_16_16_16_16_16_16_16_1_1_16_16_16_16_16_16_16_16_1_1_47_47_2_2_2_3_2_3_18_18_18
4533,107,1329460800,1,18,16,1329627000,166200,1534200,4991760,3457560,8_8_8_8_28_28_28_28_28_28_8_8_8_8_16_16_16_16_16_1_16_16_16_1_16_16_16_16_1_16_1_16_16_16_16_16_16_16_1_16_1_16_16_16_16_16_1_1
4534,116,1329462000,5,18,5,1329463800,1800,784800,786600,1800,19_19_19_19_19_19_19_19_19_19_1_1_1_1_3_3_19_2_2_19_3_3_19_14_14_14_19_19_13_13_19_14_1_13_14_1_2_2_3_5_3_5_14_13_14_13_6_6_14_13_5_5_5_5_6_6_5
4535,86,1329462900,5,9,5,1329468720,5820,3116880,3519180,402300,0_0_0_0_1_0_0_0_0_1_0_0_0_0_1_1_0_0_1_1_1_1_1_1_2_2_4_4_4_4_4_4_4_4_4_4_18_18_18_18_1_18_1_18_18_18_5_5_5
4536,156,1329463140,3,3,2,1329471540,8400,2064420,2639280,574860,16_16_16_16_16_16_16_16_16_16_16_1_1_1_16_1_16_16_16_16_16_16_1_1_1_1_16_16_16_16_16_16_16_16_16_16_16_16_16_16_16_16_16_16_16_16_16_16_16_16_16_16_1_1_16_16_16_16_16_16_16_16_1_1_47_47_2_2_2_3_2_3_18_18_18_3
4537,71,1329463800,5,18,5,1329467400,3600,3202200,3996240,794040,29_29_1_1_7_7_1_7_1_7_7_7_7_7_1_7_1_7_7_7_7_7_7_1_1_7_7_7_7_7_7_7_7_1_1_7_7_7_7_1_1_1_1_7_7_1_7_1_7_7_7_7_7_7_7_1_7_7_7_1_7_7_7_7_7_7_7_1_7_1_7_7_7_7_7_7_7_1_7_7_7_32_1_32_32_5
4538,116,1329463800,5,18,99,1329463800,0,786600,786600,0,19_19_19_19_19_19_19_19_19_19_1_1_1_1_3_3_19_2_2_19_3_3_19_14_14_14_19_19_13_13_19_14_1_13_14_1_2_2_3_5_3_5_14_13_14_13_6_6_14_13_5_5_5_5_6_6_5_5
4539,151,1329464940,19,1,1,1329468600,3660,1342740,3643800,2301060,19_19_19_19_19_1_1_19_1_1_19_19_19_19_1_19_1_19_19_19_19_19_19_19_19_19_1_19_19_1_1_1_1_1_19_19_19_19_19_19_1_1_19_19_1_1_19
4540,186,1329465600,1,18,7,1329467460,1860,79980,3636240,3556260,7_7_7_7_7_7_7_7_7_1
4541,71,1329467400,5,18,32,1329474960,7560,3205800,3996240,790440,29_29_1_1_7_7_1_7_1_7_7_7_7_7_1_7_1_7_7_7_7_7_7_1_1_7_7_7_7_7_7_7_7_1_1_7_7_7_7_1_1_1_1_7_7_1_7_1_7_7_7_7_7_7_7_1_7_7_7_1_7_7_7_7_7_7_7_1_7_1_7_7_7_7_7_7_7_1_7_7_7_32_1_32_32_5_5
4542,186,1329467460,7,8,1,1329472140,4680,81840,3636240,3554400,7_7_7_7_7_7_7_7_7_1_7
4543,152,1329467520,17,8,17,1329475800,8280,220080,3766500,3546420,17_17_17_17_17
4544,151,1329468600,1,9,1,1329468720,120,1346400,3643800,2297400,19_19_19_19_19_1_1_19_1_1_19_19_19_19_1_19_1_19_19_19_19_19_19_19_19_19_1_19_19_1_1_1_1_1_19_19_19_19_19_19_1_1_19_19_1_1_19_1
4545,151,1329468720,1,9,19,1329475740,7020,1346520,3643800,2297280,19_19_19_19_19_1_1_19_1_1_19_19_19_19_1_19_1_19_19_19_19_19_19_19_19_19_1_19_19_1_1_1_1_1_19_19_19_19_19_19_1_1_19_19_1_1_19_1_1
4546,86,1329468720,5,9,4,1329719040,250320,3122700,3519180,396480,0_0_0_0_1_0_0_0_0_1_0_0_0_0_1_1_0_0_1_1_1_1_1_1_2_2_4_4_4_4_4_4_4_4_4_4_18_18_18_18_1_18_1_18_18_18_5_5_5_5
4547,213,1329470220,1,9,0,1329470460,240,433800,3206820,2773020,0_0_0_0_0_1_0_1_0_0_0_0_0_0_0_0_1_1_0_0_0_0_0_0_0_1_1_0_0_0_0_0_0_0_0_0_0_0_0_0_0_1_1_1
4548,213,1329470460,0,1,1,1329470580,120,434040,3206820,2772780,0_0_0_0_0_1_0_1_0_0_0_0_0_0_0_0_1_1_0_0_0_0_0_0_0_1_1_0_0_0_0_0_0_0_0_0_0_0_0_0_0_1_1_1_0
4549,213,1329470580,1,9,0,1329563700,93120,434160,3206820,2772660,0_0_0_0_0_1_0_1_0_0_0_0_0_0_0_0_1_1_0_0_0_0_0_0_0_1_1_0_0_0_0_0_0_0_0_0_0_0_0_0_0_1_1_1_0_1
4550,156,1329471540,2,3,2,1329472920,1380,2072820,2639280,566460,16_16_16_16_16_16_16_16_16_16_16_1_1_1_16_1_16_16_16_16_16_16_1_1_1_1_16_16_16_16_16_16_16_16_16_16_16_16_16_16_16_16_16_16_16_16_16_16_16_16_16_16_1_1_16_16_16_16_16_16_16_16_1_1_47_47_2_2_2_3_2_3_18_18_18_3_2
4551,186,1329472140,1,18,7,1329612300,140160,86520,3636240,3549720,7_7_7_7_7_7_7_7_7_1_7_1
4552,199,1329472140,15,9,15,1329473580,1440,795180,975720,180540,0_0_0_0_0_0_0_0_0_0_0_0_0_1_1_0_0_0_0_0_1_1_2_2_18_18_18_18_18_18_18_18_18_18_15
4553,130,1329472200,5,18,5,1329475440,3240,2748540,3083940,335400,26_26_26_26_26_26_8_8_26_26_26_26_26_26_26_26_26_26_26_8_26_8_17_17_1_1_17_1_17_17_1_17_17_17_17_17_17_17_17_1_17_17_1_17_17_1_17_1_17_17_1_17_1_3_3_1_1_17_17_17_18_17_1_18_4_18_1_4_4_18_18_3_17_1_3_1_15_4_4_3_3_18_15_18_4_18_4_4_15_4_18_18_4_15_4_4_4_4_4_4_15_15_15_15_15_15_15_15_2_15_2_15_15_15_2_2_5
4554,156,1329472920,2,3,18,1329473100,180,2074200,2639280,565080,16_16_16_16_16_16_16_16_16_16_16_1_1_1_16_1_16_16_16_16_16_16_1_1_1_1_16_16_16_16_16_16_16_16_16_16_16_16_16_16_16_16_16_16_16_16_16_16_16_16_16_16_1_1_16_16_16_16_16_16_16_16_1_1_47_47_2_2_2_3_2_3_18_18_18_3_2_2
4555,156,1329473100,18,19,3,1329475500,2400,2074380,2639280,564900,16_16_16_16_16_16_16_16_16_16_16_1_1_1_16_1_16_16_16_16_16_16_1_1_1_1_16_16_16_16_16_16_16_16_16_16_16_16_16_16_16_16_16_16_16_16_16_16_16_16_16_16_1_1_16_16_16_16_16_16_16_16_1_1_47_47_2_2_2_3_2_3_18_18_18_3_2_2_18
4556,199,1329473580,15,9,6,1329602400,128820,796620,975720,179100,0_0_0_0_0_0_0_0_0_0_0_0_0_1_1_0_0_0_0_0_1_1_2_2_18_18_18_18_18_18_18_18_18_18_15_15
4557,201,1329474600,13,15,13,1329636000,161400,1307640,1645440,337800,10_10_10_10_10_10_10_10_10_10_10_10_1_1_2_2_3_3_13_13_13_13
4558,71,1329474960,32,34,7,1329630300,155340,3213360,3996240,782880,29_29_1_1_7_7_1_7_1_7_7_7_7_7_1_7_1_7_7_7_7_7_7_1_1_7_7_7_7_7_7_7_7_1_1_7_7_7_7_1_1_1_1_7_7_1_7_1_7_7_7_7_7_7_7_1_7_7_7_1_7_7_7_7_7_7_7_1_7_1_7_7_7_7_7_7_7_1_7_7_7_32_1_32_32_5_5_32
4559,46,1329475260,26,16,26,1329627000,151740,56220,2027040,1970820,26_26_26_26
4560,130,1329475440,5,18,5,1329745980,270540,2751780,3083940,332160,26_26_26_26_26_26_8_8_26_26_26_26_26_26_26_26_26_26_26_8_26_8_17_17_1_1_17_1_17_17_1_17_17_17_17_17_17_17_17_1_17_17_1_17_17_1_17_1_17_17_1_17_1_3_3_1_1_17_17_17_18_17_1_18_4_18_1_4_4_18_18_3_17_1_3_1_15_4_4_3_3_18_15_18_4_18_4_4_15_4_18_18_4_15_4_4_4_4_4_4_15_15_15_15_15_15_15_15_2_15_2_15_15_15_2_2_5_5
4561,156,1329475500,3,3,2,1329630060,154560,2076780,2639280,562500,16_16_16_16_16_16_16_16_16_16_16_1_1_1_16_1_16_16_16_16_16_16_1_1_1_1_16_16_16_16_16_16_16_16_16_16_16_16_16_16_16_16_16_16_16_16_16_16_16_16_16_16_1_1_16_16_16_16_16_16_16_16_1_1_47_47_2_2_2_3_2_3_18_18_18_3_2_2_18_3
4562,151,1329475740,19,1,19,1329563460,87720,1353540,3643800,2290260,19_19_19_19_19_1_1_19_1_1_19_19_19_19_1_19_1_19_19_19_19_19_19_19_19_19_1_19_19_1_1_1_1_1_19_19_19_19_19_19_1_1_19_19_1_1_19_1_1_19
4563,152,1329475800,17,8,17,1329475800,0,228360,3766500,3538140,17_17_17_17_17_17
4564,152,1329475800,17,12,17,1329541200,65400,228360,3766500,3538140,17_17_17_17_17_17_17
4565,152,1329541200,17,12,17,1329541200,0,293760,3766500,3472740,17_17_17_17_17_17_17_17
4566,152,1329541200,17,12,17,1329595200,54000,293760,3766500,3472740,17_17_17_17_17_17_17_17_17
4567,151,1329563460,19,14,19,1329568200,4740,1441260,3643800,2202540,19_19_19_19_19_1_1_19_1_1_19_19_19_19_1_19_1_19_19_19_19_19_19_19_19_19_1_19_19_1_1_1_1_1_19_19_19_19_19_19_1_1_19_19_1_1_19_1_1_19_19
4568,213,1329563700,0,14,0,1329595800,32100,527280,3206820,2679540,0_0_0_0_0_1_0_1_0_0_0_0_0_0_0_0_1_1_0_0_0_0_0_0_0_1_1_0_0_0_0_0_0_0_0_0_0_0_0_0_0_1_1_1_0_1_0
4569,151,1329568200,19,14,19,1329570000,1800,1446000,3643800,2197800,19_19_19_19_19_1_1_19_1_1_19_19_19_19_1_19_1_19_19_19_19_19_19_19_19_19_1_19_19_1_1_1_1_1_19_19_19_19_19_19_1_1_19_19_1_1_19_1_1_19_19_19
4570,151,1329570000,19,14,19,1329597960,27960,1447800,3643800,2196000,19_19_19_19_19_1_1_19_1_1_19_19_19_19_1_19_1_19_19_19_19_19_19_19_19_19_1_19_19_1_1_1_1_1_19_19_19_19_19_19_1_1_19_19_1_1_19_1_1_19_19_19_19
4571,152,1329595200,17,12,17,1329607380,12180,347760,3766500,3418740,17_17_17_17_17_17_17_17_17_17
4572,135,1329595800,4,5,4,1329596160,360,3521400,5649480,2128080,19_19_19_19_19_19_19_19_19_19_19_19_1_19_1_19_19_19_1_1_1_1_19_19_19_19_19_19_1_1_1_1_19_19_19_19_19_19_19_19_19_19_19_19_1_19_1_19_19_19_19_19_19_1_19_1_1_1_2_2_1_1_2_2_9_3_3_9_3_3_2_9_9_9_2_4_4_3_4_3_3_9_3_4_4_4_4_9_3_9_3_4_4_4_4
4573,213,1329595800,0,12,0,1329599700,3900,559380,3206820,2647440,0_0_0_0_0_1_0_1_0_0_0_0_0_0_0_0_1_1_0_0_0_0_0_0_0_1_1_0_0_0_0_0_0_0_0_0_0_0_0_0_0_1_1_1_0_1_0_0
4574,135,1329596160,4,5,5,1329833580,237420,3521760,5649480,2127720,19_19_19_19_19_19_19_19_19_19_19_19_1_19_1_19_19_19_1_1_1_1_19_19_19_19_19_19_1_1_1_1_19_19_19_19_19_19_19_19_19_19_19_19_1_19_1_19_19_19_19_19_19_1_19_1_1_1_2_2_1_1_2_2_9_3_3_9_3_3_2_9_9_9_2_4_4_3_4_3_3_9_3_4_4_4_4_9_3_9_3_4_4_4_4_4
4575,142,1329596220,4,5,4,1329603000,6780,3837780,7299960,3462180,0_0_0_0_0_0_0_1_1_0_0_0_0_0_0_0_0_1_1_0_0_0_0_0_0_1_1_0_0_0_0_0_0_1_1_0_0_0_0_0_0_0_1_0_1_0_0_0_1_1_1_1_27_27_27_27_1_27_27_1_27_27_27_27_27_27_27_27_27_27_27_27_27_27_27_27_2_2_2_2_2_2_3_3_3_2_2_3_3_3_2_2_3_3_4_4_15_4_15_4_4_4_4_4_4
4576,151,1329597960,19,12,19,1329621240,23280,1475760,3643800,2168040,19_19_19_19_19_1_1_19_1_1_19_19_19_19_1_19_1_19_19_19_19_19_19_19_19_19_1_19_19_1_1_1_1_1_19_19_19_19_19_19_1_1_19_19_1_1_19_1_1_19_19_19_19_19
4577,213,1329599700,0,14,0,1329626880,27180,563280,3206820,2643540,0_0_0_0_0_1_0_1_0_0_0_0_0_0_0_0_1_1_0_0_0_0_0_0_0_1_1_0_0_0_0_0_0_0_0_0_0_0_0_0_0_1_1_1_0_1_0_0_0
4578,47,1329602400,6,7,6,1329606000,3600,0,31200,31200,6
4579,199,1329602400,6,7,6,1329606000,3600,925440,975720,50280,0_0_0_0_0_0_0_0_0_0_0_0_0_1_1_0_0_0_0_0_1_1_2_2_18_18_18_18_18_18_18_18_18_18_15_15_6
4580,142,1329603000,4,5,4,1329627300,24300,3844560,7299960,3455400,0_0_0_0_0_0_0_1_1_0_0_0_0_0_0_0_0_1_1_0_0_0_0_0_0_1_1_0_0_0_0_0_0_1_1_0_0_0_0_0_0_0_1_0_1_0_0_0_1_1_1_1_27_27_27_27_1_27_27_1_27_27_27_27_27_27_27_27_27_27_27_27_27_27_27_27_2_2_2_2_2_2_3_3_3_2_2_3_3_3_2_2_3_3_4_4_15_4_15_4_4_4_4_4_4_4_4
4581,142,1329603000,4,5,4,1329603000,0,3844560,7299960,3455400,0_0_0_0_0_0_0_1_1_0_0_0_0_0_0_0_0_1_1_0_0_0_0_0_0_1_1_0_0_0_0_0_0_1_1_0_0_0_0_0_0_0_1_0_1_0_0_0_1_1_1_1_27_27_27_27_1_27_27_1_27_27_27_27_27_27_27_27_27_27_27_27_27_27_27_27_2_2_2_2_2_2_3_3_3_2_2_3_3_3_2_2_3_3_4_4_15_4_15_4_4_4_4_4_4_4
4582,47,1329606000,6,7,5,1329627600,21600,3600,31200,27600,6_6
4583,199,1329606000,6,7,5,1329634800,28800,929040,975720,46680,0_0_0_0_0_0_0_0_0_0_0_0_0_1_1_0_0_0_0_0_1_1_2_2_18_18_18_18_18_18_18_18_18_18_15_15_6_6
4584,152,1329607380,17,12,17,1329626820,19440,359940,3766500,3406560,17_17_17_17_17_17_17_17_17_17_17
4585,186,1329612300,7,12,7,1329627000,14700,226680,3636240,3409560,7_7_7_7_7_7_7_7_7_1_7_1_7
4586,151,1329621240,19,12,19,1329634800,13560,1499040,3643800,2144760,19_19_19_19_19_1_1_19_1_1_19_19_19_19_1_19_1_19_19_19_19_19_19_19_19_19_1_19_19_1_1_1_1_1_19_19_19_19_19_19_1_1_19_19_1_1_19_1_1_19_19_19_19_19_19
4587,152,1329626820,17,12,1,1330059900,433080,379380,3766500,3387120,17_17_17_17_17_17_17_17_17_17_17_17
4588,213,1329626880,0,12,0,1329627240,360,590460,3206820,2616360,0_0_0_0_0_1_0_1_0_0_0_0_0_0_0_0_1_1_0_0_0_0_0_0_0_1_1_0_0_0_0_0_0_0_0_0_0_0_0_0_0_1_1_1_0_1_0_0_0_0
4589,182,1329627000,5,9,2,1329656940,29940,849660,915060,65400,14_14_14_14_14_14_14_14_5
4590,107,1329627000,16,20,16,1329642000,15000,1700400,4991760,3291360,8_8_8_8_28_28_28_28_28_28_8_8_8_8_16_16_16_16_16_1_16_16_16_1_16_16_16_16_1_16_1_16_16_16_16_16_16_16_1_16_1_16_16_16_16_16_1_1_16
4591,46,1329627000,26,13,26,1329628620,1620,207960,2027040,1819080,26_26_26_26_26
4592,186,1329627000,7,12,7,1329634980,7980,241380,3636240,3394860,7_7_7_7_7_7_7_7_7_1_7_1_7_7
4593,213,1329627240,0,0,0,1329660240,33000,590820,3206820,2616000,0_0_0_0_0_1_0_1_0_0_0_0_0_0_0_0_1_1_0_0_0_0_0_0_0_1_1_0_0_0_0_0_0_0_0_0_0_0_0_0_0_1_1_1_0_1_0_0_0_0_0
4594,142,1329627300,4,5,4,1329627540,240,3868860,7299960,3431100,0_0_0_0_0_0_0_1_1_0_0_0_0_0_0_0_0_1_1_0_0_0_0_0_0_1_1_0_0_0_0_0_0_1_1_0_0_0_0_0_0_0_1_0_1_0_0_0_1_1_1_1_27_27_27_27_1_27_27_1_27_27_27_27_27_27_27_27_27_27_27_27_27_27_27_27_2_2_2_2_2_2_3_3_3_2_2_3_3_3_2_2_3_3_4_4_15_4_15_4_4_4_4_4_4_4_4_4
4595,142,1329627540,4,22,4,1329628800,1260,3869100,7299960,3430860,0_0_0_0_0_0_0_1_1_0_0_0_0_0_0_0_0_1_1_0_0_0_0_0_0_1_1_0_0_0_0_0_0_1_1_0_0_0_0_0_0_0_1_0_1_0_0_0_1_1_1_1_27_27_27_27_1_27_27_1_27_27_27_27_27_27_27_27_27_27_27_27_27_27_27_27_2_2_2_2_2_2_3_3_3_2_2_3_3_3_2_2_3_3_4_4_15_4_15_4_4_4_4_4_4_4_4_4_4
4596,131,1329627600,5,2,5,1329633600,6000,3367500,6825900,3458400,16_16_16_16_16_16_16_16_16_16_16_16_16_16_16_16_16_16_16_16_16_16_16_16_16_16_1_1_1_1_2_2_3_3_3_3_18_18_18_18_18_3_3_3_3_18_18_18_18_18_18_18_18_18_18_18_18_18_18_18_18_18_18_18_5_5_5_5_5
4597,47,1329627600,5,18,5,1329633600,6000,25200,31200,6000,6_6_5
4598,119,1329627600,5,6,5,1329657600,30000,2677980,2742780,64800,7_7_7_1_1_7_7_7_7_7_7_7_7_7_1_1_2_2_3_3_14_3_3_14_14_14_14_14_14_14_5
4599,46,1329628620,26,13,26,1329637140,8520,209580,2027040,1817460,26_26_26_26_26_26
4600,142,1329628800,4,22,4,1329635040,6240,3870360,7299960,3429600,0_0_0_0_0_0_0_1_1_0_0_0_0_0_0_0_0_1_1_0_0_0_0_0_0_1_1_0_0_0_0_0_0_1_1_0_0_0_0_0_0_0_1_0_1_0_0_0_1_1_1_1_27_27_27_27_1_27_27_1_27_27_27_27_27_27_27_27_27_27_27_27_27_27_27_27_2_2_2_2_2_2_3_3_3_2_2_3_3_3_2_2_3_3_4_4_15_4_15_4_4_4_4_4_4_4_4_4_4_4
4601,156,1329630060,2,4,2,1329633540,3480,2231340,2639280,407940,16_16_16_16_16_16_16_16_16_16_16_1_1_1_16_1_16_16_16_16_16_16_1_1_1_1_16_16_16_16_16_16_16_16_16_16_16_16_16_16_16_16_16_16_16_16_16_16_16_16_16_16_1_1_16_16_16_16_16_16_16_16_1_1_47_47_2_2_2_3_2_3_18_18_18_3_2_2_18_3_2
4602,71,1329630300,7,34,7,1329669960,39660,3368700,3996240,627540,29_29_1_1_7_7_1_7_1_7_7_7_7_7_1_7_1_7_7_7_7_7_7_1_1_7_7_7_7_7_7_7_7_1_1_7_7_7_7_1_1_1_1_7_7_1_7_1_7_7_7_7_7_7_7_1_7_7_7_1_7_7_7_7_7_7_7_1_7_1_7_7_7_7_7_7_7_1_7_7_7_32_1_32_32_5_5_32_7
4603,63,1329632460,3,3,3,1329654480,22020,2781000,6232860,3451860,16_16_16_16_16_16_16_16_16_0_0_16_16_0_16_16_0_16_16_0_0_16_16_16_0_0_16_0_0_16_0_16_0_0_0_16_1_1_1_16_16_16_0_1_1_1_16_0_0_16_16_0_16_0_16_0_0_2_2_1_1_0_0_0_0_2_2_2_2_2_2_0_1_0_1_1_0_0_0_1_1_0_0_1_1_1_0_0_0_0_0_2_2_2_2_0_0_0_0_0_0_1_1_1_1_0_0_16_0_16_16_16_16_16_0_0_1_1_2_2_1_1_16_0_2_16_2_2_2_0_1_1_1_1_1_16_16_1_1_1_3_3_18_3_18_3_3
4604,156,1329633540,2,4,18,1329635220,1680,2234820,2639280,404460,16_16_16_16_16_16_16_16_16_16_16_1_1_1_16_1_16_16_16_16_16_16_1_1_1_1_16_16_16_16_16_16_16_16_16_16_16_16_16_16_16_16_16_16_16_16_16_16_16_16_16_16_1_1_16_16_16_16_16_16_16_16_1_1_47_47_2_2_2_3_2_3_18_18_18_3_2_2_18_3_2_2
4605,131,1329633600,5,2,5,1329634800,1200,3373500,6825900,3452400,16_16_16_16_16_16_16_16_16_16_16_16_16_16_16_16_16_16_16_16_16_16_16_16_16_16_1_1_1_1_2_2_3_3_3_3_18_18_18_18_18_3_3_3_3_18_18_18_18_18_18_18_18_18_18_18_18_18_18_18_18_18_18_18_5_5_5_5_5_5
4606,47,1329633600,5,18,99,1329633600,0,31200,31200,0,6_6_5_5
4607,180,1329634800,1,18,1,1329640200,5400,844380,3322080,2477700,50_50_50_50_50_50_1_50_1_50_50_50_50_50_50_50_50_50_1
4608,199,1329634800,5,9,5,1329652680,17880,957840,975720,17880,0_0_0_0_0_0_0_0_0_0_0_0_0_1_1_0_0_0_0_0_1_1_2_2_18_18_18_18_18_18_18_18_18_18_15_15_6_6_5
4609,151,1329634800,19,14,19,1329637260,2460,1512600,3643800,2131200,19_19_19_19_19_1_1_19_1_1_19_19_19_19_1_19_1_19_19_19_19_19_19_19_19_19_1_19_19_1_1_1_1_1_19_19_19_19_19_19_1_1_19_19_1_1_19_1_1_19_19_19_19_19_19_19
4610,131,1329634800,5,2,5,1329640800,6000,3374700,6825900,3451200,16_16_16_16_16_16_16_16_16_16_16_16_16_16_16_16_16_16_16_16_16_16_16_16_16_16_1_1_1_1_2_2_3_3_3_3_18_18_18_18_18_3_3_3_3_18_18_18_18_18_18_18_18_18_18_18_18_18_18_18_18_18_18_18_5_5_5_5_5_5_5
4611,186,1329634980,7,8,1,1329640200,5220,249360,3636240,3386880,7_7_7_7_7_7_7_7_7_1_7_1_7_7_7
4612,142,1329635040,4,22,4,1329651600,16560,3876600,7299960,3423360,0_0_0_0_0_0_0_1_1_0_0_0_0_0_0_0_0_1_1_0_0_0_0_0_0_1_1_0_0_0_0_0_0_1_1_0_0_0_0_0_0_0_1_0_1_0_0_0_1_1_1_1_27_27_27_27_1_27_27_1_27_27_27_27_27_27_27_27_27_27_27_27_27_27_27_27_2_2_2_2_2_2_3_3_3_2_2_3_3_3_2_2_3_3_4_4_15_4_15_4_4_4_4_4_4_4_4_4_4_4_4
4613,133,1329635100,3,4,3,1329648900,13800,2844300,6181200,3336900,17_17_17_17_17_17_17_17_17_17_17_17_17_17_17_17_17_17_17_17_17_17_17_17_17_17_17_17_17_17_1_1_17_17_17_17_1_1_1_1_17_17_17_17_17_17_17_17_17_17_17_17_17_17_17_17_17_17_17_17_17_17_19_19_17_17_2_2_3_3_3_3_3
4614,156,1329635220,18,23,2,1329641880,6660,2236500,2639280,402780,16_16_16_16_16_16_16_16_16_16_16_1_1_1_16_1_16_16_16_16_16_16_1_1_1_1_16_16_16_16_16_16_16_16_16_16_16_16_16_16_16_16_16_16_16_16_16_16_16_16_16_16_1_1_16_16_16_16_16_16_16_16_1_1_47_47_2_2_2_3_2_3_18_18_18_3_2_2_18_3_2_2_18
4615,201,1329636000,13,17,13,1329645600,9600,1469040,1645440,176400,10_10_10_10_10_10_10_10_10_10_10_10_1_1_2_2_3_3_13_13_13_13_13
4616,46,1329637140,26,13,26,1329639420,2280,218100,2027040,1808940,26_26_26_26_26_26_26
4617,151,1329637260,19,11,19,1329659580,22320,1515060,3643800,2128740,19_19_19_19_19_1_1_19_1_1_19_19_19_19_1_19_1_19_19_19_19_19_19_19_19_19_1_19_19_1_1_1_1_1_19_19_19_19_19_19_1_1_19_19_1_1_19_1_1_19_19_19_19_19_19_19_19
4618,46,1329639420,26,13,8,1329659640,20220,220380,2027040,1806660,26_26_26_26_26_26_26_26
4619,191,1329639480,26,13,26,1329641880,2400,0,1811280,1811280,26
4620,180,1329640200,1,18,2,1329724140,83940,849780,3322080,2472300,50_50_50_50_50_50_1_50_1_50_50_50_50_50_50_50_50_50_1_1
4621,186,1329640200,1,18,7,1329641580,1380,254580,3636240,3381660,7_7_7_7_7_7_7_7_7_1_7_1_7_7_7_1
4622,131,1329640800,5,2,5,1329648600,7800,3380700,6825900,3445200,16_16_16_16_16_16_16_16_16_16_16_16_16_16_16_16_16_16_16_16_16_16_16_16_16_16_1_1_1_1_2_2_3_3_3_3_18_18_18_18_18_3_3_3_3_18_18_18_18_18_18_18_18_18_18_18_18_18_18_18_18_18_18_18_5_5_5_5_5_5_5_5_5
4623,131,1329640800,5,2,5,1329640800,0,3380700,6825900,3445200,16_16_16_16_16_16_16_16_16_16_16_16_16_16_16_16_16_16_16_16_16_16_16_16_16_16_1_1_1_1_2_2_3_3_3_3_18_18_18_18_18_3_3_3_3_18_18_18_18_18_18_18_18_18_18_18_18_18_18_18_18_18_18_18_5_5_5_5_5_5_5_5
4624,186,1329641580,7,8,7,1329641640,60,255960,3636240,3380280,7_7_7_7_7_7_7_7_7_1_7_1_7_7_7_1_7
4625,186,1329641640,7,8,1,1329643800,2160,256020,3636240,3380220,7_7_7_7_7_7_7_7_7_1_7_1_7_7_7_1_7_7
4626,191,1329641880,26,13,26,1329641940,60,2400,1811280,1808880,26_26
4627,156,1329641880,2,3,2,1329644280,2400,2243160,2639280,396120,16_16_16_16_16_16_16_16_16_16_16_1_1_1_16_1_16_16_16_16_16_16_1_1_1_1_16_16_16_16_16_16_16_16_16_16_16_16_16_16_16_16_16_16_16_16_16_16_16_16_16_16_1_1_16_16_16_16_16_16_16_16_1_1_47_47_2_2_2_3_2_3_18_18_18_3_2_2_18_3_2_2_18_2
4628,191,1329641940,26,13,26,1329650760,8820,2460,1811280,1808820,26_26_26
4629,107,1329642000,16,20,16,1329642060,60,1715400,4991760,3276360,8_8_8_8_28_28_28_28_28_28_8_8_8_8_16_16_16_16_16_1_16_16_16_1_16_16_16_16_1_16_1_16_16_16_16_16_16_16_1_16_1_16_16_16_16_16_1_1_16_16
4630,107,1329642060,16,20,1,1329643800,1740,1715460,4991760,3276300,8_8_8_8_28_28_28_28_28_28_8_8_8_8_16_16_16_16_16_1_16_16_16_1_16_16_16_16_1_16_1_16_16_16_16_16_16_16_1_16_1_16_16_16_16_16_1_1_16_16_16
4631,107,1329643800,1,18,1,1329648600,4800,1717200,4991760,3274560,8_8_8_8_28_28_28_28_28_28_8_8_8_8_16_16_16_16_16_1_16_16_16_1_16_16_16_16_1_16_1_16_16_16_16_16_16_16_1_16_1_16_16_16_16_16_1_1_16_16_16_1
4632,186,1329643800,1,18,7,1329647040,3240,258180,3636240,3378060,7_7_7_7_7_7_7_7_7_1_7_1_7_7_7_1_7_7_1
4633,156,1329644280,2,3,18,1329650580,6300,2245560,2639280,393720,16_16_16_16_16_16_16_16_16_16_16_1_1_1_16_1_16_16_16_16_16_16_1_1_1_1_16_16_16_16_16_16_16_16_16_16_16_16_16_16_16_16_16_16_16_16_16_16_16_16_16_16_1_1_16_16_16_16_16_16_16_16_1_1_47_47_2_2_2_3_2_3_18_18_18_3_2_2_18_3_2_2_18_2_2
4634,201,1329645600,13,17,6,1329775200,129600,1478640,1645440,166800,10_10_10_10_10_10_10_10_10_10_10_10_1_1_2_2_3_3_13_13_13_13_13_13
4635,202,1329645600,13,17,13,1329647400,1800,0,166740,166740,13
4636,74,1329646320,34,17,34,1329653340,7020,2847120,2979600,132480,1_1_34
4637,186,1329647040,7,8,7,1329648360,1320,261420,3636240,3374820,7_7_7_7_7_7_7_7_7_1_7_1_7_7_7_1_7_7_1_7
4638,202,1329647400,13,17,6,1329775200,127800,1800,166740,164940,13_13
4639,186,1329648360,7,8,7,1329657240,8880,262740,3636240,3373500,7_7_7_7_7_7_7_7_7_1_7_1_7_7_7_1_7_7_1_7_7
4640,131,1329648600,5,2,5,1329653220,4620,3388500,6825900,3437400,16_16_16_16_16_16_16_16_16_16_16_16_16_16_16_16_16_16_16_16_16_16_16_16_16_16_1_1_1_1_2_2_3_3_3_3_18_18_18_18_18_3_3_3_3_18_18_18_18_18_18_18_18_18_18_18_18_18_18_18_18_18_18_18_5_5_5_5_5_5_5_5_5_5
4641,107,1329648600,1,18,16,1329667320,18720,1722000,4991760,3269760,8_8_8_8_28_28_28_28_28_28_8_8_8_8_16_16_16_16_16_1_16_16_16_1_16_16_16_16_1_16_1_16_16_16_16_16_16_16_1_16_1_16_16_16_16_16_1_1_16_16_16_1_1
4642,133,1329648900,3,4,5,1329650400,1500,2858100,6181200,3323100,17_17_17_17_17_17_17_17_17_17_17_17_17_17_17_17_17_17_17_17_17_17_17_17_17_17_17_17_17_17_1_1_17_17_17_17_1_1_1_1_17_17_17_17_17_17_17_17_17_17_17_17_17_17_17_17_17_17_17_17_17_17_19_19_17_17_2_2_3_3_3_3_3_3
4643,141,1329650400,5,2,5,1329653220,2820,3997200,7406100,3408900,1_1_16_16_16_16_16_1_16_16_1_1_1_16_16_16_16_16_16_16_16_16_16_16_16_16_16_16_1_1_1_1_1_1_1_1_1_1_1_1_16_2_2_16_3_3_3_3_3_3_18_18_18_18_18_3_18_3_3_3_5_5_5_5_5_5_3_3_4_4_4_4_4_3_1_3_1_4_18_3_3_18_18_1_1_18_18_5_5_18_5_5_5_5_6_6_5_5_6_6_6_6_5_5_5_5_5_5_5
4644,215,1329650400,5,18,5,1329656400,6000,1723320,1851720,128400,24_24_24_24_24_24_8_8_3_3_3_3_14_14_14_14_2_2_5
4645,133,1329650400,5,9,5,1329659460,9060,2859600,6181200,3321600,17_17_17_17_17_17_17_17_17_17_17_17_17_17_17_17_17_17_17_17_17_17_17_17_17_17_17_17_17_17_1_1_17_17_17_17_1_1_1_1_17_17_17_17_17_17_17_17_17_17_17_17_17_17_17_17_17_17_17_17_17_17_19_19_17_17_2_2_3_3_3_3_3_3_5
4646,156,1329650580,18,23,3,1329654180,3600,2251860,2639280,387420,16_16_16_16_16_16_16_16_16_16_16_1_1_1_16_1_16_16_16_16_16_16_1_1_1_1_16_16_16_16_16_16_16_16_16_16_16_16_16_16_16_16_16_16_16_16_16_16_16_16_16_16_1_1_16_16_16_16_16_16_16_16_1_1_47_47_2_2_2_3_2_3_18_18_18_3_2_2_18_3_2_2_18_2_2_18
4647,191,1329650760,26,13,8,1329659520,8760,11280,1811280,1800000,26_26_26_26
4648,187,1329650820,10,13,10,1329660180,9360,0,2496960,2496960,10
4649,142,1329651600,4,22,4,1329653400,1800,3893160,7299960,3406800,0_0_0_0_0_0_0_1_1_0_0_0_0_0_0_0_0_1_1_0_0_0_0_0_0_1_1_0_0_0_0_0_0_1_1_0_0_0_0_0_0_0_1_0_1_0_0_0_1_1_1_1_27_27_27_27_1_27_27_1_27_27_27_27_27_27_27_27_27_27_27_27_27_27_27_27_2_2_2_2_2_2_3_3_3_2_2_3_3_3_2_2_3_3_4_4_15_4_15_4_4_4_4_4_4_4_4_4_4_4_4_4
4650,199,1329652680,5,9,99,1329652680,0,975720,975720,0,0_0_0_0_0_0_0_0_0_0_0_0_0_1_1_0_0_0_0_0_1_1_2_2_18_18_18_18_18_18_18_18_18_18_15_15_6_6_5_5
4651,141,1329653220,5,2,6,1329688800,35580,4000020,7406100,3406080,1_1_16_16_16_16_16_1_16_16_1_1_1_16_16_16_16_16_16_16_16_16_16_16_16_16_16_16_1_1_1_1_1_1_1_1_1_1_1_1_16_2_2_16_3_3_3_3_3_3_18_18_18_18_18_3_18_3_3_3_5_5_5_5_5_5_3_3_4_4_4_4_4_3_1_3_1_4_18_3_3_18_18_1_1_18_18_5_5_18_5_5_5_5_6_6_5_5_6_6_6_6_5_5_5_5_5_5_5_5
4652,131,1329653220,5,2,5,1329667320,14100,3393120,6825900,3432780,16_16_16_16_16_16_16_16_16_16_16_16_16_16_16_16_16_16_16_16_16_16_16_16_16_16_1_1_1_1_2_2_3_3_3_3_18_18_18_18_18_3_3_3_3_18_18_18_18_18_18_18_18_18_18_18_18_18_18_18_18_18_18_18_5_5_5_5_5_5_5_5_5_5_5
4653,74,1329653340,34,17,5,1329657300,3960,2854140,2979600,125460,1_1_34_34
4654,142,1329653400,4,22,4,1329674340,20940,3894960,7299960,3405000,0_0_0_0_0_0_0_1_1_0_0_0_0_0_0_0_0_1_1_0_0_0_0_0_0_1_1_0_0_0_0_0_0_1_1_0_0_0_0_0_0_0_1_0_1_0_0_0_1_1_1_1_27_27_27_27_1_27_27_1_27_27_27_27_27_27_27_27_27_27_27_27_27_27_27_27_2_2_2_2_2_2_3_3_3_2_2_3_3_3_2_2_3_3_4_4_15_4_15_4_4_4_4_4_4_4_4_4_4_4_4_4_4
4655,156,1329654180,3,4,3,1329654540,360,2255460,2639280,383820,16_16_16_16_16_16_16_16_16_16_16_1_1_1_16_1_16_16_16_16_16_16_1_1_1_1_16_16_16_16_16_16_16_16_16_16_16_16_16_16_16_16_16_16_16_16_16_16_16_16_16_16_1_1_16_16_16_16_16_16_16_16_1_1_47_47_2_2_2_3_2_3_18_18_18_3_2_2_18_3_2_2_18_2_2_18_3
4656,168,1329654480,2,3,2,1329655380,900,313680,438000,124320,10_10_10_1_10_1_10_10_10_10_1_1_2
4657,63,1329654480,3,3,3,1329895740,241260,2803020,6232860,3429840,16_16_16_16_16_16_16_16_16_0_0_16_16_0_16_16_0_16_16_0_0_16_16_16_0_0_16_0_0_16_0_16_0_0_0_16_1_1_1_16_16_16_0_1_1_1_16_0_0_16_16_0_16_0_16_0_0_2_2_1_1_0_0_0_0_2_2_2_2_2_2_0_1_0_1_1_0_0_0_1_1_0_0_1_1_1_0_0_0_0_0_2_2_2_2_0_0_0_0_0_0_1_1_1_1_0_0_16_0_16_16_16_16_16_0_0_1_1_2_2_1_1_16_0_2_16_2_2_2_0_1_1_1_1_1_16_16_1_1_1_3_3_18_3_18_3_3_3
4658,156,1329654540,3,3,18,1329655740,1200,2255820,2639280,383460,16_16_16_16_16_16_16_16_16_16_16_1_1_1_16_1_16_16_16_16_16_16_1_1_1_1_16_16_16_16_16_16_16_16_16_16_16_16_16_16_16_16_16_16_16_16_16_16_16_16_16_16_1_1_16_16_16_16_16_16_16_16_1_1_47_47_2_2_2_3_2_3_18_18_18_3_2_2_18_3_2_2_18_2_2_18_3_3
4659,158,1329655080,13,17,13,1329659940,4860,1834560,2044680,210120,17_17_17_17_17_17_17_17_17_1_17_1_2_2_3_3_3_13_13_3_13_13_13_13_13_13_5_5_6_6_5_5_13
4660,168,1329655380,2,3,3,1329724080,68700,314580,438000,123420,10_10_10_1_10_1_10_10_10_10_1_1_2_2
4661,156,1329655740,18,23,3,1329659700,3960,2257020,2639280,382260,16_16_16_16_16_16_16_16_16_16_16_1_1_1_16_1_16_16_16_16_16_16_1_1_1_1_16_16_16_16_16_16_16_16_16_16_16_16_16_16_16_16_16_16_16_16_16_16_16_16_16_16_1_1_16_16_16_16_16_16_16_16_1_1_47_47_2_2_2_3_2_3_18_18_18_3_2_2_18_3_2_2_18_2_2_18_3_3_18
4662,163,1329656400,15,18,15,1329660420,4020,544860,548880,4020,17_17_17_1_1_17_17_1_17_1_17_17_17_17_17_17_17_1_1_17_1_1_2_2_15
4663,215,1329656400,5,18,5,1329721620,65220,1729320,1851720,122400,24_24_24_24_24_24_8_8_3_3_3_3_14_14_14_14_2_2_5_5
4664,182,1329656940,2,3,5,1329657060,120,879600,915060,35460,14_14_14_14_14_14_14_14_5_2
4665,182,1329657060,5,9,2,1329661440,4380,879720,915060,35340,14_14_14_14_14_14_14_14_5_2_5
4666,186,1329657240,7,8,7,1329674700,17460,271620,3636240,3364620,7_7_7_7_7_7_7_7_7_1_7_1_7_7_7_1_7_7_1_7_7_7
4667,74,1329657300,5,6,5,1329660060,2760,2858100,2979600,121500,1_1_34_34_5
4668,119,1329657600,5,6,6,1329688800,31200,2707980,2742780,34800,7_7_7_1_1_7_7_7_7_7_7_7_7_7_1_1_2_2_3_3_14_3_3_14_14_14_14_14_14_14_5_5
4669,133,1329659460,5,9,6,1329775200,115740,2868660,6181200,3312540,17_17_17_17_17_17_17_17_17_17_17_17_17_17_17_17_17_17_17_17_17_17_17_17_17_17_17_17_17_17_1_1_17_17_17_17_1_1_1_1_17_17_17_17_17_17_17_17_17_17_17_17_17_17_17_17_17_17_17_17_17_17_19_19_17_17_2_2_3_3_3_3_3_3_5_5
4670,191,1329659520,8,9,8,1329659580,60,20040,1811280,1791240,26_26_26_26_8
4671,151,1329659580,19,11,19,1329661500,1920,1537380,3643800,2106420,19_19_19_19_19_1_1_19_1_1_19_19_19_19_1_19_1_19_19_19_19_19_19_19_19_19_1_19_19_1_1_1_1_1_19_19_19_19_19_19_1_1_19_19_1_1_19_1_1_19_19_19_19_19_19_19_19_19
4672,191,1329659580,8,9,9,1329726240,66660,20100,1811280,1791180,26_26_26_26_8_8
4673,46,1329659640,8,9,8,1329659700,60,240600,2027040,1786440,26_26_26_26_26_26_26_26_8
4674,156,1329659700,3,4,3,1329664200,4500,2260980,2639280,378300,16_16_16_16_16_16_16_16_16_16_16_1_1_1_16_1_16_16_16_16_16_16_1_1_1_1_16_16_16_16_16_16_16_16_16_16_16_16_16_16_16_16_16_16_16_16_16_16_16_16_16_16_1_1_16_16_16_16_16_16_16_16_1_1_47_47_2_2_2_3_2_3_18_18_18_3_2_2_18_3_2_2_18_2_2_18_3_3_18_3
4675,46,1329659700,8,9,9,1329729660,69960,240660,2027040,1786380,26_26_26_26_26_26_26_26_8_8
4676,158,1329659940,13,17,18,1329660000,60,1839420,2044680,205260,17_17_17_17_17_17_17_17_17_1_17_1_2_2_3_3_3_13_13_3_13_13_13_13_13_13_5_5_6_6_5_5_13_13
4677,158,1329660000,18,17,18,1329666660,6660,1839480,2044680,205200,17_17_17_17_17_17_17_17_17_1_17_1_2_2_3_3_3_13_13_3_13_13_13_13_13_13_5_5_6_6_5_5_13_13_18
4678,74,1329660060,5,6,6,1329775200,115140,2860860,2979600,118740,1_1_34_34_5_5
4679,187,1329660180,10,13,10,1329660240,60,9360,2496960,2487600,10_10
4680,213,1329660240,0,0,0,1329661500,1260,623820,3206820,2583000,0_0_0_0_0_1_0_1_0_0_0_0_0_0_0_0_1_1_0_0_0_0_0_0_0_1_1_0_0_0_0_0_0_0_0_0_0_0_0_0_0_1_1_1_0_1_0_0_0_0_0_0
4681,187,1329660240,10,13,10,1329712860,52620,9420,2496960,2487540,10_10_10
4682,163,1329660420,15,18,99,1329660420,0,548880,548880,0,17_17_17_1_1_17_17_1_17_1_17_17_17_17_17_17_17_1_1_17_1_1_2_2_15_15
4683,103,1329661440,13,15,13,1329667980,6540,3860460,4719960,859500,19_19_19_19_19_19_19_1_1_19_19_19_19_1_1_19_19_19_19_19_1_1_2_2_9_2_2_9_9_9_9_9_14_14_14_14_13
4684,182,1329661440,2,3,6,1329688800,27360,884100,915060,30960,14_14_14_14_14_14_14_14_5_2_5_2
4685,213,1329661500,0,1,0,1329687960,26460,625080,3206820,2581740,0_0_0_0_0_1_0_1_0_0_0_0_0_0_0_0_1_1_0_0_0_0_0_0_0_1_1_0_0_0_0_0_0_0_0_0_0_0_0_0_0_1_1_1_0_1_0_0_0_0_0_0_0
4686,151,1329661500,19,1,19,1329675300,13800,1539300,3643800,2104500,19_19_19_19_19_1_1_19_1_1_19_19_19_19_1_19_1_19_19_19_19_19_19_19_19_19_1_19_19_1_1_1_1_1_19_19_19_19_19_19_1_1_19_19_1_1_19_1_1_19_19_19_19_19_19_19_19_19_19
4687,169,1329661740,50,10,50,1329666720,4980,0,2190660,2190660,50
4688,110,1329663720,5,9,5,1329667260,3540,4122120,5579400,1457280,1_1_0_0_1_1_1_1_2_2_2_2_4_4_4_4_4_4_4_4_4_4_4_4_4_4_4_4_4_4_4_4_4_4_4_4_4_4_4_4_4_4_4_4_4_4_4_4_4_4_4_4_5_5_6_6_5_5_5_5_18_18_18_18_18_18_5
4689,156,1329664200,3,3,18,1329667140,2940,2265480,2639280,373800,16_16_16_16_16_16_16_16_16_16_16_1_1_1_16_1_16_16_16_16_16_16_1_1_1_1_16_16_16_16_16_16_16_16_16_16_16_16_16_16_16_16_16_16_16_16_16_16_16_16_16_16_1_1_16_16_16_16_16_16_16_16_1_1_47_47_2_2_2_3_2_3_18_18_18_3_2_2_18_3_2_2_18_2_2_18_3_3_18_3_3
4690,158,1329666660,18,17,13,1329714660,48000,1846140,2044680,198540,17_17_17_17_17_17_17_17_17_1_17_1_2_2_3_3_3_13_13_3_13_13_13_13_13_13_5_5_6_6_5_5_13_13_18_18
4691,169,1329666720,50,10,50,1329674820,8100,4980,2190660,2185680,50_50
4692,156,1329667140,18,23,18,1329667980,840,2268420,2639280,370860,16_16_16_16_16_16_16_16_16_16_16_1_1_1_16_1_16_16_16_16_16_16_1_1_1_1_16_16_16_16_16_16_16_16_16_16_16_16_16_16_16_16_16_16_16_16_16_16_16_16_16_16_1_1_16_16_16_16_16_16_16_16_1_1_47_47_2_2_2_3_2_3_18_18_18_3_2_2_18_3_2_2_18_2_2_18_3_3_18_3_3_18
4693,110,1329667260,5,9,5,1329715080,47820,4125660,5579400,1453740,1_1_0_0_1_1_1_1_2_2_2_2_4_4_4_4_4_4_4_4_4_4_4_4_4_4_4_4_4_4_4_4_4_4_4_4_4_4_4_4_4_4_4_4_4_4_4_4_4_4_4_4_5_5_6_6_5_5_5_5_18_18_18_18_18_18_5_5
4694,131,1329667320,5,2,6,1329688800,21480,3407220,6825900,3418680,16_16_16_16_16_16_16_16_16_16_16_16_16_16_16_16_16_16_16_16_16_16_16_16_16_16_1_1_1_1_2_2_3_3_3_3_18_18_18_18_18_3_3_3_3_18_18_18_18_18_18_18_18_18_18_18_18_18_18_18_18_18_18_18_5_5_5_5_5_5_5_5_5_5_5_5
4695,107,1329667320,16,20,16,1329675240,7920,1740720,4991760,3251040,8_8_8_8_28_28_28_28_28_28_8_8_8_8_16_16_16_16_16_1_16_16_16_1_16_16_16_16_1_16_1_16_16_16_16_16_16_16_1_16_1_16_16_16_16_16_1_1_16_16_16_1_1_16
4696,103,1329667980,13,15,13,1329736800,68820,3867000,4719960,852960,19_19_19_19_19_19_19_1_1_19_19_19_19_1_1_19_19_19_19_19_1_1_2_2_9_2_2_9_9_9_9_9_14_14_14_14_13_13
4697,156,1329667980,18,15,18,1329687840,19860,2269260,2639280,370020,16_16_16_16_16_16_16_16_16_16_16_1_1_1_16_1_16_16_16_16_16_16_1_1_1_1_16_16_16_16_16_16_16_16_16_16_16_16_16_16_16_16_16_16_16_16_16_16_16_16_16_16_1_1_16_16_16_16_16_16_16_16_1_1_47_47_2_2_2_3_2_3_18_18_18_3_2_2_18_3_2_2_18_2_2_18_3_3_18_3_3_18_18
4698,71,1329669960,7,34,32,1329670080,120,3408360,3996240,587880,29_29_1_1_7_7_1_7_1_7_7_7_7_7_1_7_1_7_7_7_7_7_7_1_1_7_7_7_7_7_7_7_7_1_1_7_7_7_7_1_1_1_1_7_7_1_7_1_7_7_7_7_7_7_7_1_7_7_7_1_7_7_7_7_7_7_7_1_7_1_7_7_7_7_7_7_7_1_7_7_7_32_1_32_32_5_5_32_7_7
4699,71,1329670080,32,34,32,1329678000,7920,3408480,3996240,587760,29_29_1_1_7_7_1_7_1_7_7_7_7_7_1_7_1_7_7_7_7_7_7_1_1_7_7_7_7_7_7_7_7_1_1_7_7_7_7_1_1_1_1_7_7_1_7_1_7_7_7_7_7_7_7_1_7_7_7_1_7_7_7_7_7_7_7_1_7_1_7_7_7_7_7_7_7_1_7_7_7_32_1_32_32_5_5_32_7_7_32
4700,142,1329674340,4,5,4,1329679320,4980,3915900,7299960,3384060,0_0_0_0_0_0_0_1_1_0_0_0_0_0_0_0_0_1_1_0_0_0_0_0_0_1_1_0_0_0_0_0_0_1_1_0_0_0_0_0_0_0_1_0_1_0_0_0_1_1_1_1_27_27_27_27_1_27_27_1_27_27_27_27_27_27_27_27_27_27_27_27_27_27_27_27_2_2_2_2_2_2_3_3_3_2_2_3_3_3_2_2_3_3_4_4_15_4_15_4_4_4_4_4_4_4_4_4_4_4_4_4_4_4
4701,186,1329674700,7,12,7,1329690840,16140,289080,3636240,3347160,7_7_7_7_7_7_7_7_7_1_7_1_7_7_7_1_7_7_1_7_7_7_7
4702,169,1329674820,50,12,50,1329700500,25680,13080,2190660,2177580,50_50_50
4703,107,1329675240,16,14,16,1329711360,36120,1748640,4991760,3243120,8_8_8_8_28_28_28_28_28_28_8_8_8_8_16_16_16_16_16_1_16_16_16_1_16_16_16_16_1_16_1_16_16_16_16_16_16_16_1_16_1_16_16_16_16_16_1_1_16_16_16_1_1_16_16
4704,151,1329675300,19,1,19,1329675300,0,1553100,3643800,2090700,19_19_19_19_19_1_1_19_1_1_19_19_19_19_1_19_1_19_19_19_19_19_19_19_19_19_1_19_19_1_1_1_1_1_19_19_19_19_19_19_1_1_19_19_1_1_19_1_1_19_19_19_19_19_19_19_19_19_19_19
4705,151,1329675300,19,14,19,1329711300,36000,1553100,3643800,2090700,19_19_19_19_19_1_1_19_1_1_19_19_19_19_1_19_1_19_19_19_19_19_19_19_19_19_1_19_19_1_1_1_1_1_19_19_19_19_19_19_1_1_19_19_1_1_19_1_1_19_19_19_19_19_19_19_19_19_19_19_19
4706,71,1329678000,32,34,32,1329741120,63120,3416400,3996240,579840,29_29_1_1_7_7_1_7_1_7_7_7_7_7_1_7_1_7_7_7_7_7_7_1_1_7_7_7_7_7_7_7_7_1_1_7_7_7_7_1_1_1_1_7_7_1_7_1_7_7_7_7_7_7_7_1_7_7_7_1_7_7_7_7_7_7_7_1_7_1_7_7_7_7_7_7_7_1_7_7_7_32_1_32_32_5_5_32_7_7_32_32
4707,142,1329679320,4,5,4,1329679380,60,3920880,7299960,3379080,0_0_0_0_0_0_0_1_1_0_0_0_0_0_0_0_0_1_1_0_0_0_0_0_0_1_1_0_0_0_0_0_0_1_1_0_0_0_0_0_0_0_1_0_1_0_0_0_1_1_1_1_27_27_27_27_1_27_27_1_27_27_27_27_27_27_27_27_27_27_27_27_27_27_27_27_2_2_2_2_2_2_3_3_3_2_2_3_3_3_2_2_3_3_4_4_15_4_15_4_4_4_4_4_4_4_4_4_4_4_4_4_4_4_4
4708,142,1329679380,4,5,4,1329713520,34140,3920940,7299960,3379020,0_0_0_0_0_0_0_1_1_0_0_0_0_0_0_0_0_1_1_0_0_0_0_0_0_1_1_0_0_0_0_0_0_1_1_0_0_0_0_0_0_0_1_0_1_0_0_0_1_1_1_1_27_27_27_27_1_27_27_1_27_27_27_27_27_27_27_27_27_27_27_27_27_27_27_27_2_2_2_2_2_2_3_3_3_2_2_3_3_3_2_2_3_3_4_4_15_4_15_4_4_4_4_4_4_4_4_4_4_4_4_4_4_4_4_4
4709,125,1329680520,48,42,48,1329686940,6420,3652680,3969060,316380,16_16_16_16_16_16_1_1_2_2_1_1_3_3_48
4710,125,1329686940,48,42,5,1329721200,34260,3659100,3969060,309960,16_16_16_16_16_16_1_1_2_2_1_1_3_3_48_48
4711,156,1329687840,18,15,18,1329688620,780,2289120,2639280,350160,16_16_16_16_16_16_16_16_16_16_16_1_1_1_16_1_16_16_16_16_16_16_1_1_1_1_16_16_16_16_16_16_16_16_16_16_16_16_16_16_16_16_16_16_16_16_16_16_16_16_16_16_1_1_16_16_16_16_16_16_16_16_1_1_47_47_2_2_2_3_2_3_18_18_18_3_2_2_18_3_2_2_18_2_2_18_3_3_18_3_3_18_18_18
4712,213,1329687960,0,1,0,1329688020,60,651540,3206820,2555280,0_0_0_0_0_1_0_1_0_0_0_0_0_0_0_0_1_1_0_0_0_0_0_0_0_1_1_0_0_0_0_0_0_0_0_0_0_0_0_0_0_1_1_1_0_1_0_0_0_0_0_0_0_0
4713,213,1329688020,0,14,0,1329711360,23340,651600,3206820,2555220,0_0_0_0_0_1_0_1_0_0_0_0_0_0_0_0_1_1_0_0_0_0_0_0_0_1_1_0_0_0_0_0_0_0_0_0_0_0_0_0_0_1_1_1_0_1_0_0_0_0_0_0_0_0_0
4714,156,1329688620,18,5,18,1329713520,24900,2289900,2639280,349380,16_16_16_16_16_16_16_16_16_16_16_1_1_1_16_1_16_16_16_16_16_16_1_1_1_1_16_16_16_16_16_16_16_16_16_16_16_16_16_16_16_16_16_16_16_16_16_16_16_16_16_16_1_1_16_16_16_16_16_16_16_16_1_1_47_47_2_2_2_3_2_3_18_18_18_3_2_2_18_3_2_2_18_2_2_18_3_3_18_3_3_18_18_18_18
4715,69,1329688800,3,4,3,1329693300,4500,1774860,2073180,298320,16_16_1_1_0_0_1_1_2_2_3
4716,131,1329688800,6,7,6,1329692400,3600,3428700,6825900,3397200,16_16_16_16_16_16_16_16_16_16_16_16_16_16_16_16_16_16_16_16_16_16_16_16_16_16_1_1_1_1_2_2_3_3_3_3_18_18_18_18_18_3_3_3_3_18_18_18_18_18_18_18_18_18_18_18_18_18_18_18_18_18_18_18_5_5_5_5_5_5_5_5_5_5_5_5_6
4717,119,1329688800,6,7,6,1329692400,3600,2739180,2742780,3600,7_7_7_1_1_7_7_7_7_7_7_7_7_7_1_1_2_2_3_3_14_3_3_14_14_14_14_14_14_14_5_5_6
4718,182,1329688800,6,7,6,1329692400,3600,911460,915060,3600,14_14_14_14_14_14_14_14_5_2_5_2_6
4719,141,1329688800,6,7,6,1329692400,3600,4035600,7406100,3370500,1_1_16_16_16_16_16_1_16_16_1_1_1_16_16_16_16_16_16_16_16_16_16_16_16_16_16_16_1_1_1_1_1_1_1_1_1_1_1_1_16_2_2_16_3_3_3_3_3_3_18_18_18_18_18_3_18_3_3_3_5_5_5_5_5_5_3_3_4_4_4_4_4_3_1_3_1_4_18_3_3_18_18_1_1_18_18_5_5_18_5_5_5_5_6_6_5_5_6_6_6_6_5_5_5_5_5_5_5_5_6
4720,186,1329690840,7,12,7,1329714000,23160,305220,3636240,3331020,7_7_7_7_7_7_7_7_7_1_7_1_7_7_7_1_7_7_1_7_7_7_7_7
4721,119,1329692400,6,7,99,1329692400,0,2742780,2742780,0,7_7_7_1_1_7_7_7_7_7_7_7_7_7_1_1_2_2_3_3_14_3_3_14_14_14_14_14_14_14_5_5_6_6
4722,182,1329692400,6,7,99,1329692400,0,915060,915060,0,14_14_14_14_14_14_14_14_5_2_5_2_6_6
4723,131,1329692400,6,7,5,1329714000,21600,3432300,6825900,3393600,16_16_16_16_16_16_16_16_16_16_16_16_16_16_16_16_16_16_16_16_16_16_16_16_16_16_1_1_1_1_2_2_3_3_3_3_18_18_18_18_18_3_3_3_3_18_18_18_18_18_18_18_18_18_18_18_18_18_18_18_18_18_18_18_5_5_5_5_5_5_5_5_5_5_5_5_6_6
4724,141,1329692400,6,7,5,1329909600,217200,4039200,7406100,3366900,1_1_16_16_16_16_16_1_16_16_1_1_1_16_16_16_16_16_16_16_16_16_16_16_16_16_16_16_1_1_1_1_1_1_1_1_1_1_1_1_16_2_2_16_3_3_3_3_3_3_18_18_18_18_18_3_18_3_3_3_5_5_5_5_5_5_3_3_4_4_4_4_4_3_1_3_1_4_18_3_3_18_18_1_1_18_18_5_5_18_5_5_5_5_6_6_5_5_6_6_6_6_5_5_5_5_5_5_5_5_6_6
4725,69,1329693300,3,4,3,1329744060,50760,1779360,2073180,293820,16_16_1_1_0_0_1_1_2_2_3_3
4726,169,1329700500,50,12,50,1329713400,12900,38760,2190660,2151900,50_50_50_50_50
4727,169,1329700500,50,12,50,1329700500,0,38760,2190660,2151900,50_50_50_50
4728,151,1329711300,19,14,19,1329716880,5580,1589100,3643800,2054700,19_19_19_19_19_1_1_19_1_1_19_19_19_19_1_19_1_19_19_19_19_19_19_19_19_19_1_19_19_1_1_1_1_1_19_19_19_19_19_19_1_1_19_19_1_1_19_1_1_19_19_19_19_19_19_19_19_19_19_19_19_19
4729,213,1329711360,0,14,1,1329713400,2040,674940,3206820,2531880,0_0_0_0_0_1_0_1_0_0_0_0_0_0_0_0_1_1_0_0_0_0_0_0_0_1_1_0_0_0_0_0_0_0_0_0_0_0_0_0_0_1_1_1_0_1_0_0_0_0_0_0_0_0_0_0
4730,107,1329711360,16,14,16,1329714000,2640,1784760,4991760,3207000,8_8_8_8_28_28_28_28_28_28_8_8_8_8_16_16_16_16_16_1_16_16_16_1_16_16_16_16_1_16_1_16_16_16_16_16_16_16_1_16_1_16_16_16_16_16_1_1_16_16_16_1_1_16_16_16
4731,187,1329712860,10,13,10,1329712920,60,62040,2496960,2434920,10_10_10_10
4732,187,1329712920,10,13,10,1329735540,22620,62100,2496960,2434860,10_10_10_10_10
4733,169,1329713400,50,12,50,1329714420,1020,51660,2190660,2139000,50_50_50_50_50_50
4734,213,1329713400,1,9,0,1329714000,600,676980,3206820,2529840,0_0_0_0_0_1_0_1_0_0_0_0_0_0_0_0_1_1_0_0_0_0_0_0_0_1_1_0_0_0_0_0_0_0_0_0_0_0_0_0_0_1_1_1_0_1_0_0_0_0_0_0_0_0_0_0_1
4735,142,1329713520,4,5,4,1329714000,480,3955080,7299960,3344880,0_0_0_0_0_0_0_1_1_0_0_0_0_0_0_0_0_1_1_0_0_0_0_0_0_1_1_0_0_0_0_0_0_1_1_0_0_0_0_0_0_0_1_0_1_0_0_0_1_1_1_1_27_27_27_27_1_27_27_1_27_27_27_27_27_27_27_27_27_27_27_27_27_27_27_27_2_2_2_2_2_2_3_3_3_2_2_3_3_3_2_2_3_3_4_4_15_4_15_4_4_4_4_4_4_4_4_4_4_4_4_4_4_4_4_4_4
4736,156,1329713520,18,5,5,1329714120,600,2314800,2639280,324480,16_16_16_16_16_16_16_16_16_16_16_1_1_1_16_1_16_16_16_16_16_16_1_1_1_1_16_16_16_16_16_16_16_16_16_16_16_16_16_16_16_16_16_16_16_16_16_16_16_16_16_16_1_1_16_16_16_16_16_16_16_16_1_1_47_47_2_2_2_3_2_3_18_18_18_3_2_2_18_3_2_2_18_2_2_18_3_3_18_3_3_18_18_18_18_18
4737,186,1329714000,7,8,1,1329738480,24480,328380,3636240,3307860,7_7_7_7_7_7_7_7_7_1_7_1_7_7_7_1_7_7_1_7_7_7_7_7_7
4738,107,1329714000,16,20,16,1329750000,36000,1787400,4991760,3204360,8_8_8_8_28_28_28_28_28_28_8_8_8_8_16_16_16_16_16_1_16_16_16_1_16_16_16_16_1_16_1_16_16_16_16_16_16_16_1_16_1_16_16_16_16_16_1_1_16_16_16_1_1_16_16_16_16
4739,213,1329714000,0,0,1,1329715020,1020,677580,3206820,2529240,0_0_0_0_0_1_0_1_0_0_0_0_0_0_0_0_1_1_0_0_0_0_0_0_0_1_1_0_0_0_0_0_0_0_0_0_0_0_0_0_0_1_1_1_0_1_0_0_0_0_0_0_0_0_0_0_1_0
4740,142,1329714000,4,22,4,1329714120,120,3955560,7299960,3344400,0_0_0_0_0_0_0_1_1_0_0_0_0_0_0_0_0_1_1_0_0_0_0_0_0_1_1_0_0_0_0_0_0_1_1_0_0_0_0_0_0_0_1_0_1_0_0_0_1_1_1_1_27_27_27_27_1_27_27_1_27_27_27_27_27_27_27_27_27_27_27_27_27_27_27_27_2_2_2_2_2_2_3_3_3_2_2_3_3_3_2_2_3_3_4_4_15_4_15_4_4_4_4_4_4_4_4_4_4_4_4_4_4_4_4_4_4_4
4741,131,1329714000,5,2,5,1329720000,6000,3453900,6825900,3372000,16_16_16_16_16_16_16_16_16_16_16_16_16_16_16_16_16_16_16_16_16_16_16_16_16_16_1_1_1_1_2_2_3_3_3_3_18_18_18_18_18_3_3_3_3_18_18_18_18_18_18_18_18_18_18_18_18_18_18_18_18_18_18_18_5_5_5_5_5_5_5_5_5_5_5_5_6_6_5
4742,156,1329714120,5,6,18,1329714480,360,2315400,2639280,323880,16_16_16_16_16_16_16_16_16_16_16_1_1_1_16_1_16_16_16_16_16_16_1_1_1_1_16_16_16_16_16_16_16_16_16_16_16_16_16_16_16_16_16_16_16_16_16_16_16_16_16_16_1_1_16_16_16_16_16_16_16_16_1_1_47_47_2_2_2_3_2_3_18_18_18_3_2_2_18_3_2_2_18_2_2_18_3_3_18_3_3_18_18_18_18_18_5
4743,142,1329714120,4,22,4,1329744420,30300,3955680,7299960,3344280,0_0_0_0_0_0_0_1_1_0_0_0_0_0_0_0_0_1_1_0_0_0_0_0_0_1_1_0_0_0_0_0_0_1_1_0_0_0_0_0_0_0_1_0_1_0_0_0_1_1_1_1_27_27_27_27_1_27_27_1_27_27_27_27_27_27_27_27_27_27_27_27_27_27_27_27_2_2_2_2_2_2_3_3_3_2_2_3_3_3_2_2_3_3_4_4_15_4_15_4_4_4_4_4_4_4_4_4_4_4_4_4_4_4_4_4_4_4_4
4744,169,1329714420,50,10,50,1329730560,16140,52680,2190660,2137980,50_50_50_50_50_50_50
4745,156,1329714480,18,23,18,1329739500,25020,2315760,2639280,323520,16_16_16_16_16_16_16_16_16_16_16_1_1_1_16_1_16_16_16_16_16_16_1_1_1_1_16_16_16_16_16_16_16_16_16_16_16_16_16_16_16_16_16_16_16_16_16_16_16_16_16_16_1_1_16_16_16_16_16_16_16_16_1_1_47_47_2_2_2_3_2_3_18_18_18_3_2_2_18_3_2_2_18_2_2_18_3_3_18_3_3_18_18_18_18_18_5_18
4746,158,1329714660,13,17,13,1329727320,12660,1894140,2044680,150540,17_17_17_17_17_17_17_17_17_1_17_1_2_2_3_3_3_13_13_3_13_13_13_13_13_13_5_5_6_6_5_5_13_13_18_18_13
4747,90,1329714660,19,11,19,1329738600,23940,0,1532940,1532940,19
4748,213,1329715020,1,9,0,1329746220,31200,678600,3206820,2528220,0_0_0_0_0_1_0_1_0_0_0_0_0_0_0_0_1_1_0_0_0_0_0_0_0_1_1_0_0_0_0_0_0_0_0_0_0_0_0_0_0_1_1_1_0_1_0_0_0_0_0_0_0_0_0_0_1_0_1
4749,110,1329715080,5,9,5,1329744780,29700,4173480,5579400,1405920,1_1_0_0_1_1_1_1_2_2_2_2_4_4_4_4_4_4_4_4_4_4_4_4_4_4_4_4_4_4_4_4_4_4_4_4_4_4_4_4_4_4_4_4_4_4_4_4_4_4_4_4_5_5_6_6_5_5_5_5_18_18_18_18_18_18_5_5_5
4750,151,1329716880,19,11,19,1329716940,60,1594680,3643800,2049120,19_19_19_19_19_1_1_19_1_1_19_19_19_19_1_19_1_19_19_19_19_19_19_19_19_19_1_19_19_1_1_1_1_1_19_19_19_19_19_19_1_1_19_19_1_1_19_1_1_19_19_19_19_19_19_19_19_19_19_19_19_19_19
4751,151,1329716940,1,9,1,1329717000,60,1594740,3643800,2049060,19_19_19_19_19_1_1_19_1_1_19_19_19_19_1_19_1_19_19_19_19_19_19_19_19_19_1_19_19_1_1_1_1_1_19_19_19_19_19_19_1_1_19_19_1_1_19_1_1_19_19_19_19_19_19_19_19_19_19_19_19_19_19_19_1
4752,151,1329716940,19,11,1,1329716940,0,1594740,3643800,2049060,19_19_19_19_19_1_1_19_1_1_19_19_19_19_1_19_1_19_19_19_19_19_19_19_19_19_1_19_19_1_1_1_1_1_19_19_19_19_19_19_1_1_19_19_1_1_19_1_1_19_19_19_19_19_19_19_19_19_19_19_19_19_19_19
4753,151,1329717000,1,9,47,1330942380,1225380,1594800,3643800,2049000,19_19_19_19_19_1_1_19_1_1_19_19_19_19_1_19_1_19_19_19_19_19_19_19_19_19_1_19_19_1_1_1_1_1_19_19_19_19_19_19_1_1_19_19_1_1_19_1_1_19_19_19_19_19_19_19_19_19_19_19_19_19_19_19_1_1
4754,86,1329719040,4,22,4,1329719100,60,3373020,3519180,146160,0_0_0_0_1_0_0_0_0_1_0_0_0_0_1_1_0_0_1_1_1_1_1_1_2_2_4_4_4_4_4_4_4_4_4_4_18_18_18_18_1_18_1_18_18_18_5_5_5_5_4
4755,86,1329719100,4,22,4,1329719160,60,3373080,3519180,146100,0_0_0_0_1_0_0_0_0_1_0_0_0_0_1_1_0_0_1_1_1_1_1_1_2_2_4_4_4_4_4_4_4_4_4_4_18_18_18_18_1_18_1_18_18_18_5_5_5_5_4_4_4
4756,86,1329719100,4,22,4,1329719100,0,3373080,3519180,146100,0_0_0_0_1_0_0_0_0_1_0_0_0_0_1_1_0_0_1_1_1_1_1_1_2_2_4_4_4_4_4_4_4_4_4_4_18_18_18_18_1_18_1_18_18_18_5_5_5_5_4_4
4757,86,1329719160,5,9,5,1329723660,4500,3373140,3519180,146040,0_0_0_0_1_0_0_0_0_1_0_0_0_0_1_1_0_0_1_1_1_1_1_1_2_2_4_4_4_4_4_4_4_4_4_4_18_18_18_18_1_18_1_18_18_18_5_5_5_5_4_4_4_4_5
4758,86,1329719160,4,22,5,1329719160,0,3373140,3519180,146040,0_0_0_0_1_0_0_0_0_1_0_0_0_0_1_1_0_0_1_1_1_1_1_1_2_2_4_4_4_4_4_4_4_4_4_4_18_18_18_18_1_18_1_18_18_18_5_5_5_5_4_4_4_4
4759,131,1329720000,5,2,6,1329775200,55200,3459900,6825900,3366000,16_16_16_16_16_16_16_16_16_16_16_16_16_16_16_16_16_16_16_16_16_16_16_16_16_16_1_1_1_1_2_2_3_3_3_3_18_18_18_18_18_3_3_3_3_18_18_18_18_18_18_18_18_18_18_18_18_18_18_18_18_18_18_18_5_5_5_5_5_5_5_5_5_5_5_5_6_6_5_5
4760,125,1329721200,5,2,5,1329735000,13800,3693360,3969060,275700,16_16_16_16_16_16_1_1_2_2_1_1_3_3_48_48_5
4761,215,1329721620,5,9,5,1329721680,60,1794540,1851720,57180,24_24_24_24_24_24_8_8_3_3_3_3_14_14_14_14_2_2_5_5_5
4762,215,1329721680,5,9,6,1329775200,53520,1794600,1851720,57120,24_24_24_24_24_24_8_8_3_3_3_3_14_14_14_14_2_2_5_5_5_5
4763,86,1329723660,5,9,6,1329861600,137940,3377640,3519180,141540,0_0_0_0_1_0_0_0_0_1_0_0_0_0_1_1_0_0_1_1_1_1_1_1_2_2_4_4_4_4_4_4_4_4_4_4_18_18_18_18_1_18_1_18_18_18_5_5_5_5_4_4_4_4_5_5
4764,168,1329724080,3,3,3,1329726240,2160,383280,438000,54720,10_10_10_1_10_1_10_10_10_10_1_1_2_2_3
4765,180,1329724140,2,4,2,1329727080,2940,933720,3322080,2388360,50_50_50_50_50_50_1_50_1_50_50_50_50_50_50_50_50_50_1_1_2
4766,191,1329726240,9,3,9,1329729660,3420,86760,1811280,1724520,26_26_26_26_8_8_9
4767,168,1329726240,3,3,5,1329729060,2820,385440,438000,52560,10_10_10_1_10_1_10_10_10_10_1_1_2_2_3_3
4768,180,1329727080,2,4,9,1329775200,48120,936660,3322080,2385420,50_50_50_50_50_50_1_50_1_50_50_50_50_50_50_50_50_50_1_1_2_2
4769,158,1329727320,13,17,5,1329815220,87900,1906800,2044680,137880,17_17_17_17_17_17_17_17_17_1_17_1_2_2_3_3_3_13_13_3_13_13_13_13_13_13_5_5_6_6_5_5_13_13_18_18_13_13
4770,62,1329727500,11,17,11,1329735000,7500,3426360,3674460,248100,34_34_5_5_6_6_11
4771,168,1329729060,5,9,5,1329732660,3600,388260,438000,49740,10_10_10_1_10_1_10_10_10_10_1_1_2_2_3_3_5
4772,191,1329729660,9,3,3,1330595460,865800,90180,1811280,1721100,26_26_26_26_8_8_9_9
4773,46,1329729660,9,3,9,1329752340,22680,310620,2027040,1716420,26_26_26_26_26_26_26_26_8_8_9
4774,85,1329729720,2,3,3,1329729840,120,556500,778380,221880,19_19_19_19_19_19_19_19_19_19_19_19_1_1_2
4775,85,1329729840,3,3,2,1329734220,4380,556620,778380,221760,19_19_19_19_19_19_19_19_19_19_19_19_1_1_2_3
4776,169,1329730560,50,10,50,1329737520,6960,68820,2190660,2121840,50_50_50_50_50_50_50_50
4777,168,1329732660,5,9,6,1329775200,42540,391860,438000,46140,10_10_10_1_10_1_10_10_10_10_1_1_2_2_3_3_5_5
4778,85,1329734220,2,3,3,1329752340,18120,561000,778380,217380,19_19_19_19_19_19_19_19_19_19_19_19_1_1_2_3_2
4779,62,1329735000,11,17,5,1329894000,159000,3433860,3674460,240600,34_34_5_5_6_6_11_11
4780,125,1329735000,5,2,5,1329800400,65400,3707160,3969060,261900,16_16_16_16_16_16_1_1_2_2_1_1_3_3_48_48_5_5
4781,187,1329735540,10,13,10,1329735600,60,84720,2496960,2412240,10_10_10_10_10_10
4782,187,1329735600,10,13,10,1329744900,9300,84780,2496960,2412180,10_10_10_10_10_10_10
4783,103,1329736800,13,17,13,1329739200,2400,3935820,4719960,784140,19_19_19_19_19_19_19_1_1_19_19_19_19_1_1_19_19_19_19_19_1_1_2_2_9_2_2_9_9_9_9_9_14_14_14_14_13_13_13
4784,98,1329736800,5,2,5,1329747060,10260,3997380,7319880,3322500,34_34_2_2_35_35_34_34_2_2_3_3_3_3_3_3_18_18_3_3_3_18_3_3_3_18_18_18_18_3_3_18_18_18_18_18_18_18_18_3_3_18_39_3_3_39_3_3_3_3_4_4_5_5_5_5_5_5_4_4_4_5_3_5_5_3_5_4_4_4_5_5_5_5_6_6_6_6_5_5_5_5_5_5_5_5_5_5_5_5_6_6_5_5_34_34_6_6_5_5_5
4785,169,1329737520,50,10,50,1329753600,16080,75780,2190660,2114880,50_50_50_50_50_50_50_50_50
4786,186,1329738480,1,6,7,1329744420,5940,352860,3636240,3283380,7_7_7_7_7_7_7_7_7_1_7_1_7_7_7_1_7_7_1_7_7_7_7_7_7_1
4787,90,1329738600,19,11,19,1329745860,7260,23940,1532940,1509000,19_19_19
4788,90,1329738600,19,11,19,1329738600,0,23940,1532940,1509000,19_19
4789,103,1329739200,13,17,14,1329746940,7740,3938220,4719960,781740,19_19_19_19_19_19_19_1_1_19_19_19_19_1_1_19_19_19_19_19_1_1_2_2_9_2_2_9_9_9_9_9_14_14_14_14_13_13_13_13_13
4790,103,1329739200,13,17,13,1329739200,0,3938220,4719960,781740,19_19_19_19_19_19_19_1_1_19_19_19_19_1_1_19_19_19_19_19_1_1_2_2_9_2_2_9_9_9_9_9_14_14_14_14_13_13_13_13
4791,156,1329739500,18,23,18,1329739560,60,2340780,2639280,298500,16_16_16_16_16_16_16_16_16_16_16_1_1_1_16_1_16_16_16_16_16_16_1_1_1_1_16_16_16_16_16_16_16_16_16_16_16_16_16_16_16_16_16_16_16_16_16_16_16_16_16_16_1_1_16_16_16_16_16_16_16_16_1_1_47_47_2_2_2_3_2_3_18_18_18_3_2_2_18_3_2_2_18_2_2_18_3_3_18_3_3_18_18_18_18_18_5_18_18
4792,156,1329739560,18,23,5,1329740100,540,2340840,2639280,298440,16_16_16_16_16_16_16_16_16_16_16_1_1_1_16_1_16_16_16_16_16_16_1_1_1_1_16_16_16_16_16_16_16_16_16_16_16_16_16_16_16_16_16_16_16_16_16_16_16_16_16_16_1_1_16_16_16_16_16_16_16_16_1_1_47_47_2_2_2_3_2_3_18_18_18_3_2_2_18_3_2_2_18_2_2_18_3_3_18_3_3_18_18_18_18_18_5_18_18_18
4793,156,1329740100,5,6,18,1329745800,5700,2341380,2639280,297900,16_16_16_16_16_16_16_16_16_16_16_1_1_1_16_1_16_16_16_16_16_16_1_1_1_1_16_16_16_16_16_16_16_16_16_16_16_16_16_16_16_16_16_16_16_16_16_16_16_16_16_16_1_1_16_16_16_16_16_16_16_16_1_1_47_47_2_2_2_3_2_3_18_18_18_3_2_2_18_3_2_2_18_2_2_18_3_3_18_3_3_18_18_18_18_18_5_18_18_18_5
4794,71,1329741120,32,34,32,1329746760,5640,3479520,3996240,516720,29_29_1_1_7_7_1_7_1_7_7_7_7_7_1_7_1_7_7_7_7_7_7_1_1_7_7_7_7_7_7_7_7_1_1_7_7_7_7_1_1_1_1_7_7_1_7_1_7_7_7_7_7_7_7_1_7_7_7_1_7_7_7_7_7_7_7_1_7_1_7_7_7_7_7_7_7_1_7_7_7_32_1_32_32_5_5_32_7_7_32_32_32
4795,69,1329744060,3,4,3,1329746340,2280,1830120,2073180,243060,16_16_1_1_0_0_1_1_2_2_3_3_3
4796,142,1329744420,4,22,4,1329761460,17040,3985980,7299960,3313980,0_0_0_0_0_0_0_1_1_0_0_0_0_0_0_0_0_1_1_0_0_0_0_0_0_1_1_0_0_0_0_0_0_1_1_0_0_0_0_0_0_0_1_0_1_0_0_0_1_1_1_1_27_27_27_27_1_27_27_1_27_27_27_27_27_27_27_27_27_27_27_27_27_27_27_27_2_2_2_2_2_2_3_3_3_2_2_3_3_3_2_2_3_3_4_4_15_4_15_4_4_4_4_4_4_4_4_4_4_4_4_4_4_4_4_4_4_4_4_4
4797,186,1329744420,7,8,1,1329749340,4920,358800,3636240,3277440,7_7_7_7_7_7_7_7_7_1_7_1_7_7_7_1_7_7_1_7_7_7_7_7_7_1_7
4798,110,1329744780,5,9,5,1329744840,60,4203180,5579400,1376220,1_1_0_0_1_1_1_1_2_2_2_2_4_4_4_4_4_4_4_4_4_4_4_4_4_4_4_4_4_4_4_4_4_4_4_4_4_4_4_4_4_4_4_4_4_4_4_4_4_4_4_4_5_5_6_6_5_5_5_5_18_18_18_18_18_18_5_5_5_5
4799,110,1329744840,5,9,5,1329744900,60,4203240,5579400,1376160,1_1_0_0_1_1_1_1_2_2_2_2_4_4_4_4_4_4_4_4_4_4_4_4_4_4_4_4_4_4_4_4_4_4_4_4_4_4_4_4_4_4_4_4_4_4_4_4_4_4_4_4_5_5_6_6_5_5_5_5_18_18_18_18_18_18_5_5_5_5_5
4800,187,1329744900,10,13,10,1329744960,60,94080,2496960,2402880,10_10_10_10_10_10_10_10
4801,110,1329744900,5,9,6,1329775200,30300,4203300,5579400,1376100,1_1_0_0_1_1_1_1_2_2_2_2_4_4_4_4_4_4_4_4_4_4_4_4_4_4_4_4_4_4_4_4_4_4_4_4_4_4_4_4_4_4_4_4_4_4_4_4_4_4_4_4_5_5_6_6_5_5_5_5_18_18_18_18_18_18_5_5_5_5_5_5
4802,187,1329744960,10,13,10,1329750420,5460,94140,2496960,2402820,10_10_10_10_10_10_10_10_10
4803,156,1329745800,18,23,18,1329746700,900,2347080,2639280,292200,16_16_16_16_16_16_16_16_16_16_16_1_1_1_16_1_16_16_16_16_16_16_1_1_1_1_16_16_16_16_16_16_16_16_16_16_16_16_16_16_16_16_16_16_16_16_16_16_16_16_16_16_1_1_16_16_16_16_16_16_16_16_1_1_47_47_2_2_2_3_2_3_18_18_18_3_2_2_18_3_2_2_18_2_2_18_3_3_18_3_3_18_18_18_18_18_5_18_18_18_5_18
4804,90,1329745860,19,11,19,1329746340,480,31200,1532940,1501740,19_19_19_19
4805,130,1329745980,5,6,5,1329753240,7260,3022320,3083940,61620,26_26_26_26_26_26_8_8_26_26_26_26_26_26_26_26_26_26_26_8_26_8_17_17_1_1_17_1_17_17_1_17_17_17_17_17_17_17_17_1_17_17_1_17_17_1_17_1_17_17_1_17_1_3_3_1_1_17_17_17_18_17_1_18_4_18_1_4_4_18_18_3_17_1_3_1_15_4_4_3_3_18_15_18_4_18_4_4_15_4_18_18_4_15_4_4_4_4_4_4_15_15_15_15_15_15_15_15_2_15_2_15_15_15_2_2_5_5_5
4806,213,1329746220,0,0,0,1329746280,60,709800,3206820,2497020,0_0_0_0_0_1_0_1_0_0_0_0_0_0_0_0_1_1_0_0_0_0_0_0_0_1_1_0_0_0_0_0_0_0_0_0_0_0_0_0_0_1_1_1_0_1_0_0_0_0_0_0_0_0_0_0_1_0_1_0
4807,213,1329746280,0,1,0,1329774300,28020,709860,3206820,2496960,0_0_0_0_0_1_0_1_0_0_0_0_0_0_0_0_1_1_0_0_0_0_0_0_0_1_1_0_0_0_0_0_0_0_0_0_0_0_0_0_0_1_1_1_0_1_0_0_0_0_0_0_0_0_0_0_1_0_1_0_0
4808,90,1329746340,19,1,19,1329762360,16020,31680,1532940,1501260,19_19_19_19_19
4809,69,1329746340,3,4,4,1329816600,70260,1832400,2073180,240780,16_16_1_1_0_0_1_1_2_2_3_3_3_3
4810,156,1329746700,18,22,18,1329753000,6300,2347980,2639280,291300,16_16_16_16_16_16_16_16_16_16_16_1_1_1_16_1_16_16_16_16_16_16_1_1_1_1_16_16_16_16_16_16_16_16_16_16_16_16_16_16_16_16_16_16_16_16_16_16_16_16_16_16_1_1_16_16_16_16_16_16_16_16_1_1_47_47_2_2_2_3_2_3_18_18_18_3_2_2_18_3_2_2_18_2_2_18_3_3_18_3_3_18_18_18_18_18_5_18_18_18_5_18_18
4811,71,1329746760,32,34,32,1329768420,21660,3485160,3996240,511080,29_29_1_1_7_7_1_7_1_7_7_7_7_7_1_7_1_7_7_7_7_7_7_1_1_7_7_7_7_7_7_7_7_1_1_7_7_7_7_1_1_1_1_7_7_1_7_1_7_7_7_7_7_7_7_1_7_7_7_1_7_7_7_7_7_7_7_1_7_1_7_7_7_7_7_7_7_1_7_7_7_32_1_32_32_5_5_32_7_7_32_32_32_32
4812,103,1329746940,14,15,13,1329752700,5760,3945960,4719960,774000,19_19_19_19_19_19_19_1_1_19_19_19_19_1_1_19_19_19_19_19_1_1_2_2_9_2_2_9_9_9_9_9_14_14_14_14_13_13_13_13_13_14
4813,98,1329747060,5,2,5,1329813900,66840,4007640,7319880,3312240,34_34_2_2_35_35_34_34_2_2_3_3_3_3_3_3_18_18_3_3_3_18_3_3_3_18_18_18_18_3_3_18_18_18_18_18_18_18_18_3_3_18_39_3_3_39_3_3_3_3_4_4_5_5_5_5_5_5_4_4_4_5_3_5_5_3_5_4_4_4_5_5_5_5_6_6_6_6_5_5_5_5_5_5_5_5_5_5_5_5_6_6_5_5_34_34_6_6_5_5_5_5
4814,186,1329749340,1,6,1,1329749520,180,363720,3636240,3272520,7_7_7_7_7_7_7_7_7_1_7_1_7_7_7_1_7_7_1_7_7_7_7_7_7_1_7_1
4815,186,1329749520,1,6,1,1329749640,120,363900,3636240,3272340,7_7_7_7_7_7_7_7_7_1_7_1_7_7_7_1_7_7_1_7_7_7_7_7_7_1_7_1_1
4816,186,1329749640,38,46,1,1329749700,60,364020,3636240,3272220,7_7_7_7_7_7_7_7_7_1_7_1_7_7_7_1_7_7_1_7_7_7_7_7_7_1_7_1_1_1_38_38
4817,186,1329749640,38,46,38,1329749640,0,364020,3636240,3272220,7_7_7_7_7_7_7_7_7_1_7_1_7_7_7_1_7_7_1_7_7_7_7_7_7_1_7_1_1_1_38
4818,186,1329749640,1,6,38,1329749640,0,364020,3636240,3272220,7_7_7_7_7_7_7_7_7_1_7_1_7_7_7_1_7_7_1_7_7_7_7_7_7_1_7_1_1_1
4819,186,1329749700,1,6,1,1329754140,4440,364080,3636240,3272160,7_7_7_7_7_7_7_7_7_1_7_1_7_7_7_1_7_7_1_7_7_7_7_7_7_1_7_1_1_1_38_38_1
4820,107,1329750000,16,20,16,1329762300,12300,1823400,4991760,3168360,8_8_8_8_28_28_28_28_28_28_8_8_8_8_16_16_16_16_16_1_16_16_16_1_16_16_16_16_1_16_1_16_16_16_16_16_16_16_1_16_1_16_16_16_16_16_1_1_16_16_16_1_1_16_16_16_16_16
4821,187,1329750420,10,13,10,1329818940,68520,99600,2496960,2397360,10_10_10_10_10_10_10_10_10_10
4822,2,1329750540,10,13,10,1329753420,2880,0,2555640,2555640,10
4823,85,1329752340,3,3,5,1329819300,66960,579120,778380,199260,19_19_19_19_19_19_19_19_19_19_19_19_1_1_2_3_2_3
4824,46,1329752340,9,3,3,1330603080,850740,333300,2027040,1693740,26_26_26_26_26_26_26_26_8_8_9_9
4825,103,1329752700,13,17,14,1329756180,3480,3951720,4719960,768240,19_19_19_19_19_19_19_1_1_19_19_19_19_1_1_19_19_19_19_19_1_1_2_2_9_2_2_9_9_9_9_9_14_14_14_14_13_13_13_13_13_14_13
4826,156,1329753000,18,22,18,1329756180,3180,2354280,2639280,285000,16_16_16_16_16_16_16_16_16_16_16_1_1_1_16_1_16_16_16_16_16_16_1_1_1_1_16_16_16_16_16_16_16_16_16_16_16_16_16_16_16_16_16_16_16_16_16_16_16_16_16_16_1_1_16_16_16_16_16_16_16_16_1_1_47_47_2_2_2_3_2_3_18_18_18_3_2_2_18_3_2_2_18_2_2_18_3_3_18_3_3_18_18_18_18_18_5_18_18_18_5_18_18_18
4827,130,1329753240,5,6,6,1329775200,21960,3029580,3083940,54360,26_26_26_26_26_26_8_8_26_26_26_26_26_26_26_26_26_26_26_8_26_8_17_17_1_1_17_1_17_17_1_17_17_17_17_17_17_17_17_1_17_17_1_17_17_1_17_1_17_17_1_17_1_3_3_1_1_17_17_17_18_17_1_18_4_18_1_4_4_18_18_3_17_1_3_1_15_4_4_3_3_18_15_18_4_18_4_4_15_4_18_18_4_15_4_4_4_4_4_4_15_15_15_15_15_15_15_15_2_15_2_15_15_15_2_2_5_5_5_5
4828,2,1329753420,10,13,10,1329771420,18000,2880,2555640,2552760,10_10
4829,169,1329753600,50,10,50,1329763140,9540,91860,2190660,2098800,50_50_50_50_50_50_50_50_50_50
4830,186,1329754140,1,6,24,1331724960,1970820,368520,3636240,3267720,7_7_7_7_7_7_7_7_7_1_7_1_7_7_7_1_7_7_1_7_7_7_7_7_7_1_7_1_1_1_38_38_1_1
4831,103,1329756180,14,15,14,1329767580,11400,3955200,4719960,764760,19_19_19_19_19_19_19_1_1_19_19_19_19_1_1_19_19_19_19_19_1_1_2_2_9_2_2_9_9_9_9_9_14_14_14_14_13_13_13_13_13_14_13_14
4832,156,1329756180,18,15,18,1329767580,11400,2357460,2639280,281820,16_16_16_16_16_16_16_16_16_16_16_1_1_1_16_1_16_16_16_16_16_16_1_1_1_1_16_16_16_16_16_16_16_16_16_16_16_16_16_16_16_16_16_16_16_16_16_16_16_16_16_16_1_1_16_16_16_16_16_16_16_16_1_1_47_47_2_2_2_3_2_3_18_18_18_3_2_2_18_3_2_2_18_2_2_18_3_3_18_3_3_18_18_18_18_18_5_18_18_18_5_18_18_18_18
4833,54,1329760800,7,12,7,1329774600,13800,0,1314000,1314000,7
4834,142,1329761460,4,5,4,1329761520,60,4003020,7299960,3296940,0_0_0_0_0_0_0_1_1_0_0_0_0_0_0_0_0_1_1_0_0_0_0_0_0_1_1_0_0_0_0_0_0_1_1_0_0_0_0_0_0_0_1_0_1_0_0_0_1_1_1_1_27_27_27_27_1_27_27_1_27_27_27_27_27_27_27_27_27_27_27_27_27_27_27_27_2_2_2_2_2_2_3_3_3_2_2_3_3_3_2_2_3_3_4_4_15_4_15_4_4_4_4_4_4_4_4_4_4_4_4_4_4_4_4_4_4_4_4_4_4
4835,142,1329761520,4,5,4,1329765960,4440,4003080,7299960,3296880,0_0_0_0_0_0_0_1_1_0_0_0_0_0_0_0_0_1_1_0_0_0_0_0_0_1_1_0_0_0_0_0_0_1_1_0_0_0_0_0_0_0_1_0_1_0_0_0_1_1_1_1_27_27_27_27_1_27_27_1_27_27_27_27_27_27_27_27_27_27_27_27_27_27_27_27_2_2_2_2_2_2_3_3_3_2_2_3_3_3_2_2_3_3_4_4_15_4_15_4_4_4_4_4_4_4_4_4_4_4_4_4_4_4_4_4_4_4_4_4_4_4
4836,107,1329762300,16,14,16,1329798480,36180,1835700,4991760,3156060,8_8_8_8_28_28_28_28_28_28_8_8_8_8_16_16_16_16_16_1_16_16_16_1_16_16_16_16_1_16_1_16_16_16_16_16_16_16_1_16_1_16_16_16_16_16_1_1_16_16_16_1_1_16_16_16_16_16_16
4837,90,1329762360,19,14,19,1329762960,600,47700,1532940,1485240,19_19_19_19_19_19
4838,90,1329762960,19,1,19,1329798360,35400,48300,1532940,1484640,19_19_19_19_19_19_19
4839,169,1329763140,50,12,50,1329798840,35700,101400,2190660,2089260,50_50_50_50_50_50_50_50_50_50_50
4840,142,1329765960,4,5,4,1329767580,1620,4007520,7299960,3292440,0_0_0_0_0_0_0_1_1_0_0_0_0_0_0_0_0_1_1_0_0_0_0_0_0_1_1_0_0_0_0_0_0_1_1_0_0_0_0_0_0_0_1_0_1_0_0_0_1_1_1_1_27_27_27_27_1_27_27_1_27_27_27_27_27_27_27_27_27_27_27_27_27_27_27_27_2_2_2_2_2_2_3_3_3_2_2_3_3_3_2_2_3_3_4_4_15_4_15_4_4_4_4_4_4_4_4_4_4_4_4_4_4_4_4_4_4_4_4_4_4_4_4
4841,156,1329767580,18,15,18,1329767640,60,2368860,2639280,270420,16_16_16_16_16_16_16_16_16_16_16_1_1_1_16_1_16_16_16_16_16_16_1_1_1_1_16_16_16_16_16_16_16_16_16_16_16_16_16_16_16_16_16_16_16_16_16_16_16_16_16_16_1_1_16_16_16_16_16_16_16_16_1_1_47_47_2_2_2_3_2_3_18_18_18_3_2_2_18_3_2_2_18_2_2_18_3_3_18_3_3_18_18_18_18_18_5_18_18_18_5_18_18_18_18_18
4842,142,1329767580,4,5,4,1329767580,0,4009140,7299960,3290820,0_0_0_0_0_0_0_1_1_0_0_0_0_0_0_0_0_1_1_0_0_0_0_0_0_1_1_0_0_0_0_0_0_1_1_0_0_0_0_0_0_0_1_0_1_0_0_0_1_1_1_1_27_27_27_27_1_27_27_1_27_27_27_27_27_27_27_27_27_27_27_27_27_27_27_27_2_2_2_2_2_2_3_3_3_2_2_3_3_3_2_2_3_3_4_4_15_4_15_4_4_4_4_4_4_4_4_4_4_4_4_4_4_4_4_4_4_4_4_4_4_4_4_4
4843,142,1329767580,4,5,4,1329799680,32100,4009140,7299960,3290820,0_0_0_0_0_0_0_1_1_0_0_0_0_0_0_0_0_1_1_0_0_0_0_0_0_1_1_0_0_0_0_0_0_1_1_0_0_0_0_0_0_0_1_0_1_0_0_0_1_1_1_1_27_27_27_27_1_27_27_1_27_27_27_27_27_27_27_27_27_27_27_27_27_27_27_27_2_2_2_2_2_2_3_3_3_2_2_3_3_3_2_2_3_3_4_4_15_4_15_4_4_4_4_4_4_4_4_4_4_4_4_4_4_4_4_4_4_4_4_4_4_4_4_4_4
4844,103,1329767580,14,15,14,1329774300,6720,3966600,4719960,753360,19_19_19_19_19_19_19_1_1_19_19_19_19_1_1_19_19_19_19_19_1_1_2_2_9_2_2_9_9_9_9_9_14_14_14_14_13_13_13_13_13_14_13_14_14
4845,156,1329767640,18,5,6,1329775200,7560,2368920,2639280,270360,16_16_16_16_16_16_16_16_16_16_16_1_1_1_16_1_16_16_16_16_16_16_1_1_1_1_16_16_16_16_16_16_16_16_16_16_16_16_16_16_16_16_16_16_16_16_16_16_16_16_16_16_1_1_16_16_16_16_16_16_16_16_1_1_47_47_2_2_2_3_2_3_18_18_18_3_2_2_18_3_2_2_18_2_2_18_3_3_18_3_3_18_18_18_18_18_5_18_18_18_5_18_18_18_18_18_18
4846,71,1329768420,32,35,32,1329798540,30120,3506820,3996240,489420,29_29_1_1_7_7_1_7_1_7_7_7_7_7_1_7_1_7_7_7_7_7_7_1_1_7_7_7_7_7_7_7_7_1_1_7_7_7_7_1_1_1_1_7_7_1_7_1_7_7_7_7_7_7_7_1_7_7_7_1_7_7_7_7_7_7_7_1_7_1_7_7_7_7_7_7_7_1_7_7_7_32_1_32_32_5_5_32_7_7_32_32_32_32_32
4847,2,1329771420,10,14,10,1329785820,14400,20880,2555640,2534760,10_10_10
4848,213,1329774300,0,1,0,1329786000,11700,737880,3206820,2468940,0_0_0_0_0_1_0_1_0_0_0_0_0_0_0_0_1_1_0_0_0_0_0_0_0_1_1_0_0_0_0_0_0_0_0_0_0_0_0_0_0_1_1_1_0_1_0_0_0_0_0_0_0_0_0_0_1_0_1_0_0_0
4849,103,1329774300,14,15,13,1329821040,46740,3973320,4719960,746640,19_19_19_19_19_19_19_1_1_19_19_19_19_1_1_19_19_19_19_19_1_1_2_2_9_2_2_9_9_9_9_9_14_14_14_14_13_13_13_13_13_14_13_14_14_14
4850,54,1329774600,7,12,7,1329774600,0,13800,1314000,1300200,7_7
4851,54,1329774600,7,12,7,1329799800,25200,13800,1314000,1300200,7_7_7
4852,74,1329775200,6,7,6,1329778800,3600,2976000,2979600,3600,1_1_34_34_5_5_6
4853,202,1329775200,6,7,6,1329778800,3600,129600,166740,37140,13_13_6
4854,110,1329775200,6,7,6,1329778800,3600,4233600,5579400,1345800,1_1_0_0_1_1_1_1_2_2_2_2_4_4_4_4_4_4_4_4_4_4_4_4_4_4_4_4_4_4_4_4_4_4_4_4_4_4_4_4_4_4_4_4_4_4_4_4_4_4_4_4_5_5_6_6_5_5_5_5_18_18_18_18_18_18_5_5_5_5_5_5_6
4855,156,1329775200,3,4,6,1329778800,3600,2376480,2639280,262800,16_16_16_16_16_16_16_16_16_16_16_1_1_1_16_1_16_16_16_16_16_16_1_1_1_1_16_16_16_16_16_16_16_16_16_16_16_16_16_16_16_16_16_16_16_16_16_16_16_16_16_16_1_1_16_16_16_16_16_16_16_16_1_1_47_47_2_2_2_3_2_3_18_18_18_3_2_2_18_3_2_2_18_2_2_18_3_3_18_3_3_18_18_18_18_18_5_18_18_18_5_18_18_18_18_18_18_6_3
4856,180,1329775200,9,4,9,1329779700,4500,984780,3322080,2337300,50_50_50_50_50_50_1_50_1_50_50_50_50_50_50_50_50_50_1_1_2_2_9
4857,156,1329775200,6,7,3,1329775200,0,2376480,2639280,262800,16_16_16_16_16_16_16_16_16_16_16_1_1_1_16_1_16_16_16_16_16_16_1_1_1_1_16_16_16_16_16_16_16_16_16_16_16_16_16_16_16_16_16_16_16_16_16_16_16_16_16_16_1_1_16_16_16_16_16_16_16_16_1_1_47_47_2_2_2_3_2_3_18_18_18_3_2_2_18_3_2_2_18_2_2_18_3_3_18_3_3_18_18_18_18_18_5_18_18_18_5_18_18_18_18_18_18_6
4858,161,1329775200,2,9,18,1329775200,0,1865580,1955580,90000,10_24_24_10_10_10_10_10_10_10_10_10_10_10_10_10_9_9_1_1_4_4_3_3_4_4_4_4_4_4_2
4859,79,1329775200,1,25,1,1329779700,4500,4147200,4151700,4500,15_1_15_1_26_26_26_26_26_26_26_26_26_26_26_26_26_26_26_26_8_8_1_1_10_10_10_10_10_10_41_1_1_41_6_6_41_41_41_41_18_14_15_18_15_14_1_1_14_14_14_14_1_1_1_1_1_1_1
4860,55,1329775200,3,25,3,1329779700,4500,0,4500,4500,3
4861,131,1329775200,6,7,6,1329778800,3600,3515100,6825900,3310800,16_16_16_16_16_16_16_16_16_16_16_16_16_16_16_16_16_16_16_16_16_16_16_16_16_16_1_1_1_1_2_2_3_3_3_3_18_18_18_18_18_3_3_3_3_18_18_18_18_18_18_18_18_18_18_18_18_18_18_18_18_18_18_18_5_5_5_5_5_5_5_5_5_5_5_5_6_6_5_5_6
4862,168,1329775200,6,7,6,1329778800,3600,434400,438000,3600,10_10_10_1_10_1_10_10_10_10_1_1_2_2_3_3_5_5_6_6
4863,133,1329775200,6,7,6,1329778800,3600,2984400,6181200,3196800,17_17_17_17_17_17_17_17_17_17_17_17_17_17_17_17_17_17_17_17_17_17_17_17_17_17_17_17_17_17_1_1_17_17_17_17_1_1_1_1_17_17_17_17_17_17_17_17_17_17_17_17_17_17_17_17_17_17_17_17_17_17_19_19_17_17_2_2_3_3_3_3_3_3_5_5_6
4864,215,1329775200,6,7,6,1329778800,3600,1848120,1851720,3600,24_24_24_24_24_24_8_8_3_3_3_3_14_14_14_14_2_2_5_5_5_5_6
4865,130,1329775200,6,7,6,1329778800,3600,3051540,3083940,32400,26_26_26_26_26_26_8_8_26_26_26_26_26_26_26_26_26_26_26_8_26_8_17_17_1_1_17_1_17_17_1_17_17_17_17_17_17_17_17_1_17_17_1_17_17_1_17_1_17_17_1_17_1_3_3_1_1_17_17_17_18_17_1_18_4_18_1_4_4_18_18_3_17_1_3_1_15_4_4_3_3_18_15_18_4_18_4_4_15_4_18_18_4_15_4_4_4_4_4_4_15_15_15_15_15_15_15_15_2_15_2_15_15_15_2_2_5_5_5_5_6
4866,168,1329775200,6,7,6,1329775200,0,434400,438000,3600,10_10_10_1_10_1_10_10_10_10_1_1_2_2_3_3_5_5_6
4867,161,1329775200,18,9,2,1329779700,4500,1865580,1955580,90000,10_24_24_10_10_10_10_10_10_10_10_10_10_10_10_10_9_9_1_1_4_4_3_3_4_4_4_4_4_4_2_18
4868,201,1329775200,6,7,6,1329778800,3600,1608240,1645440,37200,10_10_10_10_10_10_10_10_10_10_10_10_1_1_2_2_3_3_13_13_13_13_13_13_6
4869,202,1329778800,6,7,5,1329808680,29880,133200,166740,33540,13_13_6_6
4870,131,1329778800,6,7,5,1329807600,28800,3518700,6825900,3307200,16_16_16_16_16_16_16_16_16_16_16_16_16_16_16_16_16_16_16_16_16_16_16_16_16_16_1_1_1_1_2_2_3_3_3_3_18_18_18_18_18_3_3_3_3_18_18_18_18_18_18_18_18_18_18_18_18_18_18_18_18_18_18_18_5_5_5_5_5_5_5_5_5_5_5_5_6_6_5_5_6_6
4871,215,1329778800,6,7,99,1329778800,0,1851720,1851720,0,24_24_24_24_24_24_8_8_3_3_3_3_14_14_14_14_2_2_5_5_5_5_6_6
4872,74,1329778800,6,7,99,1329778800,0,2979600,2979600,0,1_1_34_34_5_5_6_6
4873,201,1329778800,6,7,5,1329809400,30600,1611840,1645440,33600,10_10_10_10_10_10_10_10_10_10_10_10_1_1_2_2_3_3_13_13_13_13_13_13_6_6
4874,168,1329778800,6,7,6,1329778800,0,438000,438000,0,10_10_10_1_10_1_10_10_10_10_1_1_2_2_3_3_5_5_6_6_6
4875,110,1329778800,6,7,34,1331065800,1287000,4237200,5579400,1342200,1_1_0_0_1_1_1_1_2_2_2_2_4_4_4_4_4_4_4_4_4_4_4_4_4_4_4_4_4_4_4_4_4_4_4_4_4_4_4_4_4_4_4_4_4_4_4_4_4_4_4_4_5_5_6_6_5_5_5_5_18_18_18_18_18_18_5_5_5_5_5_5_6_6
4876,168,1329778800,6,7,99,1329778800,0,438000,438000,0,10_10_10_1_10_1_10_10_10_10_1_1_2_2_3_3_5_5_6_6_6_6
4877,130,1329778800,6,7,5,1329800400,21600,3055140,3083940,28800,26_26_26_26_26_26_8_8_26_26_26_26_26_26_26_26_26_26_26_8_26_8_17_17_1_1_17_1_17_17_1_17_17_17_17_17_17_17_17_1_17_17_1_17_17_1_17_1_17_17_1_17_1_3_3_1_1_17_17_17_18_17_1_18_4_18_1_4_4_18_18_3_17_1_3_1_15_4_4_3_3_18_15_18_4_18_4_4_15_4_18_18_4_15_4_4_4_4_4_4_15_15_15_15_15_15_15_15_2_15_2_15_15_15_2_2_5_5_5_5_6_6
4878,156,1329778800,6,7,3,1329779700,900,2380080,2639280,259200,16_16_16_16_16_16_16_16_16_16_16_1_1_1_16_1_16_16_16_16_16_16_1_1_1_1_16_16_16_16_16_16_16_16_16_16_16_16_16_16_16_16_16_16_16_16_16_16_16_16_16_16_1_1_16_16_16_16_16_16_16_16_1_1_47_47_2_2_2_3_2_3_18_18_18_3_2_2_18_3_2_2_18_2_2_18_3_3_18_3_3_18_18_18_18_18_5_18_18_18_5_18_18_18_18_18_18_6_3_6
4879,133,1329778800,6,7,17,1331740320,1961520,2988000,6181200,3193200,17_17_17_17_17_17_17_17_17_17_17_17_17_17_17_17_17_17_17_17_17_17_17_17_17_17_17_17_17_17_1_1_17_17_17_17_1_1_1_1_17_17_17_17_17_17_17_17_17_17_17_17_17_17_17_17_17_17_17_17_17_17_19_19_17_17_2_2_3_3_3_3_3_3_5_5_6_6
4880,55,1329779700,3,25,99,1329779700,0,4500,4500,0,3_3
4881,156,1329779700,3,4,18,1329799620,19920,2380980,2639280,258300,16_16_16_16_16_16_16_16_16_16_16_1_1_1_16_1_16_16_16_16_16_16_1_1_1_1_16_16_16_16_16_16_16_16_16_16_16_16_16_16_16_16_16_16_16_16_16_16_16_16_16_16_1_1_16_16_16_16_16_16_16_16_1_1_47_47_2_2_2_3_2_3_18_18_18_3_2_2_18_3_2_2_18_2_2_18_3_3_18_3_3_18_18_18_18_18_5_18_18_18_5_18_18_18_18_18_18_6_3_6_3
4882,161,1329779700,2,9,18,1329779700,0,1870080,1955580,85500,10_24_24_10_10_10_10_10_10_10_10_10_10_10_10_10_9_9_1_1_4_4_3_3_4_4_4_4_4_4_2_18_2
4883,180,1329779700,9,4,9,1329807780,28080,989280,3322080,2332800,50_50_50_50_50_50_1_50_1_50_50_50_50_50_50_50_50_50_1_1_2_2_9_9
4884,79,1329779700,1,25,99,1329779700,0,4151700,4151700,0,15_1_15_1_26_26_26_26_26_26_26_26_26_26_26_26_26_26_26_26_8_8_1_1_10_10_10_10_10_10_41_1_1_41_6_6_41_41_41_41_18_14_15_18_15_14_1_1_14_14_14_14_1_1_1_1_1_1_1_1
4885,161,1329779700,18,9,2,1329825540,45840,1870080,1955580,85500,10_24_24_10_10_10_10_10_10_10_10_10_10_10_10_10_9_9_1_1_4_4_3_3_4_4_4_4_4_4_2_18_2_18
4886,2,1329785820,10,14,10,1329799500,13680,35280,2555640,2520360,10_10_10_10
4887,213,1329786000,0,14,0,1329798300,12300,749580,3206820,2457240,0_0_0_0_0_1_0_1_0_0_0_0_0_0_0_0_1_1_0_0_0_0_0_0_0_1_1_0_0_0_0_0_0_0_0_0_0_0_0_0_0_1_1_1_0_1_0_0_0_0_0_0_0_0_0_0_1_0_1_0_0_0_0
4888,213,1329798300,0,14,0,1329799620,1320,761880,3206820,2444940,0_0_0_0_0_1_0_1_0_0_0_0_0_0_0_0_1_1_0_0_0_0_0_0_0_1_1_0_0_0_0_0_0_0_0_0_0_0_0_0_0_1_1_1_0_1_0_0_0_0_0_0_0_0_0_0_1_0_1_0_0_0_0_0
4889,90,1329798360,19,14,1,1329799800,1440,83700,1532940,1449240,19_19_19_19_19_19_19_19
4890,107,1329798480,16,14,16,1329799800,1320,1871880,4991760,3119880,8_8_8_8_28_28_28_28_28_28_8_8_8_8_16_16_16_16_16_1_16_16_16_1_16_16_16_16_1_16_1_16_16_16_16_16_16_16_1_16_1_16_16_16_16_16_1_1_16_16_16_1_1_16_16_16_16_16_16_16
4891,71,1329798540,32,35,32,1329804600,6060,3536940,3996240,459300,29_29_1_1_7_7_1_7_1_7_7_7_7_7_1_7_1_7_7_7_7_7_7_1_1_7_7_7_7_7_7_7_7_1_1_7_7_7_7_1_1_1_1_7_7_1_7_1_7_7_7_7_7_7_7_1_7_7_7_1_7_7_7_7_7_7_7_1_7_1_7_7_7_7_7_7_7_1_7_7_7_32_1_32_32_5_5_32_7_7_32_32_32_32_32_32
4892,169,1329798840,50,12,50,1329799560,720,137100,2190660,2053560,50_50_50_50_50_50_50_50_50_50_50_50
4893,2,1329799500,10,13,10,1329814980,15480,48960,2555640,2506680,10_10_10_10_10
4894,169,1329799560,50,0,50,1329839520,39960,137820,2190660,2052840,50_50_50_50_50_50_50_50_50_50_50_50_50
4895,213,1329799620,0,0,0,1329839460,39840,763200,3206820,2443620,0_0_0_0_0_1_0_1_0_0_0_0_0_0_0_0_1_1_0_0_0_0_0_0_0_1_1_0_0_0_0_0_0_0_0_0_0_0_0_0_0_1_1_1_0_1_0_0_0_0_0_0_0_0_0_0_1_0_1_0_0_0_0_0_0
4896,156,1329799620,18,5,18,1329801480,1860,2400900,2639280,238380,16_16_16_16_16_16_16_16_16_16_16_1_1_1_16_1_16_16_16_16_16_16_1_1_1_1_16_16_16_16_16_16_16_16_16_16_16_16_16_16_16_16_16_16_16_16_16_16_16_16_16_16_1_1_16_16_16_16_16_16_16_16_1_1_47_47_2_2_2_3_2_3_18_18_18_3_2_2_18_3_2_2_18_2_2_18_3_3_18_3_3_18_18_18_18_18_5_18_18_18_5_18_18_18_18_18_18_6_3_6_3_18
4897,142,1329799680,4,5,4,1329799800,120,4041240,7299960,3258720,0_0_0_0_0_0_0_1_1_0_0_0_0_0_0_0_0_1_1_0_0_0_0_0_0_1_1_0_0_0_0_0_0_1_1_0_0_0_0_0_0_0_1_0_1_0_0_0_1_1_1_1_27_27_27_27_1_27_27_1_27_27_27_27_27_27_27_27_27_27_27_27_27_27_27_27_2_2_2_2_2_2_3_3_3_2_2_3_3_3_2_2_3_3_4_4_15_4_15_4_4_4_4_4_4_4_4_4_4_4_4_4_4_4_4_4_4_4_4_4_4_4_4_4_4_4
4898,107,1329799800,16,20,16,1329826800,27000,1873200,4991760,3118560,8_8_8_8_28_28_28_28_28_28_8_8_8_8_16_16_16_16_16_1_16_16_16_1_16_16_16_16_1_16_1_16_16_16_16_16_16_16_1_16_1_16_16_16_16_16_1_1_16_16_16_1_1_16_16_16_16_16_16_16_16
4899,142,1329799800,4,22,4,1329801420,1620,4041360,7299960,3258600,0_0_0_0_0_0_0_1_1_0_0_0_0_0_0_0_0_1_1_0_0_0_0_0_0_1_1_0_0_0_0_0_0_1_1_0_0_0_0_0_0_0_1_0_1_0_0_0_1_1_1_1_27_27_27_27_1_27_27_1_27_27_27_27_27_27_27_27_27_27_27_27_27_27_27_27_2_2_2_2_2_2_3_3_3_2_2_3_3_3_2_2_3_3_4_4_15_4_15_4_4_4_4_4_4_4_4_4_4_4_4_4_4_4_4_4_4_4_4_4_4_4_4_4_4_4_4
4900,54,1329799800,7,12,7,1329852780,52980,39000,1314000,1275000,7_7_7_7
4901,90,1329799800,1,9,1,1329803940,4140,85140,1532940,1447800,19_19_19_19_19_19_19_19_1
4902,125,1329800400,5,2,5,1329806400,6000,3772560,3969060,196500,16_16_16_16_16_16_1_1_2_2_1_1_3_3_48_48_5_5_5
4903,130,1329800400,5,6,5,1329807600,7200,3076740,3083940,7200,26_26_26_26_26_26_8_8_26_26_26_26_26_26_26_26_26_26_26_8_26_8_17_17_1_1_17_1_17_17_1_17_17_17_17_17_17_17_17_1_17_17_1_17_17_1_17_1_17_17_1_17_1_3_3_1_1_17_17_17_18_17_1_18_4_18_1_4_4_18_18_3_17_1_3_1_15_4_4_3_3_18_15_18_4_18_4_4_15_4_18_18_4_15_4_4_4_4_4_4_15_15_15_15_15_15_15_15_2_15_2_15_15_15_2_2_5_5_5_5_6_6_5
4904,196,1329800700,7,8,7,1329808920,8220,0,3281700,3281700,7
4905,89,1329801120,19,11,19,1329804780,3660,0,1736340,1736340,19
4906,142,1329801420,4,22,4,1329801540,120,4042980,7299960,3256980,0_0_0_0_0_0_0_1_1_0_0_0_0_0_0_0_0_1_1_0_0_0_0_0_0_1_1_0_0_0_0_0_0_1_1_0_0_0_0_0_0_0_1_0_1_0_0_0_1_1_1_1_27_27_27_27_1_27_27_1_27_27_27_27_27_27_27_27_27_27_27_27_27_27_27_27_2_2_2_2_2_2_3_3_3_2_2_3_3_3_2_2_3_3_4_4_15_4_15_4_4_4_4_4_4_4_4_4_4_4_4_4_4_4_4_4_4_4_4_4_4_4_4_4_4_4_4_4
4907,156,1329801480,18,22,3,1329808440,6960,2402760,2639280,236520,16_16_16_16_16_16_16_16_16_16_16_1_1_1_16_1_16_16_16_16_16_16_1_1_1_1_16_16_16_16_16_16_16_16_16_16_16_16_16_16_16_16_16_16_16_16_16_16_16_16_16_16_1_1_16_16_16_16_16_16_16_16_1_1_47_47_2_2_2_3_2_3_18_18_18_3_2_2_18_3_2_2_18_2_2_18_3_3_18_3_3_18_18_18_18_18_5_18_18_18_5_18_18_18_18_18_18_6_3_6_3_18_18
4908,142,1329801540,4,23,4,1329805500,3960,4043100,7299960,3256860,0_0_0_0_0_0_0_1_1_0_0_0_0_0_0_0_0_1_1_0_0_0_0_0_0_1_1_0_0_0_0_0_0_1_1_0_0_0_0_0_0_0_1_0_1_0_0_0_1_1_1_1_27_27_27_27_1_27_27_1_27_27_27_27_27_27_27_27_27_27_27_27_27_27_27_27_2_2_2_2_2_2_3_3_3_2_2_3_3_3_2_2_3_3_4_4_15_4_15_4_4_4_4_4_4_4_4_4_4_4_4_4_4_4_4_4_4_4_4_4_4_4_4_4_4_4_4_4_4
4909,90,1329803940,1,9,19,1329805260,1320,89280,1532940,1443660,19_19_19_19_19_19_19_19_1_1
4910,71,1329804600,32,34,32,1329817200,12600,3543000,3996240,453240,29_29_1_1_7_7_1_7_1_7_7_7_7_7_1_7_1_7_7_7_7_7_7_1_1_7_7_7_7_7_7_7_7_1_1_7_7_7_7_1_1_1_1_7_7_1_7_1_7_7_7_7_7_7_7_1_7_7_7_1_7_7_7_7_7_7_7_1_7_1_7_7_7_7_7_7_7_1_7_7_7_32_1_32_32_5_5_32_7_7_32_32_32_32_32_32_32
4911,89,1329804780,19,11,19,1330366620,561840,3660,1736340,1732680,19_19
4912,77,1329804840,5,9,5,1329833100,28260,3196680,3257040,60360,0_0_1_0_0_1_0_0_0_0_0_0_0_0_0_0_0_0_1_0_1_0_2_2_4_4_4_4_4_4_4_4_4_4_4_4_4_4_1_1_18_18_18_18_18_18_5
4913,90,1329805260,19,11,19,1329808080,2820,90600,1532940,1442340,19_19_19_19_19_19_19_19_1_1_19
4914,142,1329805500,4,23,4,1329816120,10620,4047060,7299960,3252900,0_0_0_0_0_0_0_1_1_0_0_0_0_0_0_0_0_1_1_0_0_0_0_0_0_1_1_0_0_0_0_0_0_1_1_0_0_0_0_0_0_0_1_0_1_0_0_0_1_1_1_1_27_27_27_27_1_27_27_1_27_27_27_27_27_27_27_27_27_27_27_27_27_27_27_27_2_2_2_2_2_2_3_3_3_2_2_3_3_3_2_2_3_3_4_4_15_4_15_4_4_4_4_4_4_4_4_4_4_4_4_4_4_4_4_4_4_4_4_4_4_4_4_4_4_4_4_4_4_4_4
4915,142,1329805500,4,23,4,1329805500,0,4047060,7299960,3252900,0_0_0_0_0_0_0_1_1_0_0_0_0_0_0_0_0_1_1_0_0_0_0_0_0_1_1_0_0_0_0_0_0_1_1_0_0_0_0_0_0_0_1_0_1_0_0_0_1_1_1_1_27_27_27_27_1_27_27_1_27_27_27_27_27_27_27_27_27_27_27_27_27_27_27_27_2_2_2_2_2_2_3_3_3_2_2_3_3_3_2_2_3_3_4_4_15_4_15_4_4_4_4_4_4_4_4_4_4_4_4_4_4_4_4_4_4_4_4_4_4_4_4_4_4_4_4_4_4_4
4916,125,1329806400,5,2,48,1329819900,13500,3778560,3969060,190500,16_16_16_16_16_16_1_1_2_2_1_1_3_3_48_48_5_5_5_5
4917,130,1329807600,5,6,99,1329807600,0,3083940,3083940,0,26_26_26_26_26_26_8_8_26_26_26_26_26_26_26_26_26_26_26_8_26_8_17_17_1_1_17_1_17_17_1_17_17_17_17_17_17_17_17_1_17_17_1_17_17_1_17_1_17_17_1_17_1_3_3_1_1_17_17_17_18_17_1_18_4_18_1_4_4_18_18_3_17_1_3_1_15_4_4_3_3_18_15_18_4_18_4_4_15_4_18_18_4_15_4_4_4_4_4_4_15_15_15_15_15_15_15_15_2_15_2_15_15_15_2_2_5_5_5_5_6_6_5_5
4918,131,1329807600,5,2,5,1329813900,6300,3547500,6825900,3278400,16_16_16_16_16_16_16_16_16_16_16_16_16_16_16_16_16_16_16_16_16_16_16_16_16_16_1_1_1_1_2_2_3_3_3_3_18_18_18_18_18_3_3_3_3_18_18_18_18_18_18_18_18_18_18_18_18_18_18_18_18_18_18_18_5_5_5_5_5_5_5_5_5_5_5_5_6_6_5_5_6_6_5
4919,180,1329807780,9,4,9,1329819180,11400,1017360,3322080,2304720,50_50_50_50_50_50_1_50_1_50_50_50_50_50_50_50_50_50_1_1_2_2_9_9_9
4920,90,1329808080,19,11,19,1329808080,0,93420,1532940,1439520,19_19_19_19_19_19_19_19_1_1_19_19
4921,90,1329808080,19,11,19,1329832320,24240,93420,1532940,1439520,19_19_19_19_19_19_19_19_1_1_19_19_19
4922,156,1329808440,3,3,5,1329811200,2760,2409720,2639280,229560,16_16_16_16_16_16_16_16_16_16_16_1_1_1_16_1_16_16_16_16_16_16_1_1_1_1_16_16_16_16_16_16_16_16_16_16_16_16_16_16_16_16_16_16_16_16_16_16_16_16_16_16_1_1_16_16_16_16_16_16_16_16_1_1_47_47_2_2_2_3_2_3_18_18_18_3_2_2_18_3_2_2_18_2_2_18_3_3_18_3_3_18_18_18_18_18_5_18_18_18_5_18_18_18_18_18_18_6_3_6_3_18_18_3
4923,202,1329808680,5,6,5,1329812340,3660,163080,166740,3660,13_13_6_6_5
4924,196,1329808920,7,8,7,1329840300,31380,8220,3281700,3273480,7_7
4925,201,1329809400,5,6,5,1329812400,3000,1642440,1645440,3000,10_10_10_10_10_10_10_10_10_10_10_10_1_1_2_2_3_3_13_13_13_13_13_13_6_6_5
4926,156,1329811200,5,6,5,1329815640,4440,2412480,2639280,226800,16_16_16_16_16_16_16_16_16_16_16_1_1_1_16_1_16_16_16_16_16_16_1_1_1_1_16_16_16_16_16_16_16_16_16_16_16_16_16_16_16_16_16_16_16_16_16_16_16_16_16_16_1_1_16_16_16_16_16_16_16_16_1_1_47_47_2_2_2_3_2_3_18_18_18_3_2_2_18_3_2_2_18_2_2_18_3_3_18_3_3_18_18_18_18_18_5_18_18_18_5_18_18_18_18_18_18_6_3_6_3_18_18_3_5
4927,202,1329812340,5,6,99,1329812340,0,166740,166740,0,13_13_6_6_5_5
4928,201,1329812400,5,6,99,1329812400,0,1645440,1645440,0,10_10_10_10_10_10_10_10_10_10_10_10_1_1_2_2_3_3_13_13_13_13_13_13_6_6_5_5
4929,98,1329813900,5,2,5,1329821400,7500,4074480,7319880,3245400,34_34_2_2_35_35_34_34_2_2_3_3_3_3_3_3_18_18_3_3_3_18_3_3_3_18_18_18_18_3_3_18_18_18_18_18_18_18_18_3_3_18_39_3_3_39_3_3_3_3_4_4_5_5_5_5_5_5_4_4_4_5_3_5_5_3_5_4_4_4_5_5_5_5_6_6_6_6_5_5_5_5_5_5_5_5_5_5_5_5_6_6_5_5_34_34_6_6_5_5_5_5_5
4930,131,1329813900,5,2,5,1329922800,108900,3553800,6825900,3272100,16_16_16_16_16_16_16_16_16_16_16_16_16_16_16_16_16_16_16_16_16_16_16_16_16_16_1_1_1_1_2_2_3_3_3_3_18_18_18_18_18_3_3_3_3_18_18_18_18_18_18_18_18_18_18_18_18_18_18_18_18_18_18_18_5_5_5_5_5_5_5_5_5_5_5_5_6_6_5_5_6_6_5_5
4931,2,1329814980,10,13,10,1329815040,60,64440,2555640,2491200,10_10_10_10_10_10
4932,2,1329815040,10,13,10,1329818880,3840,64500,2555640,2491140,10_10_10_10_10_10_10
4933,158,1329815220,5,6,5,1329829620,14400,1994700,2044680,49980,17_17_17_17_17_17_17_17_17_1_17_1_2_2_3_3_3_13_13_3_13_13_13_13_13_13_5_5_6_6_5_5_13_13_18_18_13_13_5
4934,156,1329815640,5,6,3,1329817440,1800,2416920,2639280,222360,16_16_16_16_16_16_16_16_16_16_16_1_1_1_16_1_16_16_16_16_16_16_1_1_1_1_16_16_16_16_16_16_16_16_16_16_16_16_16_16_16_16_16_16_16_16_16_16_16_16_16_16_1_1_16_16_16_16_16_16_16_16_1_1_47_47_2_2_2_3_2_3_18_18_18_3_2_2_18_3_2_2_18_2_2_18_3_3_18_3_3_18_18_18_18_18_5_18_18_18_5_18_18_18_18_18_18_6_3_6_3_18_18_3_5_5
4935,142,1329816120,4,23,15,1329994440,178320,4057680,7299960,3242280,0_0_0_0_0_0_0_1_1_0_0_0_0_0_0_0_0_1_1_0_0_0_0_0_0_1_1_0_0_0_0_0_0_1_1_0_0_0_0_0_0_0_1_0_1_0_0_0_1_1_1_1_27_27_27_27_1_27_27_1_27_27_27_27_27_27_27_27_27_27_27_27_27_27_27_27_2_2_2_2_2_2_3_3_3_2_2_3_3_3_2_2_3_3_4_4_15_4_15_4_4_4_4_4_4_4_4_4_4_4_4_4_4_4_4_4_4_4_4_4_4_4_4_4_4_4_4_4_4_4_4_4
4936,69,1329816600,4,23,4,1329822000,5400,1902660,2073180,170520,16_16_1_1_0_0_1_1_2_2_3_3_3_3_4
4937,71,1329817200,32,34,32,1329823800,6600,3555600,3996240,440640,29_29_1_1_7_7_1_7_1_7_7_7_7_7_1_7_1_7_7_7_7_7_7_1_1_7_7_7_7_7_7_7_7_1_1_7_7_7_7_1_1_1_1_7_7_1_7_1_7_7_7_7_7_7_7_1_7_7_7_1_7_7_7_7_7_7_7_1_7_1_7_7_7_7_7_7_7_1_7_7_7_32_1_32_32_5_5_32_7_7_32_32_32_32_32_32_32_32
4938,156,1329817440,3,3,18,1329840480,23040,2418720,2639280,220560,16_16_16_16_16_16_16_16_16_16_16_1_1_1_16_1_16_16_16_16_16_16_1_1_1_1_16_16_16_16_16_16_16_16_16_16_16_16_16_16_16_16_16_16_16_16_16_16_16_16_16_16_1_1_16_16_16_16_16_16_16_16_1_1_47_47_2_2_2_3_2_3_18_18_18_3_2_2_18_3_2_2_18_2_2_18_3_3_18_3_3_18_18_18_18_18_5_18_18_18_5_18_18_18_18_18_18_6_3_6_3_18_18_3_5_5_3
4939,146,1329817500,3,3,3,1329834360,16860,4290300,6670800,2380500,16_16_16_16_16_16_16_1_16_1_16_1_1_16_1_16_16_2_1_1_16_1_2_16_2_2_3_3_3_3_21_21_3_3_3_3_3_21_3_21_3_3_3_3_21_3_21_3_18_18_18_18_18_18_3
4940,2,1329818880,10,13,1,1329914880,96000,68340,2555640,2487300,10_10_10_10_10_10_10_10
4941,187,1329818940,10,13,10,1329821460,2520,168120,2496960,2328840,10_10_10_10_10_10_10_10_10_10_10
4942,180,1329819180,9,4,3,1329861600,42420,1028760,3322080,2293320,50_50_50_50_50_50_1_50_1_50_50_50_50_50_50_50_50_50_1_1_2_2_9_9_9_9
4943,85,1329819300,5,9,5,1329832020,12720,646080,778380,132300,19_19_19_19_19_19_19_19_19_19_19_19_1_1_2_3_2_3_5
4944,125,1329819900,48,43,48,1329826740,6840,3792060,3969060,177000,16_16_16_16_16_16_1_1_2_2_1_1_3_3_48_48_5_5_5_5_48
4945,103,1329821040,13,17,13,1329840540,19500,4020060,4719960,699900,19_19_19_19_19_19_19_1_1_19_19_19_19_1_1_19_19_19_19_19_1_1_2_2_9_2_2_9_9_9_9_9_14_14_14_14_13_13_13_13_13_14_13_14_14_14_13
4946,98,1329821400,5,2,5,1329823200,1800,4081980,7319880,3237900,34_34_2_2_35_35_34_34_2_2_3_3_3_3_3_3_18_18_3_3_3_18_3_3_3_18_18_18_18_3_3_18_18_18_18_18_18_18_18_3_3_18_39_3_3_39_3_3_3_3_4_4_5_5_5_5_5_5_4_4_4_5_3_5_5_3_5_4_4_4_5_5_5_5_6_6_6_6_5_5_5_5_5_5_5_5_5_5_5_5_6_6_5_5_34_34_6_6_5_5_5_5_5_5
4947,187,1329821460,10,13,1,1329916260,94800,170640,2496960,2326320,10_10_10_10_10_10_10_10_10_10_10_10
4948,69,1329822000,4,23,4,1329834120,12120,1908060,2073180,165120,16_16_1_1_0_0_1_1_2_2_3_3_3_3_4_4
4949,98,1329823200,5,2,5,1329825600,2400,4083780,7319880,3236100,34_34_2_2_35_35_34_34_2_2_3_3_3_3_3_3_18_18_3_3_3_18_3_3_3_18_18_18_18_3_3_18_18_18_18_18_18_18_18_3_3_18_39_3_3_39_3_3_3_3_4_4_5_5_5_5_5_5_4_4_4_5_3_5_5_3_5_4_4_4_5_5_5_5_6_6_6_6_5_5_5_5_5_5_5_5_5_5_5_5_6_6_5_5_34_34_6_6_5_5_5_5_5_5_5
4950,177,1329823680,10,13,10,1329831480,7800,1066740,1713060,646320,10_10_10
4951,71,1329823800,32,34,32,1329832800,9000,3562200,3996240,434040,29_29_1_1_7_7_1_7_1_7_7_7_7_7_1_7_1_7_7_7_7_7_7_1_1_7_7_7_7_7_7_7_7_1_1_7_7_7_7_1_1_1_1_7_7_1_7_1_7_7_7_7_7_7_7_1_7_7_7_1_7_7_7_7_7_7_7_1_7_1_7_7_7_7_7_7_7_1_7_7_7_32_1_32_32_5_5_32_7_7_32_32_32_32_32_32_32_32_32
4952,161,1329825540,2,3,2,1329825600,60,1915920,1955580,39660,10_24_24_10_10_10_10_10_10_10_10_10_10_10_10_10_9_9_1_1_4_4_3_3_4_4_4_4_4_4_2_18_2_18_2
4953,98,1329825600,5,2,5,1329829200,3600,4086180,7319880,3233700,34_34_2_2_35_35_34_34_2_2_3_3_3_3_3_3_18_18_3_3_3_18_3_3_3_18_18_18_18_3_3_18_18_18_18_18_18_18_18_3_3_18_39_3_3_39_3_3_3_3_4_4_5_5_5_5_5_5_4_4_4_5_3_5_5_3_5_4_4_4_5_5_5_5_6_6_6_6_5_5_5_5_5_5_5_5_5_5_5_5_6_6_5_5_34_34_6_6_5_5_5_5_5_5_5_5_5
4954,98,1329825600,5,2,5,1329825600,0,4086180,7319880,3233700,34_34_2_2_35_35_34_34_2_2_3_3_3_3_3_3_18_18_3_3_3_18_3_3_3_18_18_18_18_3_3_18_18_18_18_18_18_18_18_3_3_18_39_3_3_39_3_3_3_3_4_4_5_5_5_5_5_5_4_4_4_5_3_5_5_3_5_4_4_4_5_5_5_5_6_6_6_6_5_5_5_5_5_5_5_5_5_5_5_5_6_6_5_5_34_34_6_6_5_5_5_5_5_5_5_5
4955,161,1329825600,2,3,5,1329833820,8220,1915980,1955580,39600,10_24_24_10_10_10_10_10_10_10_10_10_10_10_10_10_9_9_1_1_4_4_3_3_4_4_4_4_4_4_2_18_2_18_2_2
4956,125,1329826740,48,43,6,1329948000,121260,3798900,3969060,170160,16_16_16_16_16_16_1_1_2_2_1_1_3_3_48_48_5_5_5_5_48_48
4957,107,1329826800,16,20,1,1330263120,436320,1900200,4991760,3091560,8_8_8_8_28_28_28_28_28_28_8_8_8_8_16_16_16_16_16_1_16_16_16_1_16_16_16_16_1_16_1_16_16_16_16_16_16_16_1_16_1_16_16_16_16_16_1_1_16_16_16_1_1_16_16_16_16_16_16_16_16_16
4958,217,1329826800,16,20,16,1329832920,6120,0,557700,557700,16
4959,98,1329829200,5,2,5,1329832800,3600,4089780,7319880,3230100,34_34_2_2_35_35_34_34_2_2_3_3_3_3_3_3_18_18_3_3_3_18_3_3_3_18_18_18_18_3_3_18_18_18_18_18_18_18_18_3_3_18_39_3_3_39_3_3_3_3_4_4_5_5_5_5_5_5_4_4_4_5_3_5_5_3_5_4_4_4_5_5_5_5_6_6_6_6_5_5_5_5_5_5_5_5_5_5_5_5_6_6_5_5_34_34_6_6_5_5_5_5_5_5_5_5_5_5_5
4960,98,1329829200,5,2,5,1329829200,0,4089780,7319880,3230100,34_34_2_2_35_35_34_34_2_2_3_3_3_3_3_3_18_18_3_3_3_18_3_3_3_18_18_18_18_3_3_18_18_18_18_18_18_18_18_3_3_18_39_3_3_39_3_3_3_3_4_4_5_5_5_5_5_5_4_4_4_5_3_5_5_3_5_4_4_4_5_5_5_5_6_6_6_6_5_5_5_5_5_5_5_5_5_5_5_5_6_6_5_5_34_34_6_6_5_5_5_5_5_5_5_5_5_5
4961,158,1329829620,5,6,6,1329861600,31980,2009100,2044680,35580,17_17_17_17_17_17_17_17_17_1_17_1_2_2_3_3_3_13_13_3_13_13_13_13_13_13_5_5_6_6_5_5_13_13_18_18_13_13_5_5
4962,177,1329831480,10,13,10,1329831540,60,1074540,1713060,638520,10_10_10_10
4963,177,1329831540,10,13,10,1329837060,5520,1074600,1713060,638460,10_10_10_10_10
4964,85,1329832020,5,9,6,1329948000,115980,658800,778380,119580,19_19_19_19_19_19_19_19_19_19_19_19_1_1_2_3_2_3_5_5
4965,90,1329832320,19,11,19,1329833160,840,117660,1532940,1415280,19_19_19_19_19_19_19_19_1_1_19_19_19_19
4966,98,1329832800,5,2,2,1329891900,59100,4093380,7319880,3226500,34_34_2_2_35_35_34_34_2_2_3_3_3_3_3_3_18_18_3_3_3_18_3_3_3_18_18_18_18_3_3_18_18_18_18_18_18_18_18_3_3_18_39_3_3_39_3_3_3_3_4_4_5_5_5_5_5_5_4_4_4_5_3_5_5_3_5_4_4_4_5_5_5_5_6_6_6_6_5_5_5_5_5_5_5_5_5_5_5_5_6_6_5_5_34_34_6_6_5_5_5_5_5_5_5_5_5_5_5_5
4967,71,1329832800,32,34,7,1329837300,4500,3571200,3996240,425040,29_29_1_1_7_7_1_7_1_7_7_7_7_7_1_7_1_7_7_7_7_7_7_1_1_7_7_7_7_7_7_7_7_1_1_7_7_7_7_1_1_1_1_7_7_1_7_1_7_7_7_7_7_7_7_1_7_7_7_1_7_7_7_7_7_7_7_1_7_1_7_7_7_7_7_7_7_1_7_7_7_32_1_32_32_5_5_32_7_7_32_32_32_32_32_32_32_32_32_32
4968,203,1329832800,5,2,5,1329840120,7320,1837500,1897500,60000,7_7_7_7_7_7_7_7_7_7_7_1_1_7_7_7_7_7_7_7_7_7_17_17_17_17_4_17_4_4_4_17_17_1_1_2_2_13_9_9_3_9_3_13_4_17_13_9_3_9_3_17_3_3_4_4_9_13_3_4_3_17_17_15_1_26_17_17_9_15_1_15_1_17_4_13_13_15_1_1_15_4_4_13_9_3_1_13_4_15_1_3_13_1_26_3_13_6_6_15_26_15_5_26_25_26_26_5_25_3_3_3_4_4_4_13_4_4_13_4_4_4_4_4_4_4_26_4_5_4_4_5_4_26_15_15_26_26_15_15_15_25_15_5_5_25_26_26_6_6_5
4969,217,1329832920,16,20,16,1329833040,120,6120,557700,551580,16_16
4970,217,1329833040,16,1,16,1329854160,21120,6240,557700,551460,16_16_16
4971,77,1329833100,5,9,6,1329861600,28500,3224940,3257040,32100,0_0_1_0_0_1_0_0_0_0_0_0_0_0_0_0_0_0_1_0_1_0_2_2_4_4_4_4_4_4_4_4_4_4_4_4_4_4_1_1_18_18_18_18_18_18_5_5
4972,90,1329833160,19,1,19,1329847320,14160,118500,1532940,1414440,19_19_19_19_19_19_19_19_1_1_19_19_19_19_19
4973,135,1329833580,5,9,5,1329834720,1140,3759180,5649480,1890300,19_19_19_19_19_19_19_19_19_19_19_19_1_19_1_19_19_19_1_1_1_1_19_19_19_19_19_19_1_1_1_1_19_19_19_19_19_19_19_19_19_19_19_19_1_19_1_19_19_19_19_19_19_1_19_1_1_1_2_2_1_1_2_2_9_3_3_9_3_3_2_9_9_9_2_4_4_3_4_3_3_9_3_4_4_4_4_9_3_9_3_4_4_4_4_4_5
4974,161,1329833820,5,9,5,1329833880,60,1924200,1955580,31380,10_24_24_10_10_10_10_10_10_10_10_10_10_10_10_10_9_9_1_1_4_4_3_3_4_4_4_4_4_4_2_18_2_18_2_2_5
4975,161,1329833880,5,9,5,1329834840,960,1924260,1955580,31320,10_24_24_10_10_10_10_10_10_10_10_10_10_10_10_10_9_9_1_1_4_4_3_3_4_4_4_4_4_4_2_18_2_18_2_2_5_5
4976,69,1329834120,4,15,4,1329847800,13680,1920180,2073180,153000,16_16_1_1_0_0_1_1_2_2_3_3_3_3_4_4_4
4977,146,1329834360,3,3,3,1329861600,27240,4307160,6670800,2363640,16_16_16_16_16_16_16_1_16_1_16_1_1_16_1_16_16_2_1_1_16_1_2_16_2_2_3_3_3_3_21_21_3_3_3_3_3_21_3_21_3_3_3_3_21_3_21_3_18_18_18_18_18_18_3_3
4978,135,1329834720,5,9,5,1329834840,120,3760320,5649480,1889160,19_19_19_19_19_19_19_19_19_19_19_19_1_19_1_19_19_19_1_1_1_1_19_19_19_19_19_19_1_1_1_1_19_19_19_19_19_19_19_19_19_19_19_19_1_19_1_19_19_19_19_19_19_1_19_1_1_1_2_2_1_1_2_2_9_3_3_9_3_3_2_9_9_9_2_4_4_3_4_3_3_9_3_4_4_4_4_9_3_9_3_4_4_4_4_4_5_5
4979,161,1329834840,5,9,5,1329834900,60,1925220,1955580,30360,10_24_24_10_10_10_10_10_10_10_10_10_10_10_10_10_9_9_1_1_4_4_3_3_4_4_4_4_4_4_2_18_2_18_2_2_5_5_5
4980,135,1329834840,5,9,5,1329839940,5100,3760440,5649480,1889040,19_19_19_19_19_19_19_19_19_19_19_19_1_19_1_19_19_19_1_1_1_1_19_19_19_19_19_19_1_1_1_1_19_19_19_19_19_19_19_19_19_19_19_19_1_19_1_19_19_19_19_19_19_1_19_1_1_1_2_2_1_1_2_2_9_3_3_9_3_3_2_9_9_9_2_4_4_3_4_3_3_9_3_4_4_4_4_9_3_9_3_4_4_4_4_4_5_5_5
4981,161,1329834900,5,9,6,1329861600,26700,1925280,1955580,30300,10_24_24_10_10_10_10_10_10_10_10_10_10_10_10_10_9_9_1_1_4_4_3_3_4_4_4_4_4_4_2_18_2_18_2_2_5_5_5_5
4982,177,1329837060,10,13,10,1329837060,0,1080120,1713060,632940,10_10_10_10_10_10
4983,177,1329837060,10,13,10,1329839880,2820,1080120,1713060,632940,10_10_10_10_10_10_10
4984,71,1329837300,7,36,32,1329837360,60,3575700,3996240,420540,29_29_1_1_7_7_1_7_1_7_7_7_7_7_1_7_1_7_7_7_7_7_7_1_1_7_7_7_7_7_7_7_7_1_1_7_7_7_7_1_1_1_1_7_7_1_7_1_7_7_7_7_7_7_7_1_7_7_7_1_7_7_7_7_7_7_7_1_7_1_7_7_7_7_7_7_7_1_7_7_7_32_1_32_32_5_5_32_7_7_32_32_32_32_32_32_32_32_32_32_7
4985,71,1329837360,32,36,7,1329841800,4440,3575760,3996240,420480,29_29_1_1_7_7_1_7_1_7_7_7_7_7_1_7_1_7_7_7_7_7_7_1_1_7_7_7_7_7_7_7_7_1_1_7_7_7_7_1_1_1_1_7_7_1_7_1_7_7_7_7_7_7_7_1_7_7_7_1_7_7_7_7_7_7_7_1_7_1_7_7_7_7_7_7_7_1_7_7_7_32_1_32_32_5_5_32_7_7_32_32_32_32_32_32_32_32_32_32_7_32
4986,213,1329839460,0,0,0,1329839580,120,803040,3206820,2403780,0_0_0_0_0_1_0_1_0_0_0_0_0_0_0_0_1_1_0_0_0_0_0_0_0_1_1_0_0_0_0_0_0_0_0_0_0_0_0_0_0_1_1_1_0_1_0_0_0_0_0_0_0_0_0_0_1_0_1_0_0_0_0_0_0_0
4987,169,1329839520,50,0,50,1329852720,13200,177780,2190660,2012880,50_50_50_50_50_50_50_50_50_50_50_50_50_50
4988,213,1329839580,0,1,0,1329860520,20940,803160,3206820,2403660,0_0_0_0_0_1_0_1_0_0_0_0_0_0_0_0_1_1_0_0_0_0_0_0_0_1_1_0_0_0_0_0_0_0_0_0_0_0_0_0_0_1_1_1_0_1_0_0_0_0_0_0_0_0_0_0_1_0_1_0_0_0_0_0_0_0_0
4989,177,1329839880,10,13,10,1329886320,46440,1082940,1713060,630120,10_10_10_10_10_10_10_10
4990,135,1329839940,5,9,5,1329889560,49620,3765540,5649480,1883940,19_19_19_19_19_19_19_19_19_19_19_19_1_19_1_19_19_19_1_1_1_1_19_19_19_19_19_19_1_1_1_1_19_19_19_19_19_19_19_19_19_19_19_19_1_19_1_19_19_19_19_19_19_1_19_1_1_1_2_2_1_1_2_2_9_3_3_9_3_3_2_9_9_9_2_4_4_3_4_3_3_9_3_4_4_4_4_9_3_9_3_4_4_4_4_4_5_5_5_5
4991,203,1329840120,5,2,26,1329861600,21480,1844820,1897500,52680,7_7_7_7_7_7_7_7_7_7_7_1_1_7_7_7_7_7_7_7_7_7_17_17_17_17_4_17_4_4_4_17_17_1_1_2_2_13_9_9_3_9_3_13_4_17_13_9_3_9_3_17_3_3_4_4_9_13_3_4_3_17_17_15_1_26_17_17_9_15_1_15_1_17_4_13_13_15_1_1_15_4_4_13_9_3_1_13_4_15_1_3_13_1_26_3_13_6_6_15_26_15_5_26_25_26_26_5_25_3_3_3_4_4_4_13_4_4_13_4_4_4_4_4_4_4_26_4_5_4_4_5_4_26_15_15_26_26_15_15_15_25_15_5_5_25_26_26_6_6_5_5
4992,196,1329840300,7,8,7,1329840360,60,39600,3281700,3242100,7_7_7
4993,196,1329840360,7,8,7,1329890640,50280,39660,3281700,3242040,7_7_7_7
4994,156,1329840480,18,22,18,1329847440,6960,2441760,2639280,197520,16_16_16_16_16_16_16_16_16_16_16_1_1_1_16_1_16_16_16_16_16_16_1_1_1_1_16_16_16_16_16_16_16_16_16_16_16_16_16_16_16_16_16_16_16_16_16_16_16_16_16_16_1_1_16_16_16_16_16_16_16_16_1_1_47_47_2_2_2_3_2_3_18_18_18_3_2_2_18_3_2_2_18_2_2_18_3_3_18_3_3_18_18_18_18_18_5_18_18_18_5_18_18_18_18_18_18_6_3_6_3_18_18_3_5_5_3_18
4995,103,1329840540,13,17,13,1329847860,7320,4039560,4719960,680400,19_19_19_19_19_19_19_1_1_19_19_19_19_1_1_19_19_19_19_19_1_1_2_2_9_2_2_9_9_9_9_9_14_14_14_14_13_13_13_13_13_14_13_14_14_14_13_13
4996,71,1329841800,7,36,32,1329846600,4800,3580200,3996240,416040,29_29_1_1_7_7_1_7_1_7_7_7_7_7_1_7_1_7_7_7_7_7_7_1_1_7_7_7_7_7_7_7_7_1_1_7_7_7_7_1_1_1_1_7_7_1_7_1_7_7_7_7_7_7_7_1_7_7_7_1_7_7_7_7_7_7_7_1_7_1_7_7_7_7_7_7_7_1_7_7_7_32_1_32_32_5_5_32_7_7_32_32_32_32_32_32_32_32_32_32_7_32_7
4997,71,1329846600,32,36,32,1329846720,120,3585000,3996240,411240,29_29_1_1_7_7_1_7_1_7_7_7_7_7_1_7_1_7_7_7_7_7_7_1_1_7_7_7_7_7_7_7_7_1_1_7_7_7_7_1_1_1_1_7_7_1_7_1_7_7_7_7_7_7_7_1_7_7_7_1_7_7_7_7_7_7_7_1_7_1_7_7_7_7_7_7_7_1_7_7_7_32_1_32_32_5_5_32_7_7_32_32_32_32_32_32_32_32_32_32_7_32_7_32
4998,71,1329846720,32,36,32,1329847320,600,3585120,3996240,411120,29_29_1_1_7_7_1_7_1_7_7_7_7_7_1_7_1_7_7_7_7_7_7_1_1_7_7_7_7_7_7_7_7_1_1_7_7_7_7_1_1_1_1_7_7_1_7_1_7_7_7_7_7_7_7_1_7_7_7_1_7_7_7_7_7_7_7_1_7_1_7_7_7_7_7_7_7_1_7_7_7_32_1_32_32_5_5_32_7_7_32_32_32_32_32_32_32_32_32_32_7_32_7_32_32
4999,90,1329847320,19,14,19,1329847800,480,132660,1532940,1400280,19_19_19_19_19_19_19_19_1_1_19_19_19_19_19_19
5000,71,1329847320,32,35,32,1329850800,3480,3585720,3996240,410520,29_29_1_1_7_7_1_7_1_7_7_7_7_7_1_7_1_7_7_7_7_7_7_1_1_7_7_7_7_7_7_7_7_1_1_7_7_7_7_1_1_1_1_7_7_1_7_1_7_7_7_7_7_7_7_1_7_7_7_1_7_7_7_7_7_7_7_1_7_1_7_7_7_7_7_7_7_1_7_7_7_32_1_32_32_5_5_32_7_7_32_32_32_32_32_32_32_32_32_32_7_32_7_32_32_32
5001,156,1329847440,18,5,5,1329885900,38460,2448720,2639280,190560,16_16_16_16_16_16_16_16_16_16_16_1_1_1_16_1_16_16_16_16_16_16_1_1_1_1_16_16_16_16_16_16_16_16_16_16_16_16_16_16_16_16_16_16_16_16_16_16_16_16_16_16_1_1_16_16_16_16_16_16_16_16_1_1_47_47_2_2_2_3_2_3_18_18_18_3_2_2_18_3_2_2_18_2_2_18_3_3_18_3_3_18_18_18_18_18_5_18_18_18_5_18_18_18_18_18_18_6_3_6_3_18_18_3_5_5_3_18_18
5002,90,1329847800,19,1,19,1329885180,37380,133140,1532940,1399800,19_19_19_19_19_19_19_19_1_1_19_19_19_19_19_19_19
5003,69,1329847800,4,5,4,1329875100,27300,1933860,2073180,139320,16_16_1_1_0_0_1_1_2_2_3_3_3_3_4_4_4_4_4
5004,69,1329847800,4,15,4,1329847800,0,1933860,2073180,139320,16_16_1_1_0_0_1_1_2_2_3_3_3_3_4_4_4_4
5005,103,1329847860,13,15,13,1329856260,8400,4046880,4719960,673080,19_19_19_19_19_19_19_1_1_19_19_19_19_1_1_19_19_19_19_19_1_1_2_2_9_2_2_9_9_9_9_9_14_14_14_14_13_13_13_13_13_14_13_14_14_14_13_13_13
5006,71,1329850800,32,36,32,1329883560,32760,3589200,3996240,407040,29_29_1_1_7_7_1_7_1_7_7_7_7_7_1_7_1_7_7_7_7_7_7_1_1_7_7_7_7_7_7_7_7_1_1_7_7_7_7_1_1_1_1_7_7_1_7_1_7_7_7_7_7_7_7_1_7_7_7_1_7_7_7_7_7_7_7_1_7_1_7_7_7_7_7_7_7_1_7_7_7_32_1_32_32_5_5_32_7_7_32_32_32_32_32_32_32_32_32_32_7_32_7_32_32_32_32
5007,169,1329852720,50,12,50,1329885240,32520,190980,2190660,1999680,50_50_50_50_50_50_50_50_50_50_50_50_50_50_50
5008,54,1329852780,7,12,7,1329875760,22980,91980,1314000,1222020,7_7_7_7_7
5009,217,1329854160,16,1,16,1329858480,4320,27360,557700,530340,16_16_16_16_16
5010,217,1329854160,16,1,16,1329854160,0,27360,557700,530340,16_16_16_16
5011,103,1329856260,13,15,13,1329860400,4140,4055280,4719960,664680,19_19_19_19_19_19_19_1_1_19_19_19_19_1_1_19_19_19_19_19_1_1_2_2_9_2_2_9_9_9_9_9_14_14_14_14_13_13_13_13_13_14_13_14_14_14_13_13_13_13_13
5012,103,1329856260,13,15,13,1329856260,0,4055280,4719960,664680,19_19_19_19_19_19_19_1_1_19_19_19_19_1_1_19_19_19_19_19_1_1_2_2_9_2_2_9_9_9_9_9_14_14_14_14_13_13_13_13_13_14_13_14_14_14_13_13_13_13
5013,217,1329858480,16,14,16,1329860460,1980,31680,557700,526020,16_16_16_16_16_16
5014,103,1329860400,13,15,44,1329903000,42600,4059420,4719960,660540,19_19_19_19_19_19_19_1_1_19_19_19_19_1_1_19_19_19_19_19_1_1_2_2_9_2_2_9_9_9_9_9_14_14_14_14_13_13_13_13_13_14_13_14_14_14_13_13_13_13_13_13
5015,217,1329860460,16,1,16,1329885240,24780,33660,557700,524040,16_16_16_16_16_16_16
5016,213,1329860520,0,1,0,1329863820,3300,824100,3206820,2382720,0_0_0_0_0_1_0_1_0_0_0_0_0_0_0_0_1_1_0_0_0_0_0_0_0_1_1_0_0_0_0_0_0_0_0_0_0_0_0_0_0_1_1_1_0_1_0_0_0_0_0_0_0_0_0_0_1_0_1_0_0_0_0_0_0_0_0_0
5017,203,1329861600,26,13,25,1329861600,0,1866300,1897500,31200,7_7_7_7_7_7_7_7_7_7_7_1_1_7_7_7_7_7_7_7_7_7_17_17_17_17_4_17_4_4_4_17_17_1_1_2_2_13_9_9_3_9_3_13_4_17_13_9_3_9_3_17_3_3_4_4_9_13_3_4_3_17_17_15_1_26_17_17_9_15_1_15_1_17_4_13_13_15_1_1_15_4_4_13_9_3_1_13_4_15_1_3_13_1_26_3_13_6_6_15_26_15_5_26_25_26_26_5_25_3_3_3_4_4_4_13_4_4_13_4_4_4_4_4_4_4_26_4_5_4_4_5_4_26_15_15_26_26_15_15_15_25_15_5_5_25_26_26_6_6_5_5_26
5018,86,1329861600,6,7,6,1329865200,3600,3515580,3519180,3600,0_0_0_0_1_0_0_0_0_1_0_0_0_0_1_1_0_0_1_1_1_1_1_1_2_2_4_4_4_4_4_4_4_4_4_4_18_18_18_18_1_18_1_18_18_18_5_5_5_5_4_4_4_4_5_5_6
5019,146,1329861600,3,4,3,1329866100,4500,4334400,6670800,2336400,16_16_16_16_16_16_16_1_16_1_16_1_1_16_1_16_16_2_1_1_16_1_2_16_2_2_3_3_3_3_21_21_3_3_3_3_3_21_3_21_3_3_3_3_21_3_21_3_18_18_18_18_18_18_3_3_3
5020,77,1329861600,6,7,6,1329865200,3600,3253440,3257040,3600,0_0_1_0_0_1_0_0_0_0_0_0_0_0_0_0_0_0_1_0_1_0_2_2_4_4_4_4_4_4_4_4_4_4_4_4_4_4_1_1_18_18_18_18_18_18_5_5_6
5021,158,1329861600,6,7,6,1329865200,3600,2041080,2044680,3600,17_17_17_17_17_17_17_17_17_1_17_1_2_2_3_3_3_13_13_3_13_13_13_13_13_13_5_5_6_6_5_5_13_13_18_18_13_13_5_5_6
5022,161,1329861600,6,7,6,1329865200,3600,1951980,1955580,3600,10_24_24_10_10_10_10_10_10_10_10_10_10_10_10_10_9_9_1_1_4_4_3_3_4_4_4_4_4_4_2_18_2_18_2_2_5_5_5_5_6
5023,203,1329861600,25,28,26,1329866100,4500,1866300,1897500,31200,7_7_7_7_7_7_7_7_7_7_7_1_1_7_7_7_7_7_7_7_7_7_17_17_17_17_4_17_4_4_4_17_17_1_1_2_2_13_9_9_3_9_3_13_4_17_13_9_3_9_3_17_3_3_4_4_9_13_3_4_3_17_17_15_1_26_17_17_9_15_1_15_1_17_4_13_13_15_1_1_15_4_4_13_9_3_1_13_4_15_1_3_13_1_26_3_13_6_6_15_26_15_5_26_25_26_26_5_25_3_3_3_4_4_4_13_4_4_13_4_4_4_4_4_4_4_26_4_5_4_4_5_4_26_15_15_26_26_15_15_15_25_15_5_5_25_26_26_6_6_5_5_26_25
5024,180,1329861600,3,4,3,1329866100,4500,1071180,3322080,2250900,50_50_50_50_50_50_1_50_1_50_50_50_50_50_50_50_50_50_1_1_2_2_9_9_9_9_3
5025,213,1329863820,0,14,0,1329885480,21660,827400,3206820,2379420,0_0_0_0_0_1_0_1_0_0_0_0_0_0_0_0_1_1_0_0_0_0_0_0_0_1_1_0_0_0_0_0_0_0_0_0_0_0_0_0_0_1_1_1_0_1_0_0_0_0_0_0_0_0_0_0_1_0_1_0_0_0_0_0_0_0_0_0_0
5026,161,1329865200,6,7,99,1329865200,0,1955580,1955580,0,10_24_24_10_10_10_10_10_10_10_10_10_10_10_10_10_9_9_1_1_4_4_3_3_4_4_4_4_4_4_2_18_2_18_2_2_5_5_5_5_6_6
5027,77,1329865200,6,7,99,1329865200,0,3257040,3257040,0,0_0_1_0_0_1_0_0_0_0_0_0_0_0_0_0_0_0_1_0_1_0_2_2_4_4_4_4_4_4_4_4_4_4_4_4_4_4_1_1_18_18_18_18_18_18_5_5_6_6
5028,158,1329865200,6,7,99,1329865200,0,2044680,2044680,0,17_17_17_17_17_17_17_17_17_1_17_1_2_2_3_3_3_13_13_3_13_13_13_13_13_13_5_5_6_6_5_5_13_13_18_18_13_13_5_5_6_6
5029,86,1329865200,6,7,99,1329865200,0,3519180,3519180,0,0_0_0_0_1_0_0_0_0_1_0_0_0_0_1_1_0_0_1_1_1_1_1_1_2_2_4_4_4_4_4_4_4_4_4_4_18_18_18_18_1_18_1_18_18_18_5_5_5_5_4_4_4_4_5_5_6_6
5030,203,1329866100,26,13,25,1329866100,0,1870800,1897500,26700,7_7_7_7_7_7_7_7_7_7_7_1_1_7_7_7_7_7_7_7_7_7_17_17_17_17_4_17_4_4_4_17_17_1_1_2_2_13_9_9_3_9_3_13_4_17_13_9_3_9_3_17_3_3_4_4_9_13_3_4_3_17_17_15_1_26_17_17_9_15_1_15_1_17_4_13_13_15_1_1_15_4_4_13_9_3_1_13_4_15_1_3_13_1_26_3_13_6_6_15_26_15_5_26_25_26_26_5_25_3_3_3_4_4_4_13_4_4_13_4_4_4_4_4_4_4_26_4_5_4_4_5_4_26_15_15_26_26_15_15_15_25_15_5_5_25_26_26_6_6_5_5_26_25_26
5031,180,1329866100,3,4,3,1329894420,28320,1075680,3322080,2246400,50_50_50_50_50_50_1_50_1_50_50_50_50_50_50_50_50_50_1_1_2_2_9_9_9_9_3_3
5032,146,1329866100,3,4,4,1329874920,8820,4338900,6670800,2331900,16_16_16_16_16_16_16_1_16_1_16_1_1_16_1_16_16_2_1_1_16_1_2_16_2_2_3_3_3_3_21_21_3_3_3_3_3_21_3_21_3_3_3_3_21_3_21_3_18_18_18_18_18_18_3_3_3_3
5033,203,1329866100,25,28,5,1329886800,20700,1870800,1897500,26700,7_7_7_7_7_7_7_7_7_7_7_1_1_7_7_7_7_7_7_7_7_7_17_17_17_17_4_17_4_4_4_17_17_1_1_2_2_13_9_9_3_9_3_13_4_17_13_9_3_9_3_17_3_3_4_4_9_13_3_4_3_17_17_15_1_26_17_17_9_15_1_15_1_17_4_13_13_15_1_1_15_4_4_13_9_3_1_13_4_15_1_3_13_1_26_3_13_6_6_15_26_15_5_26_25_26_26_5_25_3_3_3_4_4_4_13_4_4_13_4_4_4_4_4_4_4_26_4_5_4_4_5_4_26_15_15_26_26_15_15_15_25_15_5_5_25_26_26_6_6_5_5_26_25_26_25
5034,146,1329874920,4,5,4,1329880320,5400,4347720,6670800,2323080,16_16_16_16_16_16_16_1_16_1_16_1_1_16_1_16_16_2_1_1_16_1_2_16_2_2_3_3_3_3_21_21_3_3_3_3_3_21_3_21_3_3_3_3_21_3_21_3_18_18_18_18_18_18_3_3_3_3_4
5035,69,1329875100,4,5,37,1329925740,50640,1961160,2073180,112020,16_16_1_1_0_0_1_1_2_2_3_3_3_3_4_4_4_4_4_4
5036,54,1329875760,7,12,7,1329875820,60,114960,1314000,1199040,7_7_7_7_7_7
5037,54,1329875820,7,12,7,1329885240,9420,115020,1314000,1198980,7_7_7_7_7_7_7
5038,146,1329880320,4,5,4,1329880320,0,4353120,6670800,2317680,16_16_16_16_16_16_16_1_16_1_16_1_1_16_1_16_16_2_1_1_16_1_2_16_2_2_3_3_3_3_21_21_3_3_3_3_3_21_3_21_3_3_3_3_21_3_21_3_18_18_18_18_18_18_3_3_3_3_4_4
5039,146,1329880320,4,5,4,1329886560,6240,4353120,6670800,2317680,16_16_16_16_16_16_16_1_16_1_16_1_1_16_1_16_16_2_1_1_16_1_2_16_2_2_3_3_3_3_21_21_3_3_3_3_3_21_3_21_3_3_3_3_21_3_21_3_18_18_18_18_18_18_3_3_3_3_4_4_4
5040,71,1329883560,32,35,32,1329885900,2340,3621960,3996240,374280,29_29_1_1_7_7_1_7_1_7_7_7_7_7_1_7_1_7_7_7_7_7_7_1_1_7_7_7_7_7_7_7_7_1_1_7_7_7_7_1_1_1_1_7_7_1_7_1_7_7_7_7_7_7_7_1_7_7_7_1_7_7_7_7_7_7_7_1_7_1_7_7_7_7_7_7_7_1_7_7_7_32_1_32_32_5_5_32_7_7_32_32_32_32_32_32_32_32_32_32_7_32_7_32_32_32_32_32
5041,90,1329885180,19,14,1,1329888360,3180,170520,1532940,1362420,19_19_19_19_19_19_19_19_1_1_19_19_19_19_19_19_19_19
5042,169,1329885240,50,12,50,1329886440,1200,223500,2190660,1967160,50_50_50_50_50_50_50_50_50_50_50_50_50_50_50_50
5043,54,1329885240,7,12,7,1329937920,52680,124440,1314000,1189560,7_7_7_7_7_7_7_7
5044,217,1329885240,16,14,8,1329886320,1080,58440,557700,499260,16_16_16_16_16_16_16_16
5045,213,1329885480,0,14,0,1329886440,960,849060,3206820,2357760,0_0_0_0_0_1_0_1_0_0_0_0_0_0_0_0_1_1_0_0_0_0_0_0_0_1_1_0_0_0_0_0_0_0_0_0_0_0_0_0_0_1_1_1_0_1_0_0_0_0_0_0_0_0_0_0_1_0_1_0_0_0_0_0_0_0_0_0_0_0
5046,71,1329885900,32,34,32,1329891000,5100,3624300,3996240,371940,29_29_1_1_7_7_1_7_1_7_7_7_7_7_1_7_1_7_7_7_7_7_7_1_1_7_7_7_7_7_7_7_7_1_1_7_7_7_7_1_1_1_1_7_7_1_7_1_7_7_7_7_7_7_7_1_7_7_7_1_7_7_7_7_7_7_7_1_7_1_7_7_7_7_7_7_7_1_7_7_7_32_1_32_32_5_5_32_7_7_32_32_32_32_32_32_32_32_32_32_7_32_7_32_32_32_32_32_32
5047,156,1329885900,5,6,18,1329886560,660,2487180,2639280,152100,16_16_16_16_16_16_16_16_16_16_16_1_1_1_16_1_16_16_16_16_16_16_1_1_1_1_16_16_16_16_16_16_16_16_16_16_16_16_16_16_16_16_16_16_16_16_16_16_16_16_16_16_1_1_16_16_16_16_16_16_16_16_1_1_47_47_2_2_2_3_2_3_18_18_18_3_2_2_18_3_2_2_18_2_2_18_3_3_18_3_3_18_18_18_18_18_5_18_18_18_5_18_18_18_18_18_18_6_3_6_3_18_18_3_5_5_3_18_18_5
5048,19,1329886200,14,17,14,1329902940,16740,0,608940,608940,14
5049,177,1329886320,10,13,10,1329895140,8820,1129380,1713060,583680,10_10_10_10_10_10_10_10_10
5050,217,1329886320,8,9,8,1329886680,360,59520,557700,498180,16_16_16_16_16_16_16_16_8
5051,213,1329886440,0,0,0,1329889320,2880,850020,3206820,2356800,0_0_0_0_0_1_0_1_0_0_0_0_0_0_0_0_1_1_0_0_0_0_0_0_0_1_1_0_0_0_0_0_0_0_0_0_0_0_0_0_0_1_1_1_0_1_0_0_0_0_0_0_0_0_0_0_1_0_1_0_0_0_0_0_0_0_0_0_0_0_0
5052,169,1329886440,50,0,1,1329887820,1380,224700,2190660,1965960,50_50_50_50_50_50_50_50_50_50_50_50_50_50_50_50_50
5053,156,1329886560,18,5,18,1329886980,420,2487840,2639280,151440,16_16_16_16_16_16_16_16_16_16_16_1_1_1_16_1_16_16_16_16_16_16_1_1_1_1_16_16_16_16_16_16_16_16_16_16_16_16_16_16_16_16_16_16_16_16_16_16_16_16_16_16_1_1_16_16_16_16_16_16_16_16_1_1_47_47_2_2_2_3_2_3_18_18_18_3_2_2_18_3_2_2_18_2_2_18_3_3_18_3_3_18_18_18_18_18_5_18_18_18_5_18_18_18_18_18_18_6_3_6_3_18_18_3_5_5_3_18_18_5_18
5054,146,1329886560,4,5,4,1329896880,10320,4359360,6670800,2311440,16_16_16_16_16_16_16_1_16_1_16_1_1_16_1_16_16_2_1_1_16_1_2_16_2_2_3_3_3_3_21_21_3_3_3_3_3_21_3_21_3_3_3_3_21_3_21_3_18_18_18_18_18_18_3_3_3_3_4_4_4_4
5055,217,1329886680,8,9,16,1329888120,1440,59880,557700,497820,16_16_16_16_16_16_16_16_8_8
5056,203,1329886800,5,2,5,1329892800,6000,1891500,1897500,6000,7_7_7_7_7_7_7_7_7_7_7_1_1_7_7_7_7_7_7_7_7_7_17_17_17_17_4_17_4_4_4_17_17_1_1_2_2_13_9_9_3_9_3_13_4_17_13_9_3_9_3_17_3_3_4_4_9_13_3_4_3_17_17_15_1_26_17_17_9_15_1_15_1_17_4_13_13_15_1_1_15_4_4_13_9_3_1_13_4_15_1_3_13_1_26_3_13_6_6_15_26_15_5_26_25_26_26_5_25_3_3_3_4_4_4_13_4_4_13_4_4_4_4_4_4_4_26_4_5_4_4_5_4_26_15_15_26_26_15_15_15_25_15_5_5_25_26_26_6_6_5_5_26_25_26_25_5
5057,156,1329886980,18,22,18,1329887580,600,2488260,2639280,151020,16_16_16_16_16_16_16_16_16_16_16_1_1_1_16_1_16_16_16_16_16_16_1_1_1_1_16_16_16_16_16_16_16_16_16_16_16_16_16_16_16_16_16_16_16_16_16_16_16_16_16_16_1_1_16_16_16_16_16_16_16_16_1_1_47_47_2_2_2_3_2_3_18_18_18_3_2_2_18_3_2_2_18_2_2_18_3_3_18_3_3_18_18_18_18_18_5_18_18_18_5_18_18_18_18_18_18_6_3_6_3_18_18_3_5_5_3_18_18_5_18_18
5058,156,1329887580,18,22,18,1329892140,4560,2488860,2639280,150420,16_16_16_16_16_16_16_16_16_16_16_1_1_1_16_1_16_16_16_16_16_16_1_1_1_1_16_16_16_16_16_16_16_16_16_16_16_16_16_16_16_16_16_16_16_16_16_16_16_16_16_16_1_1_16_16_16_16_16_16_16_16_1_1_47_47_2_2_2_3_2_3_18_18_18_3_2_2_18_3_2_2_18_2_2_18_3_3_18_3_3_18_18_18_18_18_5_18_18_18_5_18_18_18_18_18_18_6_3_6_3_18_18_3_5_5_3_18_18_5_18_18_18
5059,169,1329887820,1,9,1,1329888360,540,226080,2190660,1964580,50_50_50_50_50_50_50_50_50_50_50_50_50_50_50_50_50_1
5060,217,1329888120,16,11,16,1329889320,1200,61320,557700,496380,16_16_16_16_16_16_16_16_8_8_16
5061,157,1329888180,19,11,19,1329905460,17280,0,1993260,1993260,19
5062,90,1329888360,1,9,1,1329889500,1140,173700,1532940,1359240,19_19_19_19_19_19_19_19_1_1_19_19_19_19_19_19_19_19_1
5063,169,1329888360,1,9,50,1329919020,30660,226620,2190660,1964040,50_50_50_50_50_50_50_50_50_50_50_50_50_50_50_50_50_1_1
5064,217,1329889320,16,11,16,1329889320,0,62520,557700,495180,16_16_16_16_16_16_16_16_8_8_16_16
5065,213,1329889320,0,0,0,1329889320,0,852900,3206820,2353920,0_0_0_0_0_1_0_1_0_0_0_0_0_0_0_0_1_1_0_0_0_0_0_0_0_1_1_0_0_0_0_0_0_0_0_0_0_0_0_0_0_1_1_1_0_1_0_0_0_0_0_0_0_0_0_0_1_0_1_0_0_0_0_0_0_0_0_0_0_0_0_0
5066,217,1329889320,16,0,16,1329918960,29640,62520,557700,495180,16_16_16_16_16_16_16_16_8_8_16_16_16
5067,213,1329889320,0,11,0,1329919080,29760,852900,3206820,2353920,0_0_0_0_0_1_0_1_0_0_0_0_0_0_0_0_1_1_0_0_0_0_0_0_0_1_1_0_0_0_0_0_0_0_0_0_0_0_0_0_0_1_1_1_0_1_0_0_0_0_0_0_0_0_0_0_1_0_1_0_0_0_0_0_0_0_0_0_0_0_0_0_0
5068,90,1329889500,1,9,1,1329916560,27060,174840,1532940,1358100,19_19_19_19_19_19_19_19_1_1_19_19_19_19_19_19_19_19_1_1
5069,135,1329889560,5,9,5,1329918060,28500,3815160,5649480,1834320,19_19_19_19_19_19_19_19_19_19_19_19_1_19_1_19_19_19_1_1_1_1_19_19_19_19_19_19_1_1_1_1_19_19_19_19_19_19_19_19_19_19_19_19_1_19_1_19_19_19_19_19_19_1_19_1_1_1_2_2_1_1_2_2_9_3_3_9_3_3_2_9_9_9_2_4_4_3_4_3_3_9_3_4_4_4_4_9_3_9_3_4_4_4_4_4_5_5_5_5_5
5070,196,1329890640,7,8,7,1329910140,19500,89940,3281700,3191760,7_7_7_7_7
5071,71,1329891000,32,34,32,1329898200,7200,3629400,3996240,366840,29_29_1_1_7_7_1_7_1_7_7_7_7_7_1_7_1_7_7_7_7_7_7_1_1_7_7_7_7_7_7_7_7_1_1_7_7_7_7_1_1_1_1_7_7_1_7_1_7_7_7_7_7_7_7_1_7_7_7_1_7_7_7_7_7_7_7_1_7_1_7_7_7_7_7_7_7_1_7_7_7_32_1_32_32_5_5_32_7_7_32_32_32_32_32_32_32_32_32_32_7_32_7_32_32_32_32_32_32_32
5072,98,1329891900,2,3,2,1329894720,2820,4152480,7319880,3167400,34_34_2_2_35_35_34_34_2_2_3_3_3_3_3_3_18_18_3_3_3_18_3_3_3_18_18_18_18_3_3_18_18_18_18_18_18_18_18_3_3_18_39_3_3_39_3_3_3_3_4_4_5_5_5_5_5_5_4_4_4_5_3_5_5_3_5_4_4_4_5_5_5_5_6_6_6_6_5_5_5_5_5_5_5_5_5_5_5_5_6_6_5_5_34_34_6_6_5_5_5_5_5_5_5_5_5_5_5_5_2
5073,156,1329892140,18,23,5,1329900300,8160,2493420,2639280,145860,16_16_16_16_16_16_16_16_16_16_16_1_1_1_16_1_16_16_16_16_16_16_1_1_1_1_16_16_16_16_16_16_16_16_16_16_16_16_16_16_16_16_16_16_16_16_16_16_16_16_16_16_1_1_16_16_16_16_16_16_16_16_1_1_47_47_2_2_2_3_2_3_18_18_18_3_2_2_18_3_2_2_18_2_2_18_3_3_18_3_3_18_18_18_18_18_5_18_18_18_5_18_18_18_18_18_18_6_3_6_3_18_18_3_5_5_3_18_18_5_18_18_18_18
5074,203,1329892800,5,2,99,1329892800,0,1897500,1897500,0,7_7_7_7_7_7_7_7_7_7_7_1_1_7_7_7_7_7_7_7_7_7_17_17_17_17_4_17_4_4_4_17_17_1_1_2_2_13_9_9_3_9_3_13_4_17_13_9_3_9_3_17_3_3_4_4_9_13_3_4_3_17_17_15_1_26_17_17_9_15_1_15_1_17_4_13_13_15_1_1_15_4_4_13_9_3_1_13_4_15_1_3_13_1_26_3_13_6_6_15_26_15_5_26_25_26_26_5_25_3_3_3_4_4_4_13_4_4_13_4_4_4_4_4_4_4_26_4_5_4_4_5_4_26_15_15_26_26_15_15_15_25_15_5_5_25_26_26_6_6_5_5_26_25_26_25_5_5
5075,62,1329894000,5,2,5,1329901200,7200,3592860,3674460,81600,34_34_5_5_6_6_11_11_5
5076,180,1329894420,3,4,3,1329899820,5400,1104000,3322080,2218080,50_50_50_50_50_50_1_50_1_50_50_50_50_50_50_50_50_50_1_1_2_2_9_9_9_9_3_3_3
5077,98,1329894720,2,3,5,1329919800,25080,4155300,7319880,3164580,34_34_2_2_35_35_34_34_2_2_3_3_3_3_3_3_18_18_3_3_3_18_3_3_3_18_18_18_18_3_3_18_18_18_18_18_18_18_18_3_3_18_39_3_3_39_3_3_3_3_4_4_5_5_5_5_5_5_4_4_4_5_3_5_5_3_5_4_4_4_5_5_5_5_6_6_6_6_5_5_5_5_5_5_5_5_5_5_5_5_6_6_5_5_34_34_6_6_5_5_5_5_5_5_5_5_5_5_5_5_2_2
5078,177,1329895140,10,13,10,1329895200,60,1138200,1713060,574860,10_10_10_10_10_10_10_10_10_10
5079,177,1329895200,10,13,10,1329896520,1320,1138260,1713060,574800,10_10_10_10_10_10_10_10_10_10_10
5080,63,1329895740,3,3,3,1329922740,27000,3044280,6232860,3188580,16_16_16_16_16_16_16_16_16_0_0_16_16_0_16_16_0_16_16_0_0_16_16_16_0_0_16_0_0_16_0_16_0_0_0_16_1_1_1_16_16_16_0_1_1_1_16_0_0_16_16_0_16_0_16_0_0_2_2_1_1_0_0_0_0_2_2_2_2_2_2_0_1_0_1_1_0_0_0_1_1_0_0_1_1_1_0_0_0_0_0_2_2_2_2_0_0_0_0_0_0_1_1_1_1_0_0_16_0_16_16_16_16_16_0_0_1_1_2_2_1_1_16_0_2_16_2_2_2_0_1_1_1_1_1_16_16_1_1_1_3_3_18_3_18_3_3_3_3
5081,177,1329896520,10,13,10,1329926520,30000,1139580,1713060,573480,10_10_10_10_10_10_10_10_10_10_10_10_10
5082,177,1329896520,10,13,10,1329896520,0,1139580,1713060,573480,10_10_10_10_10_10_10_10_10_10_10_10
5083,146,1329896880,4,22,4,1329918780,21900,4369680,6670800,2301120,16_16_16_16_16_16_16_1_16_1_16_1_1_16_1_16_16_2_1_1_16_1_2_16_2_2_3_3_3_3_21_21_3_3_3_3_3_21_3_21_3_3_3_3_21_3_21_3_18_18_18_18_18_18_3_3_3_3_4_4_4_4_4
5084,71,1329898200,32,34,32,1329919200,21000,3636600,3996240,359640,29_29_1_1_7_7_1_7_1_7_7_7_7_7_1_7_1_7_7_7_7_7_7_1_1_7_7_7_7_7_7_7_7_1_1_7_7_7_7_1_1_1_1_7_7_1_7_1_7_7_7_7_7_7_7_1_7_7_7_1_7_7_7_7_7_7_7_1_7_1_7_7_7_7_7_7_7_1_7_7_7_32_1_32_32_5_5_32_7_7_32_32_32_32_32_32_32_32_32_32_7_32_7_32_32_32_32_32_32_32_32
5085,180,1329899820,3,4,5,1329985260,85440,1109400,3322080,2212680,50_50_50_50_50_50_1_50_1_50_50_50_50_50_50_50_50_50_1_1_2_2_9_9_9_9_3_3_3_3
5086,156,1329900300,5,6,18,1329917040,16740,2501580,2639280,137700,16_16_16_16_16_16_16_16_16_16_16_1_1_1_16_1_16_16_16_16_16_16_1_1_1_1_16_16_16_16_16_16_16_16_16_16_16_16_16_16_16_16_16_16_16_16_16_16_16_16_16_16_1_1_16_16_16_16_16_16_16_16_1_1_47_47_2_2_2_3_2_3_18_18_18_3_2_2_18_3_2_2_18_2_2_18_3_3_18_3_3_18_18_18_18_18_5_18_18_18_5_18_18_18_18_18_18_6_3_6_3_18_18_3_5_5_3_18_18_5_18_18_18_18_5
5087,62,1329901200,5,2,6,1329948000,46800,3600060,3674460,74400,34_34_5_5_6_6_11_11_5_5
5088,108,1329901200,5,2,5,1329907800,6600,3185340,3191940,6600,1_1_1_17_1_17_17_17_17_17_17_17_1_1_17_17_7_7_17_17_1_1_1_1_17_17_1_1_17_17_41_41_1_1_1_1_25_2_9_9_3_25_2_3_18_18_4_4_4_4_4_4_14_1_1_14_4_4_4_25_4_25_34_34_6_6_5_5_5_5_5_5_5_5_5_5_5
5089,19,1329902940,14,17,14,1329921420,18480,16740,608940,592200,14_14_14
5090,19,1329902940,14,17,14,1329902940,0,16740,608940,592200,14_14
5091,103,1329903000,44,41,44,1329913800,10800,4102020,4719960,617940,19_19_19_19_19_19_19_1_1_19_19_19_19_1_1_19_19_19_19_19_1_1_2_2_9_2_2_9_9_9_9_9_14_14_14_14_13_13_13_13_13_14_13_14_14_14_13_13_13_13_13_13_44
5092,157,1329905460,19,11,1,1329905520,60,17280,1993260,1975980,19_19
5093,157,1329905520,1,9,19,1329905520,0,17340,1993260,1975920,19_19_1
5094,157,1329905520,19,11,1,1329907260,1740,17340,1993260,1975920,19_19_1_19
5095,157,1329907260,1,9,19,1329912420,5160,19080,1993260,1974180,19_19_1_19_1
5096,108,1329907800,5,2,99,1329907800,0,3191940,3191940,0,1_1_1_17_1_17_17_17_17_17_17_17_1_1_17_17_7_7_17_17_1_1_1_1_17_17_1_1_17_17_41_41_1_1_1_1_25_2_9_9_3_25_2_3_18_18_4_4_4_4_4_4_14_1_1_14_4_4_4_25_4_25_34_34_6_6_5_5_5_5_5_5_5_5_5_5_5_5
5097,141,1329909600,5,2,5,1329913200,3600,4256400,7406100,3149700,1_1_16_16_16_16_16_1_16_16_1_1_1_16_16_16_16_16_16_16_16_16_16_16_16_16_16_16_1_1_1_1_1_1_1_1_1_1_1_1_16_2_2_16_3_3_3_3_3_3_18_18_18_18_18_3_18_3_3_3_5_5_5_5_5_5_3_3_4_4_4_4_4_3_1_3_1_4_18_3_3_18_18_1_1_18_18_5_5_18_5_5_5_5_6_6_5_5_6_6_6_6_5_5_5_5_5_5_5_5_6_6_5
5098,196,1329910140,7,8,7,1329910260,120,109440,3281700,3172260,7_7_7_7_7_7
5099,196,1329910260,7,8,7,1329919680,9420,109560,3281700,3172140,7_7_7_7_7_7_7
5100,157,1329912420,19,11,19,1329912420,0,24240,1993260,1969020,19_19_1_19_1_19
5101,157,1329912420,19,11,19,1329919080,6660,24240,1993260,1969020,19_19_1_19_1_19_19
5102,141,1329913200,5,2,5,1329913200,0,4260000,7406100,3146100,1_1_16_16_16_16_16_1_16_16_1_1_1_16_16_16_16_16_16_16_16_16_16_16_16_16_16_16_1_1_1_1_1_1_1_1_1_1_1_1_16_2_2_16_3_3_3_3_3_3_18_18_18_18_18_3_18_3_3_3_5_5_5_5_5_5_3_3_4_4_4_4_4_3_1_3_1_4_18_3_3_18_18_1_1_18_18_5_5_18_5_5_5_5_6_6_5_5_6_6_6_6_5_5_5_5_5_5_5_5_6_6_5_5
5103,141,1329913200,5,2,5,1329915000,1800,4260000,7406100,3146100,1_1_16_16_16_16_16_1_16_16_1_1_1_16_16_16_16_16_16_16_16_16_16_16_16_16_16_16_1_1_1_1_1_1_1_1_1_1_1_1_16_2_2_16_3_3_3_3_3_3_18_18_18_18_18_3_18_3_3_3_5_5_5_5_5_5_3_3_4_4_4_4_4_3_1_3_1_4_18_3_3_18_18_1_1_18_18_5_5_18_5_5_5_5_6_6_5_5_6_6_6_6_5_5_5_5_5_5_5_5_6_6_5_5_5
5104,103,1329913800,44,41,44,1329914280,480,4112820,4719960,607140,19_19_19_19_19_19_19_1_1_19_19_19_19_1_1_19_19_19_19_19_1_1_2_2_9_2_2_9_9_9_9_9_14_14_14_14_13_13_13_13_13_14_13_14_14_14_13_13_13_13_13_13_44_44
5105,103,1329914280,44,41,44,1329914700,420,4113300,4719960,606660,19_19_19_19_19_19_19_1_1_19_19_19_19_1_1_19_19_19_19_19_1_1_2_2_9_2_2_9_9_9_9_9_14_14_14_14_13_13_13_13_13_14_13_14_14_14_13_13_13_13_13_13_44_44_44
5106,103,1329914700,44,41,44,1329914700,0,4113720,4719960,606240,19_19_19_19_19_19_19_1_1_19_19_19_19_1_1_19_19_19_19_19_1_1_2_2_9_2_2_9_9_9_9_9_14_14_14_14_13_13_13_13_13_14_13_14_14_14_13_13_13_13_13_13_44_44_44_44
5107,103,1329914700,44,41,13,1329919080,4380,4113720,4719960,606240,19_19_19_19_19_19_19_1_1_19_19_19_19_1_1_19_19_19_19_19_1_1_2_2_9_2_2_9_9_9_9_9_14_14_14_14_13_13_13_13_13_14_13_14_14_14_13_13_13_13_13_13_44_44_44_44_44
5108,2,1329914880,1,9,1,1329916200,1320,164340,2555640,2391300,10_10_10_10_10_10_10_10_1
5109,141,1329915000,5,2,5,1329916200,1200,4261800,7406100,3144300,1_1_16_16_16_16_16_1_16_16_1_1_1_16_16_16_16_16_16_16_16_16_16_16_16_16_16_16_1_1_1_1_1_1_1_1_1_1_1_1_16_2_2_16_3_3_3_3_3_3_18_18_18_18_18_3_18_3_3_3_5_5_5_5_5_5_3_3_4_4_4_4_4_3_1_3_1_4_18_3_3_18_18_1_1_18_18_5_5_18_5_5_5_5_6_6_5_5_6_6_6_6_5_5_5_5_5_5_5_5_6_6_5_5_5_5_5
5110,141,1329915000,5,2,5,1329915000,0,4261800,7406100,3144300,1_1_16_16_16_16_16_1_16_16_1_1_1_16_16_16_16_16_16_16_16_16_16_16_16_16_16_16_1_1_1_1_1_1_1_1_1_1_1_1_16_2_2_16_3_3_3_3_3_3_18_18_18_18_18_3_18_3_3_3_5_5_5_5_5_5_3_3_4_4_4_4_4_3_1_3_1_4_18_3_3_18_18_1_1_18_18_5_5_18_5_5_5_5_6_6_5_5_6_6_6_6_5_5_5_5_5_5_5_5_6_6_5_5_5_5
5111,141,1329916200,5,2,5,1329917400,1200,4263000,7406100,3143100,1_1_16_16_16_16_16_1_16_16_1_1_1_16_16_16_16_16_16_16_16_16_16_16_16_16_16_16_1_1_1_1_1_1_1_1_1_1_1_1_16_2_2_16_3_3_3_3_3_3_18_18_18_18_18_3_18_3_3_3_5_5_5_5_5_5_3_3_4_4_4_4_4_3_1_3_1_4_18_3_3_18_18_1_1_18_18_5_5_18_5_5_5_5_6_6_5_5_6_6_6_6_5_5_5_5_5_5_5_5_6_6_5_5_5_5_5_5_5
5112,141,1329916200,5,2,5,1329916200,0,4263000,7406100,3143100,1_1_16_16_16_16_16_1_16_16_1_1_1_16_16_16_16_16_16_16_16_16_16_16_16_16_16_16_1_1_1_1_1_1_1_1_1_1_1_1_16_2_2_16_3_3_3_3_3_3_18_18_18_18_18_3_18_3_3_3_5_5_5_5_5_5_3_3_4_4_4_4_4_3_1_3_1_4_18_3_3_18_18_1_1_18_18_5_5_18_5_5_5_5_6_6_5_5_6_6_6_6_5_5_5_5_5_5_5_5_6_6_5_5_5_5_5_5
5113,2,1329916200,1,9,2,1331456700,1540500,165660,2555640,2389980,10_10_10_10_10_10_10_10_1_1
5114,187,1329916260,1,9,1,1329918420,2160,265440,2496960,2231520,10_10_10_10_10_10_10_10_10_10_10_10_1
5115,90,1329916560,1,9,1,1329916800,240,201900,1532940,1331040,19_19_19_19_19_19_19_19_1_1_19_19_19_19_19_19_19_19_1_1_1
5116,90,1329916800,1,9,9,1329998340,81540,202140,1532940,1330800,19_19_19_19_19_19_19_19_1_1_19_19_19_19_19_19_19_19_1_1_1_1
5117,156,1329917040,18,23,18,1329917160,120,2518320,2639280,120960,16_16_16_16_16_16_16_16_16_16_16_1_1_1_16_1_16_16_16_16_16_16_1_1_1_1_16_16_16_16_16_16_16_16_16_16_16_16_16_16_16_16_16_16_16_16_16_16_16_16_16_16_1_1_16_16_16_16_16_16_16_16_1_1_47_47_2_2_2_3_2_3_18_18_18_3_2_2_18_3_2_2_18_2_2_18_3_3_18_3_3_18_18_18_18_18_5_18_18_18_5_18_18_18_18_18_18_6_3_6_3_18_18_3_5_5_3_18_18_5_18_18_18_18_5_18
5118,156,1329917160,18,23,18,1329919260,2100,2518440,2639280,120840,16_16_16_16_16_16_16_16_16_16_16_1_1_1_16_1_16_16_16_16_16_16_1_1_1_1_16_16_16_16_16_16_16_16_16_16_16_16_16_16_16_16_16_16_16_16_16_16_16_16_16_16_1_1_16_16_16_16_16_16_16_16_1_1_47_47_2_2_2_3_2_3_18_18_18_3_2_2_18_3_2_2_18_2_2_18_3_3_18_3_3_18_18_18_18_18_5_18_18_18_5_18_18_18_18_18_18_6_3_6_3_18_18_3_5_5_3_18_18_5_18_18_18_18_5_18_18
5119,141,1329917400,5,2,5,1329917400,0,4264200,7406100,3141900,1_1_16_16_16_16_16_1_16_16_1_1_1_16_16_16_16_16_16_16_16_16_16_16_16_16_16_16_1_1_1_1_1_1_1_1_1_1_1_1_16_2_2_16_3_3_3_3_3_3_18_18_18_18_18_3_18_3_3_3_5_5_5_5_5_5_3_3_4_4_4_4_4_3_1_3_1_4_18_3_3_18_18_1_1_18_18_5_5_18_5_5_5_5_6_6_5_5_6_6_6_6_5_5_5_5_5_5_5_5_6_6_5_5_5_5_5_5_5_5
5120,141,1329917400,5,2,5,1329918600,1200,4264200,7406100,3141900,1_1_16_16_16_16_16_1_16_16_1_1_1_16_16_16_16_16_16_16_16_16_16_16_16_16_16_16_1_1_1_1_1_1_1_1_1_1_1_1_16_2_2_16_3_3_3_3_3_3_18_18_18_18_18_3_18_3_3_3_5_5_5_5_5_5_3_3_4_4_4_4_4_3_1_3_1_4_18_3_3_18_18_1_1_18_18_5_5_18_5_5_5_5_6_6_5_5_6_6_6_6_5_5_5_5_5_5_5_5_6_6_5_5_5_5_5_5_5_5_5
5121,135,1329918060,5,9,6,1329948000,29940,3843660,5649480,1805820,19_19_19_19_19_19_19_19_19_19_19_19_1_19_1_19_19_19_1_1_1_1_19_19_19_19_19_19_1_1_1_1_19_19_19_19_19_19_19_19_19_19_19_19_1_19_1_19_19_19_19_19_19_1_19_1_1_1_2_2_1_1_2_2_9_3_3_9_3_3_2_9_9_9_2_4_4_3_4_3_3_9_3_4_4_4_4_9_3_9_3_4_4_4_4_4_5_5_5_5_5_5
5122,187,1329918420,1,9,1,1331112480,1194060,267600,2496960,2229360,10_10_10_10_10_10_10_10_10_10_10_10_1_1
5123,141,1329918600,5,2,5,1329918600,0,4265400,7406100,3140700,1_1_16_16_16_16_16_1_16_16_1_1_1_16_16_16_16_16_16_16_16_16_16_16_16_16_16_16_1_1_1_1_1_1_1_1_1_1_1_1_16_2_2_16_3_3_3_3_3_3_18_18_18_18_18_3_18_3_3_3_5_5_5_5_5_5_3_3_4_4_4_4_4_3_1_3_1_4_18_3_3_18_18_1_1_18_18_5_5_18_5_5_5_5_6_6_5_5_6_6_6_6_5_5_5_5_5_5_5_5_6_6_5_5_5_5_5_5_5_5_5_5
5124,141,1329918600,5,2,5,1329919800,1200,4265400,7406100,3140700,1_1_16_16_16_16_16_1_16_16_1_1_1_16_16_16_16_16_16_16_16_16_16_16_16_16_16_16_1_1_1_1_1_1_1_1_1_1_1_1_16_2_2_16_3_3_3_3_3_3_18_18_18_18_18_3_18_3_3_3_5_5_5_5_5_5_3_3_4_4_4_4_4_3_1_3_1_4_18_3_3_18_18_1_1_18_18_5_5_18_5_5_5_5_6_6_5_5_6_6_6_6_5_5_5_5_5_5_5_5_6_6_5_5_5_5_5_5_5_5_5_5_5
5125,146,1329918780,4,22,4,1329933780,15000,4391580,6670800,2279220,16_16_16_16_16_16_16_1_16_1_16_1_1_16_1_16_16_2_1_1_16_1_2_16_2_2_3_3_3_3_21_21_3_3_3_3_3_21_3_21_3_3_3_3_21_3_21_3_18_18_18_18_18_18_3_3_3_3_4_4_4_4_4_4
5126,217,1329918960,16,0,16,1329927180,8220,92160,557700,465540,16_16_16_16_16_16_16_16_8_8_16_16_16_16
5127,169,1329919020,50,0,50,1329934860,15840,257280,2190660,1933380,50_50_50_50_50_50_50_50_50_50_50_50_50_50_50_50_50_1_1_50
5128,157,1329919080,19,11,19,1329927180,8100,30900,1993260,1962360,19_19_1_19_1_19_19_19
5129,213,1329919080,0,11,0,1329927120,8040,882660,3206820,2324160,0_0_0_0_0_1_0_1_0_0_0_0_0_0_0_0_1_1_0_0_0_0_0_0_0_1_1_0_0_0_0_0_0_0_0_0_0_0_0_0_0_1_1_1_0_1_0_0_0_0_0_0_0_0_0_0_1_0_1_0_0_0_0_0_0_0_0_0_0_0_0_0_0_0
5130,103,1329919080,13,15,44,1329919200,120,4118100,4719960,601860,19_19_19_19_19_19_19_1_1_19_19_19_19_1_1_19_19_19_19_19_1_1_2_2_9_2_2_9_9_9_9_9_14_14_14_14_13_13_13_13_13_14_13_14_14_14_13_13_13_13_13_13_44_44_44_44_44_13
5131,103,1329919200,44,41,13,1329921480,2280,4118220,4719960,601740,19_19_19_19_19_19_19_1_1_19_19_19_19_1_1_19_19_19_19_19_1_1_2_2_9_2_2_9_9_9_9_9_14_14_14_14_13_13_13_13_13_14_13_14_14_14_13_13_13_13_13_13_44_44_44_44_44_13_44
5132,71,1329919200,32,34,32,1329933960,14760,3657600,3996240,338640,29_29_1_1_7_7_1_7_1_7_7_7_7_7_1_7_1_7_7_7_7_7_7_1_1_7_7_7_7_7_7_7_7_1_1_7_7_7_7_1_1_1_1_7_7_1_7_1_7_7_7_7_7_7_7_1_7_7_7_1_7_7_7_7_7_7_7_1_7_1_7_7_7_7_7_7_7_1_7_7_7_32_1_32_32_5_5_32_7_7_32_32_32_32_32_32_32_32_32_32_7_32_7_32_32_32_32_32_32_32_32_32
5133,156,1329919260,18,23,18,1329919680,420,2520540,2639280,118740,16_16_16_16_16_16_16_16_16_16_16_1_1_1_16_1_16_16_16_16_16_16_1_1_1_1_16_16_16_16_16_16_16_16_16_16_16_16_16_16_16_16_16_16_16_16_16_16_16_16_16_16_1_1_16_16_16_16_16_16_16_16_1_1_47_47_2_2_2_3_2_3_18_18_18_3_2_2_18_3_2_2_18_2_2_18_3_3_18_3_3_18_18_18_18_18_5_18_18_18_5_18_18_18_18_18_18_6_3_6_3_18_18_3_5_5_3_18_18_5_18_18_18_18_5_18_18_18
5134,156,1329919680,18,19,18,1329922020,2340,2520960,2639280,118320,16_16_16_16_16_16_16_16_16_16_16_1_1_1_16_1_16_16_16_16_16_16_1_1_1_1_16_16_16_16_16_16_16_16_16_16_16_16_16_16_16_16_16_16_16_16_16_16_16_16_16_16_1_1_16_16_16_16_16_16_16_16_1_1_47_47_2_2_2_3_2_3_18_18_18_3_2_2_18_3_2_2_18_2_2_18_3_3_18_3_3_18_18_18_18_18_5_18_18_18_5_18_18_18_18_18_18_6_3_6_3_18_18_3_5_5_3_18_18_5_18_18_18_18_5_18_18_18_18
5135,196,1329919680,7,8,7,1329973860,54180,118980,3281700,3162720,7_7_7_7_7_7_7_7
5136,141,1329919800,5,2,34,1330971840,1052040,4266600,7406100,3139500,1_1_16_16_16_16_16_1_16_16_1_1_1_16_16_16_16_16_16_16_16_16_16_16_16_16_16_16_1_1_1_1_1_1_1_1_1_1_1_1_16_2_2_16_3_3_3_3_3_3_18_18_18_18_18_3_18_3_3_3_5_5_5_5_5_5_3_3_4_4_4_4_4_3_1_3_1_4_18_3_3_18_18_1_1_18_18_5_5_18_5_5_5_5_6_6_5_5_6_6_6_6_5_5_5_5_5_5_5_5_6_6_5_5_5_5_5_5_5_5_5_5_5_5
5137,98,1329919800,5,2,18,1329922080,2280,4180380,7319880,3139500,34_34_2_2_35_35_34_34_2_2_3_3_3_3_3_3_18_18_3_3_3_18_3_3_3_18_18_18_18_3_3_18_18_18_18_18_18_18_18_3_3_18_39_3_3_39_3_3_3_3_4_4_5_5_5_5_5_5_4_4_4_5_3_5_5_3_5_4_4_4_5_5_5_5_6_6_6_6_5_5_5_5_5_5_5_5_5_5_5_5_6_6_5_5_34_34_6_6_5_5_5_5_5_5_5_5_5_5_5_5_2_2_5
5138,19,1329921420,14,17,14,1329921540,120,35220,608940,573720,14_14_14_14
5139,103,1329921480,13,17,13,1329921540,60,4120500,4719960,599460,19_19_19_19_19_19_19_1_1_19_19_19_19_1_1_19_19_19_19_19_1_1_2_2_9_2_2_9_9_9_9_9_14_14_14_14_13_13_13_13_13_14_13_14_14_14_13_13_13_13_13_13_44_44_44_44_44_13_44_13
5140,19,1329921540,14,15,14,1329932280,10740,35340,608940,573600,14_14_14_14_14
5141,103,1329921540,13,15,13,1329924900,3360,4120560,4719960,599400,19_19_19_19_19_19_19_1_1_19_19_19_19_1_1_19_19_19_19_19_1_1_2_2_9_2_2_9_9_9_9_9_14_14_14_14_13_13_13_13_13_14_13_14_14_14_13_13_13_13_13_13_44_44_44_44_44_13_44_13_13
5142,156,1329922020,18,19,5,1329973200,51180,2523300,2639280,115980,16_16_16_16_16_16_16_16_16_16_16_1_1_1_16_1_16_16_16_16_16_16_1_1_1_1_16_16_16_16_16_16_16_16_16_16_16_16_16_16_16_16_16_16_16_16_16_16_16_16_16_16_1_1_16_16_16_16_16_16_16_16_1_1_47_47_2_2_2_3_2_3_18_18_18_3_2_2_18_3_2_2_18_2_2_18_3_3_18_3_3_18_18_18_18_18_5_18_18_18_5_18_18_18_18_18_18_6_3_6_3_18_18_3_5_5_3_18_18_5_18_18_18_18_5_18_18_18_18_18
5143,98,1329922080,18,19,5,1329923400,1320,4182660,7319880,3137220,34_34_2_2_35_35_34_34_2_2_3_3_3_3_3_3_18_18_3_3_3_18_3_3_3_18_18_18_18_3_3_18_18_18_18_18_18_18_18_3_3_18_39_3_3_39_3_3_3_3_4_4_5_5_5_5_5_5_4_4_4_5_3_5_5_3_5_4_4_4_5_5_5_5_6_6_6_6_5_5_5_5_5_5_5_5_5_5_5_5_6_6_5_5_34_34_6_6_5_5_5_5_5_5_5_5_5_5_5_5_2_2_5_18
5144,63,1329922740,3,3,18,1329949620,26880,3071280,6232860,3161580,16_16_16_16_16_16_16_16_16_0_0_16_16_0_16_16_0_16_16_0_0_16_16_16_0_0_16_0_0_16_0_16_0_0_0_16_1_1_1_16_16_16_0_1_1_1_16_0_0_16_16_0_16_0_16_0_0_2_2_1_1_0_0_0_0_2_2_2_2_2_2_0_1_0_1_1_0_0_0_1_1_0_0_1_1_1_0_0_0_0_0_2_2_2_2_0_0_0_0_0_0_1_1_1_1_0_0_16_0_16_16_16_16_16_0_0_1_1_2_2_1_1_16_0_2_16_2_2_2_0_1_1_1_1_1_16_16_1_1_1_3_3_18_3_18_3_3_3_3_3
5145,131,1329922800,5,2,5,1329926520,3720,3662700,6825900,3163200,16_16_16_16_16_16_16_16_16_16_16_16_16_16_16_16_16_16_16_16_16_16_16_16_16_16_1_1_1_1_2_2_3_3_3_3_18_18_18_18_18_3_3_3_3_18_18_18_18_18_18_18_18_18_18_18_18_18_18_18_18_18_18_18_5_5_5_5_5_5_5_5_5_5_5_5_6_6_5_5_6_6_5_5_5
5146,98,1329923400,5,2,18,1329932880,9480,4183980,7319880,3135900,34_34_2_2_35_35_34_34_2_2_3_3_3_3_3_3_18_18_3_3_3_18_3_3_3_18_18_18_18_3_3_18_18_18_18_18_18_18_18_3_3_18_39_3_3_39_3_3_3_3_4_4_5_5_5_5_5_5_4_4_4_5_3_5_5_3_5_4_4_4_5_5_5_5_6_6_6_6_5_5_5_5_5_5_5_5_5_5_5_5_6_6_5_5_34_34_6_6_5_5_5_5_5_5_5_5_5_5_5_5_2_2_5_18_5
5147,103,1329924900,13,17,44,1329972960,48060,4123920,4719960,596040,19_19_19_19_19_19_19_1_1_19_19_19_19_1_1_19_19_19_19_19_1_1_2_2_9_2_2_9_9_9_9_9_14_14_14_14_13_13_13_13_13_14_13_14_14_14_13_13_13_13_13_13_44_44_44_44_44_13_44_13_13_13
5148,69,1329925740,37,6,37,1329930240,4500,2011800,2073180,61380,16_16_1_1_0_0_1_1_2_2_3_3_3_3_4_4_4_4_4_4_37
5149,131,1329926520,5,2,5,1329985800,59280,3666420,6825900,3159480,16_16_16_16_16_16_16_16_16_16_16_16_16_16_16_16_16_16_16_16_16_16_16_16_16_16_1_1_1_1_2_2_3_3_3_3_18_18_18_18_18_3_3_3_3_18_18_18_18_18_18_18_18_18_18_18_18_18_18_18_18_18_18_18_5_5_5_5_5_5_5_5_5_5_5_5_6_6_5_5_6_6_5_5_5_5
5150,177,1329926520,10,13,10,1329972540,46020,1169580,1713060,543480,10_10_10_10_10_10_10_10_10_10_10_10_10_10
5151,213,1329927120,0,1,0,1329947100,19980,890700,3206820,2316120,0_0_0_0_0_1_0_1_0_0_0_0_0_0_0_0_1_1_0_0_0_0_0_0_0_1_1_0_0_0_0_0_0_0_0_0_0_0_0_0_0_1_1_1_0_1_0_0_0_0_0_0_0_0_0_0_1_0_1_0_0_0_0_0_0_0_0_0_0_0_0_0_0_0_0
5152,217,1329927180,16,1,16,1329934920,7740,100380,557700,457320,16_16_16_16_16_16_16_16_8_8_16_16_16_16_16
5153,157,1329927180,19,1,19,1329947040,19860,39000,1993260,1954260,19_19_1_19_1_19_19_19_19
5154,69,1329930240,37,6,6,1329948000,17760,2016300,2073180,56880,16_16_1_1_0_0_1_1_2_2_3_3_3_3_4_4_4_4_4_4_37_37
5155,19,1329932280,14,15,6,1329948000,15720,46080,608940,562860,14_14_14_14_14_14
5156,98,1329932880,18,19,18,1329946980,14100,4193460,7319880,3126420,34_34_2_2_35_35_34_34_2_2_3_3_3_3_3_3_18_18_3_3_3_18_3_3_3_18_18_18_18_3_3_18_18_18_18_18_18_18_18_3_3_18_39_3_3_39_3_3_3_3_4_4_5_5_5_5_5_5_4_4_4_5_3_5_5_3_5_4_4_4_5_5_5_5_6_6_6_6_5_5_5_5_5_5_5_5_5_5_5_5_6_6_5_5_34_34_6_6_5_5_5_5_5_5_5_5_5_5_5_5_2_2_5_18_5_18_18
5157,98,1329932880,18,19,18,1329932880,0,4193460,7319880,3126420,34_34_2_2_35_35_34_34_2_2_3_3_3_3_3_3_18_18_3_3_3_18_3_3_3_18_18_18_18_3_3_18_18_18_18_18_18_18_18_3_3_18_39_3_3_39_3_3_3_3_4_4_5_5_5_5_5_5_4_4_4_5_3_5_5_3_5_4_4_4_5_5_5_5_6_6_6_6_5_5_5_5_5_5_5_5_5_5_5_5_6_6_5_5_34_34_6_6_5_5_5_5_5_5_5_5_5_5_5_5_2_2_5_18_5_18
5158,146,1329933780,4,5,4,1329965160,31380,4406580,6670800,2264220,16_16_16_16_16_16_16_1_16_1_16_1_1_16_1_16_16_2_1_1_16_1_2_16_2_2_3_3_3_3_21_21_3_3_3_3_3_21_3_21_3_3_3_3_21_3_21_3_18_18_18_18_18_18_3_3_3_3_4_4_4_4_4_4_4
5159,71,1329933960,32,35,32,1329971460,37500,3672360,3996240,323880,29_29_1_1_7_7_1_7_1_7_7_7_7_7_1_7_1_7_7_7_7_7_7_1_1_7_7_7_7_7_7_7_7_1_1_7_7_7_7_1_1_1_1_7_7_1_7_1_7_7_7_7_7_7_7_1_7_7_7_1_7_7_7_7_7_7_7_1_7_1_7_7_7_7_7_7_7_1_7_7_7_32_1_32_32_5_5_32_7_7_32_32_32_32_32_32_32_32_32_32_7_32_7_32_32_32_32_32_32_32_32_32_32
5160,169,1329934860,50,12,50,1329972060,37200,273120,2190660,1917540,50_50_50_50_50_50_50_50_50_50_50_50_50_50_50_50_50_1_1_50_50
5161,217,1329934920,16,1,16,1329934980,60,108120,557700,449580,16_16_16_16_16_16_16_16_8_8_16_16_16_16_16_16
5162,217,1329934980,16,14,16,1329971400,36420,108180,557700,449520,16_16_16_16_16_16_16_16_8_8_16_16_16_16_16_16_16
5163,54,1329937920,7,12,7,1329972060,34140,177120,1314000,1136880,7_7_7_7_7_7_7_7_7
5164,98,1329946980,18,19,6,1329948000,1020,4207560,7319880,3112320,34_34_2_2_35_35_34_34_2_2_3_3_3_3_3_3_18_18_3_3_3_18_3_3_3_18_18_18_18_3_3_18_18_18_18_18_18_18_18_3_3_18_39_3_3_39_3_3_3_3_4_4_5_5_5_5_5_5_4_4_4_5_3_5_5_3_5_4_4_4_5_5_5_5_6_6_6_6_5_5_5_5_5_5_5_5_5_5_5_5_6_6_5_5_34_34_6_6_5_5_5_5_5_5_5_5_5_5_5_5_2_2_5_18_5_18_18_18
5165,157,1329947040,19,1,19,1329947340,300,58860,1993260,1934400,19_19_1_19_1_19_19_19_19_19
5166,213,1329947100,0,1,0,1329947400,300,910680,3206820,2296140,0_0_0_0_0_1_0_1_0_0_0_0_0_0_0_0_1_1_0_0_0_0_0_0_0_1_1_0_0_0_0_0_0_0_0_0_0_0_0_0_0_1_1_1_0_1_0_0_0_0_0_0_0_0_0_0_1_0_1_0_0_0_0_0_0_0_0_0_0_0_0_0_0_0_0_0
5167,157,1329947340,19,14,19,1329952860,5520,59160,1993260,1934100,19_19_1_19_1_19_19_19_19_19_19
5168,213,1329947400,0,14,0,1329971400,24000,910980,3206820,2295840,0_0_0_0_0_1_0_1_0_0_0_0_0_0_0_0_1_1_0_0_0_0_0_0_0_1_1_0_0_0_0_0_0_0_0_0_0_0_0_0_0_1_1_1_0_1_0_0_0_0_0_0_0_0_0_0_1_0_1_0_0_0_0_0_0_0_0_0_0_0_0_0_0_0_0_0_0
5169,98,1329948000,6,7,6,1329951600,3600,4208580,7319880,3111300,34_34_2_2_35_35_34_34_2_2_3_3_3_3_3_3_18_18_3_3_3_18_3_3_3_18_18_18_18_3_3_18_18_18_18_18_18_18_18_3_3_18_39_3_3_39_3_3_3_3_4_4_5_5_5_5_5_5_4_4_4_5_3_5_5_3_5_4_4_4_5_5_5_5_6_6_6_6_5_5_5_5_5_5_5_5_5_5_5_5_6_6_5_5_34_34_6_6_5_5_5_5_5_5_5_5_5_5_5_5_2_2_5_18_5_18_18_18_6
5170,125,1329948000,6,7,6,1329951600,3600,3920160,3969060,48900,16_16_16_16_16_16_1_1_2_2_1_1_3_3_48_48_5_5_5_5_48_48_6
5171,85,1329948000,6,7,6,1329948000,0,774780,778380,3600,19_19_19_19_19_19_19_19_19_19_19_19_1_1_2_3_2_3_5_5_6
5172,19,1329948000,6,7,6,1329951600,3600,61800,608940,547140,14_14_14_14_14_14_6
5173,135,1329948000,6,7,6,1329951600,3600,3873600,5649480,1775880,19_19_19_19_19_19_19_19_19_19_19_19_1_19_1_19_19_19_1_1_1_1_19_19_19_19_19_19_1_1_1_1_19_19_19_19_19_19_19_19_19_19_19_19_1_19_1_19_19_19_19_19_19_1_19_1_1_1_2_2_1_1_2_2_9_3_3_9_3_3_2_9_9_9_2_4_4_3_4_3_3_9_3_4_4_4_4_9_3_9_3_4_4_4_4_4_5_5_5_5_5_5_6
5174,69,1329948000,6,7,6,1329948000,0,2034060,2073180,39120,16_16_1_1_0_0_1_1_2_2_3_3_3_3_4_4_4_4_4_4_37_37_6
5175,20,1329948000,6,7,6,1329948000,0,0,39660,39660,6
5176,69,1329948000,6,7,6,1329951600,3600,2034060,2073180,39120,16_16_1_1_0_0_1_1_2_2_3_3_3_3_4_4_4_4_4_4_37_37_6_6
5177,85,1329948000,6,7,6,1329951600,3600,774780,778380,3600,19_19_19_19_19_19_19_19_19_19_19_19_1_1_2_3_2_3_5_5_6_6
5178,62,1329948000,6,7,6,1329951600,3600,3646860,3674460,27600,34_34_5_5_6_6_11_11_5_5_6
5179,20,1329948000,6,7,6,1329951600,3600,0,39660,39660,6_6
5180,63,1329949620,18,5,18,1329972360,22740,3098160,6232860,3134700,16_16_16_16_16_16_16_16_16_0_0_16_16_0_16_16_0_16_16_0_0_16_16_16_0_0_16_0_0_16_0_16_0_0_0_16_1_1_1_16_16_16_0_1_1_1_16_0_0_16_16_0_16_0_16_0_0_2_2_1_1_0_0_0_0_2_2_2_2_2_2_0_1_0_1_1_0_0_0_1_1_0_0_1_1_1_0_0_0_0_0_2_2_2_2_0_0_0_0_0_0_1_1_1_1_0_0_16_0_16_16_16_16_16_0_0_1_1_2_2_1_1_16_0_2_16_2_2_2_0_1_1_1_1_1_16_16_1_1_1_3_3_18_3_18_3_3_3_3_3_18
5181,85,1329951600,6,7,6,1329951600,0,778380,778380,0,19_19_19_19_19_19_19_19_19_19_19_19_1_1_2_3_2_3_5_5_6_6_6
5182,62,1329951600,6,7,5,1329973200,21600,3650460,3674460,24000,34_34_5_5_6_6_11_11_5_5_6_6
5183,135,1329951600,6,7,49,1331647680,1696080,3877200,5649480,1772280,19_19_19_19_19_19_19_19_19_19_19_19_1_19_1_19_19_19_1_1_1_1_19_19_19_19_19_19_1_1_1_1_19_19_19_19_19_19_19_19_19_19_19_19_1_19_1_19_19_19_19_19_19_1_19_1_1_1_2_2_1_1_2_2_9_3_3_9_3_3_2_9_9_9_2_4_4_3_4_3_3_9_3_4_4_4_4_9_3_9_3_4_4_4_4_4_5_5_5_5_5_5_6_6
5184,85,1329951600,6,7,99,1329951600,0,778380,778380,0,19_19_19_19_19_19_19_19_19_19_19_19_1_1_2_3_2_3_5_5_6_6_6_6
5185,125,1329951600,6,7,5,1329980400,28800,3923760,3969060,45300,16_16_16_16_16_16_1_1_2_2_1_1_3_3_48_48_5_5_5_5_48_48_6_6
5186,19,1329951600,6,7,14,1329973260,21660,65400,608940,543540,14_14_14_14_14_14_6_6
5187,69,1329951600,6,7,37,1329978960,27360,2037660,2073180,35520,16_16_1_1_0_0_1_1_2_2_3_3_3_3_4_4_4_4_4_4_37_37_6_6_6_6
5188,20,1329951600,6,7,23,1329983160,31560,3600,39660,36060,6_6_6_6
5189,20,1329951600,6,7,6,1329951600,0,3600,39660,36060,6_6_6
5190,98,1329951600,6,7,5,1330003200,51600,4212180,7319880,3107700,34_34_2_2_35_35_34_34_2_2_3_3_3_3_3_3_18_18_3_3_3_18_3_3_3_18_18_18_18_3_3_18_18_18_18_18_18_18_18_3_3_18_39_3_3_39_3_3_3_3_4_4_5_5_5_5_5_5_4_4_4_5_3_5_5_3_5_4_4_4_5_5_5_5_6_6_6_6_5_5_5_5_5_5_5_5_5_5_5_5_6_6_5_5_34_34_6_6_5_5_5_5_5_5_5_5_5_5_5_5_2_2_5_18_5_18_18_18_6_6
5191,69,1329951600,6,7,6,1329951600,0,2037660,2073180,35520,16_16_1_1_0_0_1_1_2_2_3_3_3_3_4_4_4_4_4_4_37_37_6_6_6
5192,157,1329952860,19,14,1,1329975420,22560,64680,1993260,1928580,19_19_1_19_1_19_19_19_19_19_19_19
5193,146,1329965160,4,5,4,1329973020,7860,4437960,6670800,2232840,16_16_16_16_16_16_16_1_16_1_16_1_1_16_1_16_16_2_1_1_16_1_2_16_2_2_3_3_3_3_21_21_3_3_3_3_3_21_3_21_3_3_3_3_21_3_21_3_18_18_18_18_18_18_3_3_3_3_4_4_4_4_4_4_4_4
5194,213,1329971400,0,14,0,1329972720,1320,934980,3206820,2271840,0_0_0_0_0_1_0_1_0_0_0_0_0_0_0_0_1_1_0_0_0_0_0_0_0_1_1_0_0_0_0_0_0_0_0_0_0_0_0_0_0_1_1_1_0_1_0_0_0_0_0_0_0_0_0_0_1_0_1_0_0_0_0_0_0_0_0_0_0_0_0_0_0_0_0_0_0_0
5195,217,1329971400,16,14,16,1329972720,1320,144600,557700,413100,16_16_16_16_16_16_16_16_8_8_16_16_16_16_16_16_16_16
5196,71,1329971460,32,35,32,1329972300,840,3709860,3996240,286380,29_29_1_1_7_7_1_7_1_7_7_7_7_7_1_7_1_7_7_7_7_7_7_1_1_7_7_7_7_7_7_7_7_1_1_7_7_7_7_1_1_1_1_7_7_1_7_1_7_7_7_7_7_7_7_1_7_7_7_1_7_7_7_7_7_7_7_1_7_1_7_7_7_7_7_7_7_1_7_7_7_32_1_32_32_5_5_32_7_7_32_32_32_32_32_32_32_32_32_32_7_32_7_32_32_32_32_32_32_32_32_32_32_32
5197,54,1329972060,7,12,1,1329976200,4140,211260,1314000,1102740,7_7_7_7_7_7_7_7_7_7
5198,169,1329972060,50,12,50,1330255560,283500,310320,2190660,1880340,50_50_50_50_50_50_50_50_50_50_50_50_50_50_50_50_50_1_1_50_50_50
5199,71,1329972300,32,34,32,1329984000,11700,3710700,3996240,285540,29_29_1_1_7_7_1_7_1_7_7_7_7_7_1_7_1_7_7_7_7_7_7_1_1_7_7_7_7_7_7_7_7_1_1_7_7_7_7_1_1_1_1_7_7_1_7_1_7_7_7_7_7_7_7_1_7_7_7_1_7_7_7_7_7_7_7_1_7_1_7_7_7_7_7_7_7_1_7_7_7_32_1_32_32_5_5_32_7_7_32_32_32_32_32_32_32_32_32_32_7_32_7_32_32_32_32_32_32_32_32_32_32_32_32
5200,63,1329972360,18,5,18,1329972960,600,3120900,6232860,3111960,16_16_16_16_16_16_16_16_16_0_0_16_16_0_16_16_0_16_16_0_0_16_16_16_0_0_16_0_0_16_0_16_0_0_0_16_1_1_1_16_16_16_0_1_1_1_16_0_0_16_16_0_16_0_16_0_0_2_2_1_1_0_0_0_0_2_2_2_2_2_2_0_1_0_1_1_0_0_0_1_1_0_0_1_1_1_0_0_0_0_0_2_2_2_2_0_0_0_0_0_0_1_1_1_1_0_0_16_0_16_16_16_16_16_0_0_1_1_2_2_1_1_16_0_2_16_2_2_2_0_1_1_1_1_1_16_16_1_1_1_3_3_18_3_18_3_3_3_3_3_18_18
5201,177,1329972540,10,13,10,1329986580,14040,1215600,1713060,497460,10_10_10_10_10_10_10_10_10_10_10_10_10_10_10
5202,213,1329972720,0,0,1,1329972780,60,936300,3206820,2270520,0_0_0_0_0_1_0_1_0_0_0_0_0_0_0_0_1_1_0_0_0_0_0_0_0_1_1_0_0_0_0_0_0_0_0_0_0_0_0_0_0_1_1_1_0_1_0_0_0_0_0_0_0_0_0_0_1_0_1_0_0_0_0_0_0_0_0_0_0_0_0_0_0_0_0_0_0_0_0
5203,217,1329972720,16,0,8,1329980940,8220,145920,557700,411780,16_16_16_16_16_16_16_16_8_8_16_16_16_16_16_16_16_16_16
5204,213,1329972780,1,9,1,1329975900,3120,936360,3206820,2270460,0_0_0_0_0_1_0_1_0_0_0_0_0_0_0_0_1_1_0_0_0_0_0_0_0_1_1_0_0_0_0_0_0_0_0_0_0_0_0_0_0_1_1_1_0_1_0_0_0_0_0_0_0_0_0_0_1_0_1_0_0_0_0_0_0_0_0_0_0_0_0_0_0_0_0_0_0_0_0_1
5205,63,1329972960,18,22,18,1329973020,60,3121500,6232860,3111360,16_16_16_16_16_16_16_16_16_0_0_16_16_0_16_16_0_16_16_0_0_16_16_16_0_0_16_0_0_16_0_16_0_0_0_16_1_1_1_16_16_16_0_1_1_1_16_0_0_16_16_0_16_0_16_0_0_2_2_1_1_0_0_0_0_2_2_2_2_2_2_0_1_0_1_1_0_0_0_1_1_0_0_1_1_1_0_0_0_0_0_2_2_2_2_0_0_0_0_0_0_1_1_1_1_0_0_16_0_16_16_16_16_16_0_0_1_1_2_2_1_1_16_0_2_16_2_2_2_0_1_1_1_1_1_16_16_1_1_1_3_3_18_3_18_3_3_3_3_3_18_18_18
5206,103,1329972960,44,41,44,1329983160,10200,4171980,4719960,547980,19_19_19_19_19_19_19_1_1_19_19_19_19_1_1_19_19_19_19_19_1_1_2_2_9_2_2_9_9_9_9_9_14_14_14_14_13_13_13_13_13_14_13_14_14_14_13_13_13_13_13_13_44_44_44_44_44_13_44_13_13_13_44
5207,63,1329973020,18,22,3,1329975480,2460,3121560,6232860,3111300,16_16_16_16_16_16_16_16_16_0_0_16_16_0_16_16_0_16_16_0_0_16_16_16_0_0_16_0_0_16_0_16_0_0_0_16_1_1_1_16_16_16_0_1_1_1_16_0_0_16_16_0_16_0_16_0_0_2_2_1_1_0_0_0_0_2_2_2_2_2_2_0_1_0_1_1_0_0_0_1_1_0_0_1_1_1_0_0_0_0_0_2_2_2_2_0_0_0_0_0_0_1_1_1_1_0_0_16_0_16_16_16_16_16_0_0_1_1_2_2_1_1_16_0_2_16_2_2_2_0_1_1_1_1_1_16_16_1_1_1_3_3_18_3_18_3_3_3_3_3_18_18_18_18
5208,146,1329973020,4,22,4,1329988260,15240,4445820,6670800,2224980,16_16_16_16_16_16_16_1_16_1_16_1_1_16_1_16_16_2_1_1_16_1_2_16_2_2_3_3_3_3_21_21_3_3_3_3_3_21_3_21_3_3_3_3_21_3_21_3_18_18_18_18_18_18_3_3_3_3_4_4_4_4_4_4_4_4_4
5209,62,1329973200,5,2,5,1329975600,2400,3672060,3674460,2400,34_34_5_5_6_6_11_11_5_5_6_6_5
5210,156,1329973200,5,6,5,1329978420,5220,2574480,2639280,64800,16_16_16_16_16_16_16_16_16_16_16_1_1_1_16_1_16_16_16_16_16_16_1_1_1_1_16_16_16_16_16_16_16_16_16_16_16_16_16_16_16_16_16_16_16_16_16_16_16_16_16_16_1_1_16_16_16_16_16_16_16_16_1_1_47_47_2_2_2_3_2_3_18_18_18_3_2_2_18_3_2_2_18_2_2_18_3_3_18_3_3_18_18_18_18_18_5_18_18_18_5_18_18_18_18_18_18_6_3_6_3_18_18_3_5_5_3_18_18_5_18_18_18_18_5_18_18_18_18_18_5
5211,19,1329973260,14,17,5,1329975600,2340,87060,608940,521880,14_14_14_14_14_14_6_6_14
5212,216,1329973500,19,11,19,1330004940,31440,0,496500,496500,19
5213,196,1329973860,7,8,7,1329988380,14520,173160,3281700,3108540,7_7_7_7_7_7_7_7_7
5214,157,1329975420,1,9,1,1329975480,60,87240,1993260,1906020,19_19_1_19_1_19_19_19_19_19_19_19_1
5215,157,1329975480,1,9,1,1330247400,271920,87300,1993260,1905960,19_19_1_19_1_19_19_19_19_19_19_19_1_1
5216,63,1329975480,3,4,3,1329980940,5460,3124020,6232860,3108840,16_16_16_16_16_16_16_16_16_0_0_16_16_0_16_16_0_16_16_0_0_16_16_16_0_0_16_0_0_16_0_16_0_0_0_16_1_1_1_16_16_16_0_1_1_1_16_0_0_16_16_0_16_0_16_0_0_2_2_1_1_0_0_0_0_2_2_2_2_2_2_0_1_0_1_1_0_0_0_1_1_0_0_1_1_1_0_0_0_0_0_2_2_2_2_0_0_0_0_0_0_1_1_1_1_0_0_16_0_16_16_16_16_16_0_0_1_1_2_2_1_1_16_0_2_16_2_2_2_0_1_1_1_1_1_16_16_1_1_1_3_3_18_3_18_3_3_3_3_3_18_18_18_18_3
5217,62,1329975600,5,2,99,1329975600,0,3674460,3674460,0,34_34_5_5_6_6_11_11_5_5_6_6_5_5
5218,19,1329975600,5,2,5,1329979200,3600,89400,608940,519540,14_14_14_14_14_14_6_6_14_5
5219,213,1329975900,1,9,0,1330004880,28980,939480,3206820,2267340,0_0_0_0_0_1_0_1_0_0_0_0_0_0_0_0_1_1_0_0_0_0_0_0_0_1_1_0_0_0_0_0_0_0_0_0_0_0_0_0_0_1_1_1_0_1_0_0_0_0_0_0_0_0_0_0_1_0_1_0_0_0_0_0_0_0_0_0_0_0_0_0_0_0_0_0_0_0_0_1_1
5220,54,1329976200,1,9,1,1329980880,4680,215400,1314000,1098600,7_7_7_7_7_7_7_7_7_7_1
5221,156,1329978420,5,6,6,1330034400,55980,2579700,2639280,59580,16_16_16_16_16_16_16_16_16_16_16_1_1_1_16_1_16_16_16_16_16_16_1_1_1_1_16_16_16_16_16_16_16_16_16_16_16_16_16_16_16_16_16_16_16_16_16_16_16_16_16_16_1_1_16_16_16_16_16_16_16_16_1_1_47_47_2_2_2_3_2_3_18_18_18_3_2_2_18_3_2_2_18_2_2_18_3_3_18_3_3_18_18_18_18_18_5_18_18_18_5_18_18_18_18_18_18_6_3_6_3_18_18_3_5_5_3_18_18_5_18_18_18_18_5_18_18_18_18_18_5_5
5222,69,1329978960,37,6,37,1329982560,3600,2065020,2073180,8160,16_16_1_1_0_0_1_1_2_2_3_3_3_3_4_4_4_4_4_4_37_37_6_6_6_6_37
5223,19,1329979200,5,2,14,1329980640,1440,93000,608940,515940,14_14_14_14_14_14_6_6_14_5_5
5224,125,1329980400,5,2,5,1329985800,5400,3952560,3969060,16500,16_16_16_16_16_16_1_1_2_2_1_1_3_3_48_48_5_5_5_5_48_48_6_6_5
5225,19,1329980640,14,17,14,1329980700,60,94440,608940,514500,14_14_14_14_14_14_6_6_14_5_5_14
5226,19,1329980700,14,17,14,1330004820,24120,94500,608940,514440,14_14_14_14_14_14_6_6_14_5_5_14_14
5227,54,1329980880,1,9,5,1330319340,338460,220080,1314000,1093920,7_7_7_7_7_7_7_7_7_7_1_1
5228,217,1329980940,8,9,8,1329994320,13380,154140,557700,403560,16_16_16_16_16_16_16_16_8_8_16_16_16_16_16_16_16_16_16_8
5229,63,1329980940,3,3,3,1329992760,11820,3129480,6232860,3103380,16_16_16_16_16_16_16_16_16_0_0_16_16_0_16_16_0_16_16_0_0_16_16_16_0_0_16_0_0_16_0_16_0_0_0_16_1_1_1_16_16_16_0_1_1_1_16_0_0_16_16_0_16_0_16_0_0_2_2_1_1_0_0_0_0_2_2_2_2_2_2_0_1_0_1_1_0_0_0_1_1_0_0_1_1_1_0_0_0_0_0_2_2_2_2_0_0_0_0_0_0_1_1_1_1_0_0_16_0_16_16_16_16_16_0_0_1_1_2_2_1_1_16_0_2_16_2_2_2_0_1_1_1_1_1_16_16_1_1_1_3_3_18_3_18_3_3_3_3_3_18_18_18_18_3_3
5230,69,1329982560,37,6,5,1329982620,60,2068620,2073180,4560,16_16_1_1_0_0_1_1_2_2_3_3_3_3_4_4_4_4_4_4_37_37_6_6_6_6_37_37
5231,69,1329982620,5,6,5,1329987120,4500,2068680,2073180,4500,16_16_1_1_0_0_1_1_2_2_3_3_3_3_4_4_4_4_4_4_37_37_6_6_6_6_37_37_5
5232,20,1329983160,23,6,23,1329987660,4500,35160,39660,4500,6_6_6_6_23
5233,103,1329983160,44,41,44,1329983400,240,4182180,4719960,537780,19_19_19_19_19_19_19_1_1_19_19_19_19_1_1_19_19_19_19_19_1_1_2_2_9_2_2_9_9_9_9_9_14_14_14_14_13_13_13_13_13_14_13_14_14_14_13_13_13_13_13_13_44_44_44_44_44_13_44_13_13_13_44_44
5234,103,1329983400,44,41,44,1329987000,3600,4182420,4719960,537540,19_19_19_19_19_19_19_1_1_19_19_19_19_1_1_19_19_19_19_19_1_1_2_2_9_2_2_9_9_9_9_9_14_14_14_14_13_13_13_13_13_14_13_14_14_14_13_13_13_13_13_13_44_44_44_44_44_13_44_13_13_13_44_44_44
5235,71,1329984000,32,34,32,1329987600,3600,3722400,3996240,273840,29_29_1_1_7_7_1_7_1_7_7_7_7_7_1_7_1_7_7_7_7_7_7_1_1_7_7_7_7_7_7_7_7_1_1_7_7_7_7_1_1_1_1_7_7_1_7_1_7_7_7_7_7_7_7_1_7_7_7_1_7_7_7_7_7_7_7_1_7_1_7_7_7_7_7_7_7_1_7_7_7_32_1_32_32_5_5_32_7_7_32_32_32_32_32_32_32_32_32_32_7_32_7_32_32_32_32_32_32_32_32_32_32_32_32_32
5236,180,1329985260,5,6,5,1329988860,3600,1194840,3322080,2127240,50_50_50_50_50_50_1_50_1_50_50_50_50_50_50_50_50_50_1_1_2_2_9_9_9_9_3_3_3_3_5
5237,125,1329985800,5,2,5,1329996000,10200,3957960,3969060,11100,16_16_16_16_16_16_1_1_2_2_1_1_3_3_48_48_5_5_5_5_48_48_6_6_5_5
5238,131,1329985800,5,2,5,1329994200,8400,3725700,6825900,3100200,16_16_16_16_16_16_16_16_16_16_16_16_16_16_16_16_16_16_16_16_16_16_16_16_16_16_1_1_1_1_2_2_3_3_3_3_18_18_18_18_18_3_3_3_3_18_18_18_18_18_18_18_18_18_18_18_18_18_18_18_18_18_18_18_5_5_5_5_5_5_5_5_5_5_5_5_6_6_5_5_6_6_5_5_5_5_5
5239,177,1329986580,10,13,1,1330072260,85680,1229640,1713060,483420,10_10_10_10_10_10_10_10_10_10_10_10_10_10_10_10
5240,210,1329986640,10,13,10,1330008480,21840,0,1118160,1118160,10
5241,103,1329987000,44,41,44,1329987000,0,4186020,4719960,533940,19_19_19_19_19_19_19_1_1_19_19_19_19_1_1_19_19_19_19_19_1_1_2_2_9_2_2_9_9_9_9_9_14_14_14_14_13_13_13_13_13_14_13_14_14_14_13_13_13_13_13_13_44_44_44_44_44_13_44_13_13_13_44_44_44_44
5242,103,1329987000,44,41,44,1330005600,18600,4186020,4719960,533940,19_19_19_19_19_19_19_1_1_19_19_19_19_1_1_19_19_19_19_19_1_1_2_2_9_2_2_9_9_9_9_9_14_14_14_14_13_13_13_13_13_14_13_14_14_14_13_13_13_13_13_13_44_44_44_44_44_13_44_13_13_13_44_44_44_44_44
5243,69,1329987120,5,6,99,1329987120,0,2073180,2073180,0,16_16_1_1_0_0_1_1_2_2_3_3_3_3_4_4_4_4_4_4_37_37_6_6_6_6_37_37_5_5
5244,71,1329987600,32,34,32,1329991200,3600,3726000,3996240,270240,29_29_1_1_7_7_1_7_1_7_7_7_7_7_1_7_1_7_7_7_7_7_7_1_1_7_7_7_7_7_7_7_7_1_1_7_7_7_7_1_1_1_1_7_7_1_7_1_7_7_7_7_7_7_7_1_7_7_7_1_7_7_7_7_7_7_7_1_7_1_7_7_7_7_7_7_7_1_7_7_7_32_1_32_32_5_5_32_7_7_32_32_32_32_32_32_32_32_32_32_7_32_7_32_32_32_32_32_32_32_32_32_32_32_32_32_32
5245,20,1329987660,23,6,99,1329987660,0,39660,39660,0,6_6_6_6_23_23
5246,146,1329988260,4,22,4,1329992100,3840,4461060,6670800,2209740,16_16_16_16_16_16_16_1_16_1_16_1_1_16_1_16_16_2_1_1_16_1_2_16_2_2_3_3_3_3_21_21_3_3_3_3_3_21_3_21_3_3_3_3_21_3_21_3_18_18_18_18_18_18_3_3_3_3_4_4_4_4_4_4_4_4_4_4_4
5247,146,1329988260,4,22,4,1329988260,0,4461060,6670800,2209740,16_16_16_16_16_16_16_1_16_1_16_1_1_16_1_16_16_2_1_1_16_1_2_16_2_2_3_3_3_3_21_21_3_3_3_3_3_21_3_21_3_3_3_3_21_3_21_3_18_18_18_18_18_18_3_3_3_3_4_4_4_4_4_4_4_4_4_4
5248,196,1329988380,7,8,7,1329988440,60,187680,3281700,3094020,7_7_7_7_7_7_7_7_7_7
5249,196,1329988440,7,8,7,1330004280,15840,187740,3281700,3093960,7_7_7_7_7_7_7_7_7_7_7
5250,180,1329988860,5,6,6,1330034400,45540,1198440,3322080,2123640,50_50_50_50_50_50_1_50_1_50_50_50_50_50_50_50_50_50_1_1_2_2_9_9_9_9_3_3_3_3_5_5
5251,71,1329991200,32,34,32,1330000200,9000,3729600,3996240,266640,29_29_1_1_7_7_1_7_1_7_7_7_7_7_1_7_1_7_7_7_7_7_7_1_1_7_7_7_7_7_7_7_7_1_1_7_7_7_7_1_1_1_1_7_7_1_7_1_7_7_7_7_7_7_7_1_7_7_7_1_7_7_7_7_7_7_7_1_7_1_7_7_7_7_7_7_7_1_7_7_7_32_1_32_32_5_5_32_7_7_32_32_32_32_32_32_32_32_32_32_7_32_7_32_32_32_32_32_32_32_32_32_32_32_32_32_32_32
5252,146,1329992100,4,22,4,1329992160,60,4464900,6670800,2205900,16_16_16_16_16_16_16_1_16_1_16_1_1_16_1_16_16_2_1_1_16_1_2_16_2_2_3_3_3_3_21_21_3_3_3_3_3_21_3_21_3_3_3_3_21_3_21_3_18_18_18_18_18_18_3_3_3_3_4_4_4_4_4_4_4_4_4_4_4_4
5253,146,1329992160,4,19,4,1329992580,420,4464960,6670800,2205840,16_16_16_16_16_16_16_1_16_1_16_1_1_16_1_16_16_2_1_1_16_1_2_16_2_2_3_3_3_3_21_21_3_3_3_3_3_21_3_21_3_3_3_3_21_3_21_3_18_18_18_18_18_18_3_3_3_3_4_4_4_4_4_4_4_4_4_4_4_4_4
5254,146,1329992580,4,19,4,1330028160,35580,4465380,6670800,2205420,16_16_16_16_16_16_16_1_16_1_16_1_1_16_1_16_16_2_1_1_16_1_2_16_2_2_3_3_3_3_21_21_3_3_3_3_3_21_3_21_3_3_3_3_21_3_21_3_18_18_18_18_18_18_3_3_3_3_4_4_4_4_4_4_4_4_4_4_4_4_4_4
5255,63,1329992760,3,3,3,1329993900,1140,3141300,6232860,3091560,16_16_16_16_16_16_16_16_16_0_0_16_16_0_16_16_0_16_16_0_0_16_16_16_0_0_16_0_0_16_0_16_0_0_0_16_1_1_1_16_16_16_0_1_1_1_16_0_0_16_16_0_16_0_16_0_0_2_2_1_1_0_0_0_0_2_2_2_2_2_2_0_1_0_1_1_0_0_0_1_1_0_0_1_1_1_0_0_0_0_0_2_2_2_2_0_0_0_0_0_0_1_1_1_1_0_0_16_0_16_16_16_16_16_0_0_1_1_2_2_1_1_16_0_2_16_2_2_2_0_1_1_1_1_1_16_16_1_1_1_3_3_18_3_18_3_3_3_3_3_18_18_18_18_3_3_3
5256,113,1329992820,4,19,3,1329996360,3540,3169560,3646740,477180,16_16_16_16_1_1_2_2_48_3_3_48_15_15_4
5257,63,1329993900,3,4,18,1330036380,42480,3142440,6232860,3090420,16_16_16_16_16_16_16_16_16_0_0_16_16_0_16_16_0_16_16_0_0_16_16_16_0_0_16_0_0_16_0_16_0_0_0_16_1_1_1_16_16_16_0_1_1_1_16_0_0_16_16_0_16_0_16_0_0_2_2_1_1_0_0_0_0_2_2_2_2_2_2_0_1_0_1_1_0_0_0_1_1_0_0_1_1_1_0_0_0_0_0_2_2_2_2_0_0_0_0_0_0_1_1_1_1_0_0_16_0_16_16_16_16_16_0_0_1_1_2_2_1_1_16_0_2_16_2_2_2_0_1_1_1_1_1_16_16_1_1_1_3_3_18_3_18_3_3_3_3_3_18_18_18_18_3_3_3_3
5258,131,1329994200,5,2,5,1329996900,2700,3734100,6825900,3091800,16_16_16_16_16_16_16_16_16_16_16_16_16_16_16_16_16_16_16_16_16_16_16_16_16_16_1_1_1_1_2_2_3_3_3_3_18_18_18_18_18_3_3_3_3_18_18_18_18_18_18_18_18_18_18_18_18_18_18_18_18_18_18_18_5_5_5_5_5_5_5_5_5_5_5_5_6_6_5_5_6_6_5_5_5_5_5_5
5259,217,1329994320,8,9,16,1329996360,2040,167520,557700,390180,16_16_16_16_16_16_16_16_8_8_16_16_16_16_16_16_16_16_16_8_8
5260,142,1329994440,15,9,15,1330005840,11400,4236000,7299960,3063960,0_0_0_0_0_0_0_1_1_0_0_0_0_0_0_0_0_1_1_0_0_0_0_0_0_1_1_0_0_0_0_0_0_1_1_0_0_0_0_0_0_0_1_0_1_0_0_0_1_1_1_1_27_27_27_27_1_27_27_1_27_27_27_27_27_27_27_27_27_27_27_27_27_27_27_27_2_2_2_2_2_2_3_3_3_2_2_3_3_3_2_2_3_3_4_4_15_4_15_4_4_4_4_4_4_4_4_4_4_4_4_4_4_4_4_4_4_4_4_4_4_4_4_4_4_4_4_4_4_4_4_4_15
5261,125,1329996000,5,2,5,1329996900,900,3968160,3969060,900,16_16_16_16_16_16_1_1_2_2_1_1_3_3_48_48_5_5_5_5_48_48_6_6_5_5_5
5262,113,1329996360,3,4,3,1330003020,6660,3173100,3646740,473640,16_16_16_16_1_1_2_2_48_3_3_48_15_15_4_3
5263,217,1329996360,16,0,8,1330262400,266040,169560,557700,388140,16_16_16_16_16_16_16_16_8_8_16_16_16_16_16_16_16_16_16_8_8_16
5264,214,1329996420,22,0,22,1330004880,8460,0,341760,341760,22
5265,125,1329996900,5,2,99,1329996900,0,3969060,3969060,0,16_16_16_16_16_16_1_1_2_2_1_1_3_3_48_48_5_5_5_5_48_48_6_6_5_5_5_5
5266,131,1329996900,5,2,5,1330000200,3300,3736800,6825900,3089100,16_16_16_16_16_16_16_16_16_16_16_16_16_16_16_16_16_16_16_16_16_16_16_16_16_16_1_1_1_1_2_2_3_3_3_3_18_18_18_18_18_3_3_3_3_18_18_18_18_18_18_18_18_18_18_18_18_18_18_18_18_18_18_18_5_5_5_5_5_5_5_5_5_5_5_5_6_6_5_5_6_6_5_5_5_5_5_5_5
5267,90,1329998340,9,3,9,1330011840,13500,283680,1532940,1249260,19_19_19_19_19_19_19_19_1_1_19_19_19_19_19_19_19_19_1_1_1_1_9
5268,71,1330000200,32,34,32,1330005600,5400,3738600,3996240,257640,29_29_1_1_7_7_1_7_1_7_7_7_7_7_1_7_1_7_7_7_7_7_7_1_1_7_7_7_7_7_7_7_7_1_1_7_7_7_7_1_1_1_1_7_7_1_7_1_7_7_7_7_7_7_7_1_7_7_7_1_7_7_7_7_7_7_7_1_7_1_7_7_7_7_7_7_7_1_7_7_7_32_1_32_32_5_5_32_7_7_32_32_32_32_32_32_32_32_32_32_7_32_7_32_32_32_32_32_32_32_32_32_32_32_32_32_32_32_32
5269,131,1330000200,5,2,5,1330000200,0,3740100,6825900,3085800,16_16_16_16_16_16_16_16_16_16_16_16_16_16_16_16_16_16_16_16_16_16_16_16_16_16_1_1_1_1_2_2_3_3_3_3_18_18_18_18_18_3_3_3_3_18_18_18_18_18_18_18_18_18_18_18_18_18_18_18_18_18_18_18_5_5_5_5_5_5_5_5_5_5_5_5_6_6_5_5_6_6_5_5_5_5_5_5_5_5
5270,131,1330000200,5,2,5,1330003200,3000,3740100,6825900,3085800,16_16_16_16_16_16_16_16_16_16_16_16_16_16_16_16_16_16_16_16_16_16_16_16_16_16_1_1_1_1_2_2_3_3_3_3_18_18_18_18_18_3_3_3_3_18_18_18_18_18_18_18_18_18_18_18_18_18_18_18_18_18_18_18_5_5_5_5_5_5_5_5_5_5_5_5_6_6_5_5_6_6_5_5_5_5_5_5_5_5_5
5271,113,1330003020,3,3,4,1330003200,180,3179760,3646740,466980,16_16_16_16_1_1_2_2_48_3_3_48_15_15_4_3_3_3
5272,113,1330003020,3,3,3,1330003020,0,3179760,3646740,466980,16_16_16_16_1_1_2_2_48_3_3_48_15_15_4_3_3
5273,113,1330003200,4,19,4,1330003260,60,3179940,3646740,466800,16_16_16_16_1_1_2_2_48_3_3_48_15_15_4_3_3_3_4
5274,98,1330003200,5,2,5,1330006200,3000,4263780,7319880,3056100,34_34_2_2_35_35_34_34_2_2_3_3_3_3_3_3_18_18_3_3_3_18_3_3_3_18_18_18_18_3_3_18_18_18_18_18_18_18_18_3_3_18_39_3_3_39_3_3_3_3_4_4_5_5_5_5_5_5_4_4_4_5_3_5_5_3_5_4_4_4_5_5_5_5_6_6_6_6_5_5_5_5_5_5_5_5_5_5_5_5_6_6_5_5_34_34_6_6_5_5_5_5_5_5_5_5_5_5_5_5_2_2_5_18_5_18_18_18_6_6_5
5275,131,1330003200,5,2,6,1330466400,463200,3743100,6825900,3082800,16_16_16_16_16_16_16_16_16_16_16_16_16_16_16_16_16_16_16_16_16_16_16_16_16_16_1_1_1_1_2_2_3_3_3_3_18_18_18_18_18_3_3_3_3_18_18_18_18_18_18_18_18_18_18_18_18_18_18_18_18_18_18_18_5_5_5_5_5_5_5_5_5_5_5_5_6_6_5_5_6_6_5_5_5_5_5_5_5_5_5_5
5276,113,1330003260,4,19,3,1330004760,1500,3180000,3646740,466740,16_16_16_16_1_1_2_2_48_3_3_48_15_15_4_3_3_3_4_4
5277,196,1330004280,7,8,7,1330023060,18780,203580,3281700,3078120,7_7_7_7_7_7_7_7_7_7_7_7
5278,134,1330004760,3,3,3,1330011840,7080,3191340,3656580,465240,0_0_0_0_0_0_0_0_0_0_1_1_2_2_3_3_13_13_13_13_13_13_13_13_15_15_3
5279,113,1330004760,3,3,3,1330005120,360,3181500,3646740,465240,16_16_16_16_1_1_2_2_48_3_3_48_15_15_4_3_3_3_4_4_3
5280,19,1330004820,14,17,14,1330264140,259320,118620,608940,490320,14_14_14_14_14_14_6_6_14_5_5_14_14_14
5281,214,1330004880,22,0,16,1330006920,2040,8460,341760,333300,22_22
5282,213,1330004880,0,0,0,1330006980,2100,968460,3206820,2238360,0_0_0_0_0_1_0_1_0_0_0_0_0_0_0_0_1_1_0_0_0_0_0_0_0_1_1_0_0_0_0_0_0_0_0_0_0_0_0_0_0_1_1_1_0_1_0_0_0_0_0_0_0_0_0_0_1_0_1_0_0_0_0_0_0_0_0_0_0_0_0_0_0_0_0_0_0_0_0_1_1_0
5283,216,1330004940,19,11,19,1330006860,1920,31440,496500,465060,19_19
5284,113,1330005120,3,4,3,1330007520,2400,3181860,3646740,464880,16_16_16_16_1_1_2_2_48_3_3_48_15_15_4_3_3_3_4_4_3_3
5285,103,1330005600,44,41,5,1330321860,316260,4204620,4719960,515340,19_19_19_19_19_19_19_1_1_19_19_19_19_1_1_19_19_19_19_19_1_1_2_2_9_2_2_9_9_9_9_9_14_14_14_14_13_13_13_13_13_14_13_14_14_14_13_13_13_13_13_13_44_44_44_44_44_13_44_13_13_13_44_44_44_44_44_44
5286,71,1330005600,32,34,32,1330020360,14760,3744000,3996240,252240,29_29_1_1_7_7_1_7_1_7_7_7_7_7_1_7_1_7_7_7_7_7_7_1_1_7_7_7_7_7_7_7_7_1_1_7_7_7_7_1_1_1_1_7_7_1_7_1_7_7_7_7_7_7_7_1_7_7_7_1_7_7_7_7_7_7_7_1_7_1_7_7_7_7_7_7_7_1_7_7_7_32_1_32_32_5_5_32_7_7_32_32_32_32_32_32_32_32_32_32_7_32_7_32_32_32_32_32_32_32_32_32_32_32_32_32_32_32_32_32
5287,142,1330005840,15,9,15,1330062420,56580,4247400,7299960,3052560,0_0_0_0_0_0_0_1_1_0_0_0_0_0_0_0_0_1_1_0_0_0_0_0_0_1_1_0_0_0_0_0_0_1_1_0_0_0_0_0_0_0_1_0_1_0_0_0_1_1_1_1_27_27_27_27_1_27_27_1_27_27_27_27_27_27_27_27_27_27_27_27_27_27_27_27_2_2_2_2_2_2_3_3_3_2_2_3_3_3_2_2_3_3_4_4_15_4_15_4_4_4_4_4_4_4_4_4_4_4_4_4_4_4_4_4_4_4_4_4_4_4_4_4_4_4_4_4_4_4_4_4_15_15
5288,98,1330006200,5,2,5,1330239600,233400,4266780,7319880,3053100,34_34_2_2_35_35_34_34_2_2_3_3_3_3_3_3_18_18_3_3_3_18_3_3_3_18_18_18_18_3_3_18_18_18_18_18_18_18_18_3_3_18_39_3_3_39_3_3_3_3_4_4_5_5_5_5_5_5_4_4_4_5_3_5_5_3_5_4_4_4_5_5_5_5_6_6_6_6_5_5_5_5_5_5_5_5_5_5_5_5_6_6_5_5_34_34_6_6_5_5_5_5_5_5_5_5_5_5_5_5_2_2_5_18_5_18_18_18_6_6_5_5
5289,216,1330006860,19,1,19,1330033380,26520,33360,496500,463140,19_19_19
5290,214,1330006920,16,1,16,1330020840,13920,10500,341760,331260,22_22_16
5291,213,1330006980,0,1,0,1330033380,26400,970560,3206820,2236260,0_0_0_0_0_1_0_1_0_0_0_0_0_0_0_0_1_1_0_0_0_0_0_0_0_1_1_0_0_0_0_0_0_0_0_0_0_0_0_0_0_1_1_1_0_1_0_0_0_0_0_0_0_0_0_0_1_0_1_0_0_0_0_0_0_0_0_0_0_0_0_0_0_0_0_0_0_0_0_1_1_0_0
5292,113,1330007520,3,3,4,1330011720,4200,3184260,3646740,462480,16_16_16_16_1_1_2_2_48_3_3_48_15_15_4_3_3_3_4_4_3_3_3
5293,210,1330008480,10,13,10,1330008540,60,21840,1118160,1096320,10_10
5294,210,1330008540,10,13,10,1330012320,3780,21900,1118160,1096260,10_10_10
5295,113,1330011720,4,19,5,1330325520,313800,3188460,3646740,458280,16_16_16_16_1_1_2_2_48_3_3_48_15_15_4_3_3_3_4_4_3_3_3_4
5296,134,1330011840,3,3,4,1330011900,60,3198420,3656580,458160,0_0_0_0_0_0_0_0_0_0_1_1_2_2_3_3_13_13_13_13_13_13_13_13_15_15_3_3
5297,90,1330011840,9,3,9,1330062300,50460,297180,1532940,1235760,19_19_19_19_19_19_19_19_1_1_19_19_19_19_19_19_19_19_1_1_1_1_9_9
5298,134,1330011900,4,19,4,1330016820,4920,3198480,3656580,458100,0_0_0_0_0_0_0_0_0_0_1_1_2_2_3_3_13_13_13_13_13_13_13_13_15_15_3_3_4
5299,210,1330012320,10,13,10,1330060200,47880,25680,1118160,1092480,10_10_10_10
5300,134,1330016820,4,19,4,1330019760,2940,3203400,3656580,453180,0_0_0_0_0_0_0_0_0_0_1_1_2_2_3_3_13_13_13_13_13_13_13_13_15_15_3_3_4_4_4
5301,134,1330016820,4,19,4,1330016820,0,3203400,3656580,453180,0_0_0_0_0_0_0_0_0_0_1_1_2_2_3_3_13_13_13_13_13_13_13_13_15_15_3_3_4_4
5302,134,1330019760,4,5,4,1330019820,60,3206340,3656580,450240,0_0_0_0_0_0_0_0_0_0_1_1_2_2_3_3_13_13_13_13_13_13_13_13_15_15_3_3_4_4_4_4
5303,134,1330019820,4,19,4,1330028100,8280,3206400,3656580,450180,0_0_0_0_0_0_0_0_0_0_1_1_2_2_3_3_13_13_13_13_13_13_13_13_15_15_3_3_4_4_4_4_4
5304,71,1330020360,32,35,32,1330057800,37440,3758760,3996240,237480,29_29_1_1_7_7_1_7_1_7_7_7_7_7_1_7_1_7_7_7_7_7_7_1_1_7_7_7_7_7_7_7_7_1_1_7_7_7_7_1_1_1_1_7_7_1_7_1_7_7_7_7_7_7_7_1_7_7_7_1_7_7_7_7_7_7_7_1_7_1_7_7_7_7_7_7_7_1_7_7_7_32_1_32_32_5_5_32_7_7_32_32_32_32_32_32_32_32_32_32_7_32_7_32_32_32_32_32_32_32_32_32_32_32_32_32_32_32_32_32_32
5305,214,1330020840,16,1,16,1330020900,60,24420,341760,317340,22_22_16_16
5306,214,1330020900,16,14,16,1330034820,13920,24480,341760,317280,22_22_16_16_16
5307,196,1330023060,7,12,7,1330058040,34980,222360,3281700,3059340,7_7_7_7_7_7_7_7_7_7_7_7_7
5308,134,1330028100,4,5,5,1330332780,304680,3214680,3656580,441900,0_0_0_0_0_0_0_0_0_0_1_1_2_2_3_3_13_13_13_13_13_13_13_13_15_15_3_3_4_4_4_4_4_4
5309,146,1330028160,4,5,4,1330036320,8160,4500960,6670800,2169840,16_16_16_16_16_16_16_1_16_1_16_1_1_16_1_16_16_2_1_1_16_1_2_16_2_2_3_3_3_3_21_21_3_3_3_3_3_21_3_21_3_3_3_3_21_3_21_3_18_18_18_18_18_18_3_3_3_3_4_4_4_4_4_4_4_4_4_4_4_4_4_4_4
5310,213,1330033380,0,1,0,1330034940,1560,996960,3206820,2209860,0_0_0_0_0_1_0_1_0_0_0_0_0_0_0_0_1_1_0_0_0_0_0_0_0_1_1_0_0_0_0_0_0_0_0_0_0_0_0_0_0_1_1_1_0_1_0_0_0_0_0_0_0_0_0_0_1_0_1_0_0_0_0_0_0_0_0_0_0_0_0_0_0_0_0_0_0_0_0_1_1_0_0_0
5311,216,1330033380,19,1,19,1330035000,1620,59880,496500,436620,19_19_19_19
5312,180,1330034400,6,7,6,1330038000,3600,1243980,3322080,2078100,50_50_50_50_50_50_1_50_1_50_50_50_50_50_50_50_50_50_1_1_2_2_9_9_9_9_3_3_3_3_5_5_6
5313,156,1330034400,6,7,6,1330034400,0,2635680,2639280,3600,16_16_16_16_16_16_16_16_16_16_16_1_1_1_16_1_16_16_16_16_16_16_1_1_1_1_16_16_16_16_16_16_16_16_16_16_16_16_16_16_16_16_16_16_16_16_16_16_16_16_16_16_1_1_16_16_16_16_16_16_16_16_1_1_47_47_2_2_2_3_2_3_18_18_18_3_2_2_18_3_2_2_18_2_2_18_3_3_18_3_3_18_18_18_18_18_5_18_18_18_5_18_18_18_18_18_18_6_3_6_3_18_18_3_5_5_3_18_18_5_18_18_18_18_5_18_18_18_18_18_5_5_6
5314,156,1330034400,6,7,6,1330038000,3600,2635680,2639280,3600,16_16_16_16_16_16_16_16_16_16_16_1_1_1_16_1_16_16_16_16_16_16_1_1_1_1_16_16_16_16_16_16_16_16_16_16_16_16_16_16_16_16_16_16_16_16_16_16_16_16_16_16_1_1_16_16_16_16_16_16_16_16_1_1_47_47_2_2_2_3_2_3_18_18_18_3_2_2_18_3_2_2_18_2_2_18_3_3_18_3_3_18_18_18_18_18_5_18_18_18_5_18_18_18_18_18_18_6_3_6_3_18_18_3_5_5_3_18_18_5_18_18_18_18_5_18_18_18_18_18_5_5_6_6
5315,214,1330034820,16,14,16,1330037160,2340,38400,341760,303360,22_22_16_16_16_16
5316,213,1330034940,0,14,0,1330057860,22920,998520,3206820,2208300,0_0_0_0_0_1_0_1_0_0_0_0_0_0_0_0_1_1_0_0_0_0_0_0_0_1_1_0_0_0_0_0_0_0_0_0_0_0_0_0_0_1_1_1_0_1_0_0_0_0_0_0_0_0_0_0_1_0_1_0_0_0_0_0_0_0_0_0_0_0_0_0_0_0_0_0_0_0_0_1_1_0_0_0_0
5317,216,1330035000,19,14,19,1330057740,22740,61500,496500,435000,19_19_19_19_19
5318,146,1330036320,4,5,4,1330036320,0,4509120,6670800,2161680,16_16_16_16_16_16_16_1_16_1_16_1_1_16_1_16_16_2_1_1_16_1_2_16_2_2_3_3_3_3_21_21_3_3_3_3_3_21_3_21_3_3_3_3_21_3_21_3_18_18_18_18_18_18_3_3_3_3_4_4_4_4_4_4_4_4_4_4_4_4_4_4_4_4
5319,146,1330036320,4,5,4,1330058100,21780,4509120,6670800,2161680,16_16_16_16_16_16_16_1_16_1_16_1_1_16_1_16_16_2_1_1_16_1_2_16_2_2_3_3_3_3_21_21_3_3_3_3_3_21_3_21_3_3_3_3_21_3_21_3_18_18_18_18_18_18_3_3_3_3_4_4_4_4_4_4_4_4_4_4_4_4_4_4_4_4_4
5320,63,1330036380,18,5,18,1330058100,21720,3184920,6232860,3047940,16_16_16_16_16_16_16_16_16_0_0_16_16_0_16_16_0_16_16_0_0_16_16_16_0_0_16_0_0_16_0_16_0_0_0_16_1_1_1_16_16_16_0_1_1_1_16_0_0_16_16_0_16_0_16_0_0_2_2_1_1_0_0_0_0_2_2_2_2_2_2_0_1_0_1_1_0_0_0_1_1_0_0_1_1_1_0_0_0_0_0_2_2_2_2_0_0_0_0_0_0_1_1_1_1_0_0_16_0_16_16_16_16_16_0_0_1_1_2_2_1_1_16_0_2_16_2_2_2_0_1_1_1_1_1_16_16_1_1_1_3_3_18_3_18_3_3_3_3_3_18_18_18_18_3_3_3_3_18
5321,214,1330037160,16,14,16,1330058040,20880,40740,341760,301020,22_22_16_16_16_16_16
5322,180,1330038000,6,7,50,1332108000,2070000,1247580,3322080,2074500,50_50_50_50_50_50_1_50_1_50_50_50_50_50_50_50_50_50_1_1_2_2_9_9_9_9_3_3_3_3_5_5_6_6
5323,156,1330038000,6,7,6,1330038000,0,2639280,2639280,0,16_16_16_16_16_16_16_16_16_16_16_1_1_1_16_1_16_16_16_16_16_16_1_1_1_1_16_16_16_16_16_16_16_16_16_16_16_16_16_16_16_16_16_16_16_16_16_16_16_16_16_16_1_1_16_16_16_16_16_16_16_16_1_1_47_47_2_2_2_3_2_3_18_18_18_3_2_2_18_3_2_2_18_2_2_18_3_3_18_3_3_18_18_18_18_18_5_18_18_18_5_18_18_18_18_18_18_6_3_6_3_18_18_3_5_5_3_18_18_5_18_18_18_18_5_18_18_18_18_18_5_5_6_6_6
5324,156,1330038000,6,7,99,1330038000,0,2639280,2639280,0,16_16_16_16_16_16_16_16_16_16_16_1_1_1_16_1_16_16_16_16_16_16_1_1_1_1_16_16_16_16_16_16_16_16_16_16_16_16_16_16_16_16_16_16_16_16_16_16_16_16_16_16_1_1_16_16_16_16_16_16_16_16_1_1_47_47_2_2_2_3_2_3_18_18_18_3_2_2_18_3_2_2_18_2_2_18_3_3_18_3_3_18_18_18_18_18_5_18_18_18_5_18_18_18_18_18_18_6_3_6_3_18_18_3_5_5_3_18_18_5_18_18_18_18_5_18_18_18_18_18_5_5_6_6_6_6
5325,216,1330057740,19,14,19,1330059600,1860,84240,496500,412260,19_19_19_19_19_19
5326,71,1330057800,32,35,6,1330207200,149400,3796200,3996240,200040,29_29_1_1_7_7_1_7_1_7_7_7_7_7_1_7_1_7_7_7_7_7_7_1_1_7_7_7_7_7_7_7_7_1_1_7_7_7_7_1_1_1_1_7_7_1_7_1_7_7_7_7_7_7_7_1_7_7_7_1_7_7_7_7_7_7_7_1_7_1_7_7_7_7_7_7_7_1_7_7_7_32_1_32_32_5_5_32_7_7_32_32_32_32_32_32_32_32_32_32_7_32_7_32_32_32_32_32_32_32_32_32_32_32_32_32_32_32_32_32_32_32
5327,213,1330057860,0,14,0,1330059660,1800,1021440,3206820,2185380,0_0_0_0_0_1_0_1_0_0_0_0_0_0_0_0_1_1_0_0_0_0_0_0_0_1_1_0_0_0_0_0_0_0_0_0_0_0_0_0_0_1_1_1_0_1_0_0_0_0_0_0_0_0_0_0_1_0_1_0_0_0_0_0_0_0_0_0_0_0_0_0_0_0_0_0_0_0_0_1_1_0_0_0_0_0
5328,214,1330058040,16,14,16,1330059720,1680,61620,341760,280140,22_22_16_16_16_16_16_16
5329,196,1330058040,7,12,7,1330200120,142080,257340,3281700,3024360,7_7_7_7_7_7_7_7_7_7_7_7_7_7
5330,63,1330058100,18,5,18,1330059540,1440,3206640,6232860,3026220,16_16_16_16_16_16_16_16_16_0_0_16_16_0_16_16_0_16_16_0_0_16_16_16_0_0_16_0_0_16_0_16_0_0_0_16_1_1_1_16_16_16_0_1_1_1_16_0_0_16_16_0_16_0_16_0_0_2_2_1_1_0_0_0_0_2_2_2_2_2_2_0_1_0_1_1_0_0_0_1_1_0_0_1_1_1_0_0_0_0_0_2_2_2_2_0_0_0_0_0_0_1_1_1_1_0_0_16_0_16_16_16_16_16_0_0_1_1_2_2_1_1_16_0_2_16_2_2_2_0_1_1_1_1_1_16_16_1_1_1_3_3_18_3_18_3_3_3_3_3_18_18_18_18_3_3_3_3_18_18
5331,146,1330058100,4,5,18,1330059420,1320,4530900,6670800,2139900,16_16_16_16_16_16_16_1_16_1_16_1_1_16_1_16_16_2_1_1_16_1_2_16_2_2_3_3_3_3_21_21_3_3_3_3_3_21_3_21_3_3_3_3_21_3_21_3_18_18_18_18_18_18_3_3_3_3_4_4_4_4_4_4_4_4_4_4_4_4_4_4_4_4_4_4
5332,146,1330059420,18,22,18,1330059480,60,4532220,6670800,2138580,16_16_16_16_16_16_16_1_16_1_16_1_1_16_1_16_16_2_1_1_16_1_2_16_2_2_3_3_3_3_21_21_3_3_3_3_3_21_3_21_3_3_3_3_21_3_21_3_18_18_18_18_18_18_3_3_3_3_4_4_4_4_4_4_4_4_4_4_4_4_4_4_4_4_4_4_18
5333,146,1330059480,18,22,4,1330059480,0,4532280,6670800,2138520,16_16_16_16_16_16_16_1_16_1_16_1_1_16_1_16_16_2_1_1_16_1_2_16_2_2_3_3_3_3_21_21_3_3_3_3_3_21_3_21_3_3_3_3_21_3_21_3_18_18_18_18_18_18_3_3_3_3_4_4_4_4_4_4_4_4_4_4_4_4_4_4_4_4_4_4_18_18
5334,146,1330059480,4,22,4,1330077120,17640,4532280,6670800,2138520,16_16_16_16_16_16_16_1_16_1_16_1_1_16_1_16_16_2_1_1_16_1_2_16_2_2_3_3_3_3_21_21_3_3_3_3_3_21_3_21_3_3_3_3_21_3_21_3_18_18_18_18_18_18_3_3_3_3_4_4_4_4_4_4_4_4_4_4_4_4_4_4_4_4_4_4_18_18_4
5335,63,1330059540,18,22,18,1330077120,17580,3208080,6232860,3024780,16_16_16_16_16_16_16_16_16_0_0_16_16_0_16_16_0_16_16_0_0_16_16_16_0_0_16_0_0_16_0_16_0_0_0_16_1_1_1_16_16_16_0_1_1_1_16_0_0_16_16_0_16_0_16_0_0_2_2_1_1_0_0_0_0_2_2_2_2_2_2_0_1_0_1_1_0_0_0_1_1_0_0_1_1_1_0_0_0_0_0_2_2_2_2_0_0_0_0_0_0_1_1_1_1_0_0_16_0_16_16_16_16_16_0_0_1_1_2_2_1_1_16_0_2_16_2_2_2_0_1_1_1_1_1_16_16_1_1_1_3_3_18_3_18_3_3_3_3_3_18_18_18_18_3_3_3_3_18_18_18
5336,216,1330059600,19,0,19,1330080840,21240,86100,496500,410400,19_19_19_19_19_19_19
5337,213,1330059660,0,0,0,1330080900,21240,1023240,3206820,2183580,0_0_0_0_0_1_0_1_0_0_0_0_0_0_0_0_1_1_0_0_0_0_0_0_0_1_1_0_0_0_0_0_0_0_0_0_0_0_0_0_0_1_1_1_0_1_0_0_0_0_0_0_0_0_0_0_1_0_1_0_0_0_0_0_0_0_0_0_0_0_0_0_0_0_0_0_0_0_0_1_1_0_0_0_0_0_0
5338,214,1330059720,16,0,16,1330080840,21120,63300,341760,278460,22_22_16_16_16_16_16_16_16
5339,152,1330059900,1,6,1,1330070760,10860,812460,3766500,2954040,17_17_17_17_17_17_17_17_17_17_17_17_1
5340,210,1330060200,10,13,10,1330061940,1740,73560,1118160,1044600,10_10_10_10_10
5341,210,1330061940,10,13,10,1330062900,960,75300,1118160,1042860,10_10_10_10_10_10_10
5342,210,1330061940,10,13,10,1330061940,0,75300,1118160,1042860,10_10_10_10_10_10
5343,90,1330062300,9,9,9,1330062540,240,347640,1532940,1185300,19_19_19_19_19_19_19_19_1_1_19_19_19_19_19_19_19_19_1_1_1_1_9_9_9
5344,142,1330062420,15,9,15,1330080780,18360,4303980,7299960,2995980,0_0_0_0_0_0_0_1_1_0_0_0_0_0_0_0_0_1_1_0_0_0_0_0_0_1_1_0_0_0_0_0_0_1_1_0_0_0_0_0_0_0_1_0_1_0_0_0_1_1_1_1_27_27_27_27_1_27_27_1_27_27_27_27_27_27_27_27_27_27_27_27_27_27_27_27_2_2_2_2_2_2_3_3_3_2_2_3_3_3_2_2_3_3_4_4_15_4_15_4_4_4_4_4_4_4_4_4_4_4_4_4_4_4_4_4_4_4_4_4_4_4_4_4_4_4_4_4_4_4_4_4_15_15_15
5345,90,1330062540,9,9,2,1330956300,893760,347880,1532940,1185060,19_19_19_19_19_19_19_19_1_1_19_19_19_19_19_19_19_19_1_1_1_1_9_9_9_9
5346,210,1330062900,10,13,10,1330081560,18660,76260,1118160,1041900,10_10_10_10_10_10_10_10_10
5347,210,1330062900,10,13,10,1330062900,0,76260,1118160,1041900,10_10_10_10_10_10_10_10
5348,152,1330070760,1,6,2,1330240620,169860,823320,3766500,2943180,17_17_17_17_17_17_17_17_17_17_17_17_1_1
5349,177,1330072260,1,9,9,1330072380,120,1315320,1713060,397740,10_10_10_10_10_10_10_10_10_10_10_10_10_10_10_10_1
5350,177,1330072380,9,4,1,1330076760,4380,1315440,1713060,397620,10_10_10_10_10_10_10_10_10_10_10_10_10_10_10_10_1_9
5351,177,1330076760,1,9,9,1330078080,1320,1319820,1713060,393240,10_10_10_10_10_10_10_10_10_10_10_10_10_10_10_10_1_9_1
5352,146,1330077120,4,22,4,1330200300,123180,4549920,6670800,2120880,16_16_16_16_16_16_16_1_16_1_16_1_1_16_1_16_16_2_1_1_16_1_2_16_2_2_3_3_3_3_21_21_3_3_3_3_3_21_3_21_3_3_3_3_21_3_21_3_18_18_18_18_18_18_3_3_3_3_4_4_4_4_4_4_4_4_4_4_4_4_4_4_4_4_4_4_18_18_4_4
5353,63,1330077120,18,22,18,1330200300,123180,3225660,6232860,3007200,16_16_16_16_16_16_16_16_16_0_0_16_16_0_16_16_0_16_16_0_0_16_16_16_0_0_16_0_0_16_0_16_0_0_0_16_1_1_1_16_16_16_0_1_1_1_16_0_0_16_16_0_16_0_16_0_0_2_2_1_1_0_0_0_0_2_2_2_2_2_2_0_1_0_1_1_0_0_0_1_1_0_0_1_1_1_0_0_0_0_0_2_2_2_2_0_0_0_0_0_0_1_1_1_1_0_0_16_0_16_16_16_16_16_0_0_1_1_2_2_1_1_16_0_2_16_2_2_2_0_1_1_1_1_1_16_16_1_1_1_3_3_18_3_18_3_3_3_3_3_18_18_18_18_3_3_3_3_18_18_18_18
5354,177,1330078080,9,4,2,1330231860,153780,1321140,1713060,391920,10_10_10_10_10_10_10_10_10_10_10_10_10_10_10_10_1_9_1_9
5355,142,1330080780,15,9,15,1330253160,172380,4322340,7299960,2977620,0_0_0_0_0_0_0_1_1_0_0_0_0_0_0_0_0_1_1_0_0_0_0_0_0_1_1_0_0_0_0_0_0_1_1_0_0_0_0_0_0_0_1_0_1_0_0_0_1_1_1_1_27_27_27_27_1_27_27_1_27_27_27_27_27_27_27_27_27_27_27_27_27_27_27_27_2_2_2_2_2_2_3_3_3_2_2_3_3_3_2_2_3_3_4_4_15_4_15_4_4_4_4_4_4_4_4_4_4_4_4_4_4_4_4_4_4_4_4_4_4_4_4_4_4_4_4_4_4_4_4_4_15_15_15_15
5356,214,1330080840,16,0,19,1330150080,69240,84420,341760,257340,22_22_16_16_16_16_16_16_16_16
5357,216,1330080840,19,0,19,1330171140,90300,107340,496500,389160,19_19_19_19_19_19_19_19
5358,213,1330080900,0,0,0,1330156800,75900,1044480,3206820,2162340,0_0_0_0_0_1_0_1_0_0_0_0_0_0_0_0_1_1_0_0_0_0_0_0_0_1_1_0_0_0_0_0_0_0_0_0_0_0_0_0_0_1_1_1_0_1_0_0_0_0_0_0_0_0_0_0_1_0_1_0_0_0_0_0_0_0_0_0_0_0_0_0_0_0_0_0_0_0_0_1_1_0_0_0_0_0_0_0
5359,210,1330081560,10,13,1,1330241520,159960,94920,1118160,1023240,10_10_10_10_10_10_10_10_10_10
5360,214,1330150080,19,0,19,1330156680,6600,153660,341760,188100,22_22_16_16_16_16_16_16_16_16_19
5361,214,1330156680,19,0,16,1330168020,11340,160260,341760,181500,22_22_16_16_16_16_16_16_16_16_19_19
5362,213,1330156800,0,11,0,1330168020,11220,1120380,3206820,2086440,0_0_0_0_0_1_0_1_0_0_0_0_0_0_0_0_1_1_0_0_0_0_0_0_0_1_1_0_0_0_0_0_0_0_0_0_0_0_0_0_0_1_1_1_0_1_0_0_0_0_0_0_0_0_0_0_1_0_1_0_0_0_0_0_0_0_0_0_0_0_0_0_0_0_0_0_0_0_0_1_1_0_0_0_0_0_0_0_0
5363,214,1330168020,16,0,19,1330200840,32820,171600,341760,170160,22_22_16_16_16_16_16_16_16_16_19_19_16
5364,213,1330168020,0,0,0,1330193700,25680,1131600,3206820,2075220,0_0_0_0_0_1_0_1_0_0_0_0_0_0_0_0_1_1_0_0_0_0_0_0_0_1_1_0_0_0_0_0_0_0_0_0_0_0_0_0_0_1_1_1_0_1_0_0_0_0_0_0_0_0_0_0_1_0_1_0_0_0_0_0_0_0_0_0_0_0_0_0_0_0_0_0_0_0_0_1_1_0_0_0_0_0_0_0_0_0
5365,216,1330171140,19,0,19,1330199880,28740,197640,496500,298860,19_19_19_19_19_19_19_19_19
5366,213,1330193700,0,11,0,1330201020,7320,1157280,3206820,2049540,0_0_0_0_0_1_0_1_0_0_0_0_0_0_0_0_1_1_0_0_0_0_0_0_0_1_1_0_0_0_0_0_0_0_0_0_0_0_0_0_0_1_1_1_0_1_0_0_0_0_0_0_0_0_0_0_1_0_1_0_0_0_0_0_0_0_0_0_0_0_0_0_0_0_0_0_0_0_0_1_1_0_0_0_0_0_0_0_0_0_0
5367,216,1330199880,19,11,19,1330225860,25980,226380,496500,270120,19_19_19_19_19_19_19_19_19_19
5368,196,1330200120,7,8,7,1330219260,19140,399420,3281700,2882280,7_7_7_7_7_7_7_7_7_7_7_7_7_7_7
5369,63,1330200300,18,17,18,1330231020,30720,3348840,6232860,2884020,16_16_16_16_16_16_16_16_16_0_0_16_16_0_16_16_0_16_16_0_0_16_16_16_0_0_16_0_0_16_0_16_0_0_0_16_1_1_1_16_16_16_0_1_1_1_16_0_0_16_16_0_16_0_16_0_0_2_2_1_1_0_0_0_0_2_2_2_2_2_2_0_1_0_1_1_0_0_0_1_1_0_0_1_1_1_0_0_0_0_0_2_2_2_2_0_0_0_0_0_0_1_1_1_1_0_0_16_0_16_16_16_16_16_0_0_1_1_2_2_1_1_16_0_2_16_2_2_2_0_1_1_1_1_1_16_16_1_1_1_3_3_18_3_18_3_3_3_3_3_18_18_18_18_3_3_3_3_18_18_18_18_18
5370,146,1330200300,4,17,4,1330231020,30720,4673100,6670800,1997700,16_16_16_16_16_16_16_1_16_1_16_1_1_16_1_16_16_2_1_1_16_1_2_16_2_2_3_3_3_3_21_21_3_3_3_3_3_21_3_21_3_3_3_3_21_3_21_3_18_18_18_18_18_18_3_3_3_3_4_4_4_4_4_4_4_4_4_4_4_4_4_4_4_4_4_4_18_18_4_4_4
5371,214,1330200840,19,11,19,1330204080,3240,204420,341760,137340,22_22_16_16_16_16_16_16_16_16_19_19_16_19
5372,213,1330201020,0,11,0,1330231320,30300,1164600,3206820,2042220,0_0_0_0_0_1_0_1_0_0_0_0_0_0_0_0_1_1_0_0_0_0_0_0_0_1_1_0_0_0_0_0_0_0_0_0_0_0_0_0_0_1_1_1_0_1_0_0_0_0_0_0_0_0_0_0_1_0_1_0_0_0_0_0_0_0_0_0_0_0_0_0_0_0_0_0_0_0_0_1_1_0_0_0_0_0_0_0_0_0_0_0
5373,214,1330204080,19,11,16,1330204080,0,207660,341760,134100,22_22_16_16_16_16_16_16_16_16_19_19_16_19_19
5374,214,1330204080,16,11,16,1330231260,27180,207660,341760,134100,22_22_16_16_16_16_16_16_16_16_19_19_16_19_19_16
5375,49,1330207200,6,30,6,1330210800,3600,3938400,3991980,53580,29_29_30_30_5_31_6
5376,49,1330207200,5,18,31,1330207200,0,3938400,3991980,53580,29_29_30_30_5
5377,49,1330207200,31,18,6,1330207200,0,3938400,3991980,53580,29_29_30_30_5_31
5378,71,1330207200,6,30,6,1330210800,3600,3945600,3996240,50640,29_29_1_1_7_7_1_7_1_7_7_7_7_7_1_7_1_7_7_7_7_7_7_1_1_7_7_7_7_7_7_7_7_1_1_7_7_7_7_1_1_1_1_7_7_1_7_1_7_7_7_7_7_7_7_1_7_7_7_1_7_7_7_7_7_7_7_1_7_1_7_7_7_7_7_7_7_1_7_7_7_32_1_32_32_5_5_32_7_7_32_32_32_32_32_32_32_32_32_32_7_32_7_32_32_32_32_32_32_32_32_32_32_32_32_32_32_32_32_32_32_32_6
5379,49,1330210800,6,30,5,1330211700,900,3942000,3991980,49980,29_29_30_30_5_31_6_6
5380,71,1330210800,6,30,5,1330245000,34200,3949200,3996240,47040,29_29_1_1_7_7_1_7_1_7_7_7_7_7_1_7_1_7_7_7_7_7_7_1_1_7_7_7_7_7_7_7_7_1_1_7_7_7_7_1_1_1_1_7_7_1_7_1_7_7_7_7_7_7_7_1_7_7_7_1_7_7_7_7_7_7_7_1_7_1_7_7_7_7_7_7_7_1_7_7_7_32_1_32_32_5_5_32_7_7_32_32_32_32_32_32_32_32_32_32_7_32_7_32_32_32_32_32_32_32_32_32_32_32_32_32_32_32_32_32_32_32_6_6
5381,49,1330211700,31,18,32,1330256280,44580,3942900,3991980,49080,29_29_30_30_5_31_6_6_5_31
5382,49,1330211700,5,18,31,1330211700,0,3942900,3991980,49080,29_29_30_30_5_31_6_6_5
5383,196,1330219260,7,8,7,1330221420,2160,418560,3281700,2863140,7_7_7_7_7_7_7_7_7_7_7_7_7_7_7_7
5384,196,1330221420,7,8,7,1330232400,10980,420720,3281700,2860980,7_7_7_7_7_7_7_7_7_7_7_7_7_7_7_7_7
5385,216,1330225860,19,11,19,1330232400,6540,252360,496500,244140,19_19_19_19_19_19_19_19_19_19_19
5386,146,1330231020,4,17,4,1330232460,1440,4703820,6670800,1966980,16_16_16_16_16_16_16_1_16_1_16_1_1_16_1_16_16_2_1_1_16_1_2_16_2_2_3_3_3_3_21_21_3_3_3_3_3_21_3_21_3_3_3_3_21_3_21_3_18_18_18_18_18_18_3_3_3_3_4_4_4_4_4_4_4_4_4_4_4_4_4_4_4_4_4_4_18_18_4_4_4_4
5387,63,1330231020,18,17,18,1330241280,10260,3379560,6232860,2853300,16_16_16_16_16_16_16_16_16_0_0_16_16_0_16_16_0_16_16_0_0_16_16_16_0_0_16_0_0_16_0_16_0_0_0_16_1_1_1_16_16_16_0_1_1_1_16_0_0_16_16_0_16_0_16_0_0_2_2_1_1_0_0_0_0_2_2_2_2_2_2_0_1_0_1_1_0_0_0_1_1_0_0_1_1_1_0_0_0_0_0_2_2_2_2_0_0_0_0_0_0_1_1_1_1_0_0_16_0_16_16_16_16_16_0_0_1_1_2_2_1_1_16_0_2_16_2_2_2_0_1_1_1_1_1_16_16_1_1_1_3_3_18_3_18_3_3_3_3_3_18_18_18_18_3_3_3_3_18_18_18_18_18_18
5388,214,1330231260,16,11,16,1330243020,11760,234840,341760,106920,22_22_16_16_16_16_16_16_16_16_19_19_16_19_19_16_16
5389,213,1330231320,0,11,0,1330243020,11700,1194900,3206820,2011920,0_0_0_0_0_1_0_1_0_0_0_0_0_0_0_0_1_1_0_0_0_0_0_0_0_1_1_0_0_0_0_0_0_0_0_0_0_0_0_0_0_1_1_1_0_1_0_0_0_0_0_0_0_0_0_0_1_0_1_0_0_0_0_0_0_0_0_0_0_0_0_0_0_0_0_0_0_0_0_1_1_0_0_0_0_0_0_0_0_0_0_0_0
5390,177,1330231860,2,4,2,1330231920,60,1474920,1713060,238140,10_10_10_10_10_10_10_10_10_10_10_10_10_10_10_10_1_9_1_9_2
5391,177,1330231920,2,4,2,1330245660,13740,1474980,1713060,238080,10_10_10_10_10_10_10_10_10_10_10_10_10_10_10_10_1_9_1_9_2_2
5392,196,1330232400,7,8,7,1330242360,9960,431700,3281700,2850000,7_7_7_7_7_7_7_7_7_7_7_7_7_7_7_7_7_7
5393,216,1330232400,19,21,19,1330240140,7740,258900,496500,237600,19_19_19_19_19_19_19_19_19_19_19_19
5394,146,1330232460,4,5,3,1330235880,3420,4705260,6670800,1965540,16_16_16_16_16_16_16_1_16_1_16_1_1_16_1_16_16_2_1_1_16_1_2_16_2_2_3_3_3_3_21_21_3_3_3_3_3_21_3_21_3_3_3_3_21_3_21_3_18_18_18_18_18_18_3_3_3_3_4_4_4_4_4_4_4_4_4_4_4_4_4_4_4_4_4_4_18_18_4_4_4_4_4
5395,146,1330235880,3,4,3,1330240560,4680,4708680,6670800,1962120,16_16_16_16_16_16_16_1_16_1_16_1_1_16_1_16_16_2_1_1_16_1_2_16_2_2_3_3_3_3_21_21_3_3_3_3_3_21_3_21_3_3_3_3_21_3_21_3_18_18_18_18_18_18_3_3_3_3_4_4_4_4_4_4_4_4_4_4_4_4_4_4_4_4_4_4_18_18_4_4_4_4_4_3
5396,98,1330239600,5,2,5,1330250400,10800,4500180,7319880,2819700,34_34_2_2_35_35_34_34_2_2_3_3_3_3_3_3_18_18_3_3_3_18_3_3_3_18_18_18_18_3_3_18_18_18_18_18_18_18_18_3_3_18_39_3_3_39_3_3_3_3_4_4_5_5_5_5_5_5_4_4_4_5_3_5_5_3_5_4_4_4_5_5_5_5_6_6_6_6_5_5_5_5_5_5_5_5_5_5_5_5_6_6_5_5_34_34_6_6_5_5_5_5_5_5_5_5_5_5_5_5_2_2_5_18_5_18_18_18_6_6_5_5_5
5397,216,1330240140,19,21,19,1330243140,3000,266640,496500,229860,19_19_19_19_19_19_19_19_19_19_19_19_19
5398,146,1330240560,3,4,4,1330260060,19500,4713360,6670800,1957440,16_16_16_16_16_16_16_1_16_1_16_1_1_16_1_16_16_2_1_1_16_1_2_16_2_2_3_3_3_3_21_21_3_3_3_3_3_21_3_21_3_3_3_3_21_3_21_3_18_18_18_18_18_18_3_3_3_3_4_4_4_4_4_4_4_4_4_4_4_4_4_4_4_4_4_4_18_18_4_4_4_4_4_3_3
5399,152,1330240620,2,4,2,1330242420,1800,993180,3766500,2773320,17_17_17_17_17_17_17_17_17_17_17_17_1_1_2
5400,63,1330241280,18,19,5,1330250400,9120,3389820,6232860,2843040,16_16_16_16_16_16_16_16_16_0_0_16_16_0_16_16_0_16_16_0_0_16_16_16_0_0_16_0_0_16_0_16_0_0_0_16_1_1_1_16_16_16_0_1_1_1_16_0_0_16_16_0_16_0_16_0_0_2_2_1_1_0_0_0_0_2_2_2_2_2_2_0_1_0_1_1_0_0_0_1_1_0_0_1_1_1_0_0_0_0_0_2_2_2_2_0_0_0_0_0_0_1_1_1_1_0_0_16_0_16_16_16_16_16_0_0_1_1_2_2_1_1_16_0_2_16_2_2_2_0_1_1_1_1_1_16_16_1_1_1_3_3_18_3_18_3_3_3_3_3_18_18_18_18_3_3_3_3_18_18_18_18_18_18_18
5401,210,1330241520,1,9,1,1330245180,3660,254880,1118160,863280,10_10_10_10_10_10_10_10_10_10_1
5402,123,1330241580,3,3,3,1330242960,1380,3286800,3545820,259020,16_16_16_16_16_16_16_16_16_16_16_16_1_1_2_2_3_3_3_14_14_3_3_3_14_14_14_14_14_14_14_14_14_15_14_15_15_15_15_15_3
5403,196,1330242360,7,12,7,1330264620,22260,441660,3281700,2840040,7_7_7_7_7_7_7_7_7_7_7_7_7_7_7_7_7_7_7
5404,152,1330242420,2,4,17,1330293600,51180,994980,3766500,2771520,17_17_17_17_17_17_17_17_17_17_17_17_1_1_2_2
5405,123,1330242960,3,3,4,1330264500,21540,3288180,3545820,257640,16_16_16_16_16_16_16_16_16_16_16_16_1_1_2_2_3_3_3_14_14_3_3_3_14_14_14_14_14_14_14_14_14_15_14_15_15_15_15_15_3_3
5406,213,1330243020,0,0,1,1330245840,2820,1206600,3206820,2000220,0_0_0_0_0_1_0_1_0_0_0_0_0_0_0_0_1_1_0_0_0_0_0_0_0_1_1_0_0_0_0_0_0_0_0_0_0_0_0_0_0_1_1_1_0_1_0_0_0_0_0_0_0_0_0_0_1_0_1_0_0_0_0_0_0_0_0_0_0_0_0_0_0_0_0_0_0_0_0_1_1_0_0_0_0_0_0_0_0_0_0_0_0_0
5407,214,1330243020,16,0,1,1330260540,17520,246600,341760,95160,22_22_16_16_16_16_16_16_16_16_19_19_16_19_19_16_16_16
5408,102,1330243020,3,3,3,1330247520,4500,2947260,3198240,250980,43_43_43_43_16_16_8_1_16_1_8_16_16_16_2_2_3_3_13_13_13_13_15_15_3
5409,216,1330243140,19,0,19,1330247880,4740,269640,496500,226860,19_19_19_19_19_19_19_19_19_19_19_19_19_19
5410,71,1330245000,5,18,5,1330257840,12840,3983400,3996240,12840,29_29_1_1_7_7_1_7_1_7_7_7_7_7_1_7_1_7_7_7_7_7_7_1_1_7_7_7_7_7_7_7_7_1_1_7_7_7_7_1_1_1_1_7_7_1_7_1_7_7_7_7_7_7_7_1_7_7_7_1_7_7_7_7_7_7_7_1_7_1_7_7_7_7_7_7_7_1_7_7_7_32_1_32_32_5_5_32_7_7_32_32_32_32_32_32_32_32_32_32_7_32_7_32_32_32_32_32_32_32_32_32_32_32_32_32_32_32_32_32_32_32_6_6_5
5411,210,1330245180,1,9,10,1330251120,5940,258540,1118160,859620,10_10_10_10_10_10_10_10_10_10_1_1
5412,177,1330245660,2,4,2,1330248060,2400,1488720,1713060,224340,10_10_10_10_10_10_10_10_10_10_10_10_10_10_10_10_1_9_1_9_2_2_2
5413,213,1330245840,1,9,1,1330260360,14520,1209420,3206820,1997400,0_0_0_0_0_1_0_1_0_0_0_0_0_0_0_0_1_1_0_0_0_0_0_0_0_1_1_0_0_0_0_0_0_0_0_0_0_0_0_0_0_1_1_1_0_1_0_0_0_0_0_0_0_0_0_0_1_0_1_0_0_0_0_0_0_0_0_0_0_0_0_0_0_0_0_0_0_0_0_1_1_0_0_0_0_0_0_0_0_0_0_0_0_0_1
5414,157,1330247400,1,9,1,1330247460,60,359220,1993260,1634040,19_19_1_19_1_19_19_19_19_19_19_19_1_1_1
5415,157,1330247460,1,9,9,1330500960,253500,359280,1993260,1633980,19_19_1_19_1_19_19_19_19_19_19_19_1_1_1_1
5416,102,1330247520,3,3,4,1330285740,38220,2951760,3198240,246480,43_43_43_43_16_16_8_1_16_1_8_16_16_16_2_2_3_3_13_13_13_13_15_15_3_3
5417,216,1330247880,19,21,19,1330248840,960,274380,496500,222120,19_19_19_19_19_19_19_19_19_19_19_19_19_19_19
5418,24,1330247940,16,14,16,1330265280,17340,0,1547520,1547520,16
5419,177,1330248060,2,4,5,1330264380,16320,1491120,1713060,221940,10_10_10_10_10_10_10_10_10_10_10_10_10_10_10_10_1_9_1_9_2_2_2_2
5420,216,1330248840,19,21,19,1330279080,30240,275340,496500,221160,19_19_19_19_19_19_19_19_19_19_19_19_19_19_19_19
5421,63,1330250400,5,2,5,1330253400,3000,3398940,6232860,2833920,16_16_16_16_16_16_16_16_16_0_0_16_16_0_16_16_0_16_16_0_0_16_16_16_0_0_16_0_0_16_0_16_0_0_0_16_1_1_1_16_16_16_0_1_1_1_16_0_0_16_16_0_16_0_16_0_0_2_2_1_1_0_0_0_0_2_2_2_2_2_2_0_1_0_1_1_0_0_0_1_1_0_0_1_1_1_0_0_0_0_0_2_2_2_2_0_0_0_0_0_0_1_1_1_1_0_0_16_0_16_16_16_16_16_0_0_1_1_2_2_1_1_16_0_2_16_2_2_2_0_1_1_1_1_1_16_16_1_1_1_3_3_18_3_18_3_3_3_3_3_18_18_18_18_3_3_3_3_18_18_18_18_18_18_18_5
5422,98,1330250400,5,2,5,1330326000,75600,4510980,7319880,2808900,34_34_2_2_35_35_34_34_2_2_3_3_3_3_3_3_18_18_3_3_3_18_3_3_3_18_18_18_18_3_3_18_18_18_18_18_18_18_18_3_3_18_39_3_3_39_3_3_3_3_4_4_5_5_5_5_5_5_4_4_4_5_3_5_5_3_5_4_4_4_5_5_5_5_6_6_6_6_5_5_5_5_5_5_5_5_5_5_5_5_6_6_5_5_34_34_6_6_5_5_5_5_5_5_5_5_5_5_5_5_2_2_5_18_5_18_18_18_6_6_5_5_5_5
5423,210,1330251120,10,16,10,1330260720,9600,264480,1118160,853680,10_10_10_10_10_10_10_10_10_10_1_1_10
5424,142,1330253160,15,9,15,1330260420,7260,4494720,7299960,2805240,0_0_0_0_0_0_0_1_1_0_0_0_0_0_0_0_0_1_1_0_0_0_0_0_0_1_1_0_0_0_0_0_0_1_1_0_0_0_0_0_0_0_1_0_1_0_0_0_1_1_1_1_27_27_27_27_1_27_27_1_27_27_27_27_27_27_27_27_27_27_27_27_27_27_27_27_2_2_2_2_2_2_3_3_3_2_2_3_3_3_2_2_3_3_4_4_15_4_15_4_4_4_4_4_4_4_4_4_4_4_4_4_4_4_4_4_4_4_4_4_4_4_4_4_4_4_4_4_4_4_4_4_15_15_15_15_15
5425,63,1330253400,5,2,5,1330255200,1800,3401940,6232860,2830920,16_16_16_16_16_16_16_16_16_0_0_16_16_0_16_16_0_16_16_0_0_16_16_16_0_0_16_0_0_16_0_16_0_0_0_16_1_1_1_16_16_16_0_1_1_1_16_0_0_16_16_0_16_0_16_0_0_2_2_1_1_0_0_0_0_2_2_2_2_2_2_0_1_0_1_1_0_0_0_1_1_0_0_1_1_1_0_0_0_0_0_2_2_2_2_0_0_0_0_0_0_1_1_1_1_0_0_16_0_16_16_16_16_16_0_0_1_1_2_2_1_1_16_0_2_16_2_2_2_0_1_1_1_1_1_16_16_1_1_1_3_3_18_3_18_3_3_3_3_3_18_18_18_18_3_3_3_3_18_18_18_18_18_18_18_5_5
5426,63,1330255200,5,2,18,1330264440,9240,3403740,6232860,2829120,16_16_16_16_16_16_16_16_16_0_0_16_16_0_16_16_0_16_16_0_0_16_16_16_0_0_16_0_0_16_0_16_0_0_0_16_1_1_1_16_16_16_0_1_1_1_16_0_0_16_16_0_16_0_16_0_0_2_2_1_1_0_0_0_0_2_2_2_2_2_2_0_1_0_1_1_0_0_0_1_1_0_0_1_1_1_0_0_0_0_0_2_2_2_2_0_0_0_0_0_0_1_1_1_1_0_0_16_0_16_16_16_16_16_0_0_1_1_2_2_1_1_16_0_2_16_2_2_2_0_1_1_1_1_1_16_16_1_1_1_3_3_18_3_18_3_3_3_3_3_18_18_18_18_3_3_3_3_18_18_18_18_18_18_18_5_5_5
5427,169,1330255560,50,10,1,1330257600,2040,593820,2190660,1596840,50_50_50_50_50_50_50_50_50_50_50_50_50_50_50_50_50_1_1_50_50_50_50
5428,49,1330256280,32,18,5,1330256340,60,3987480,3991980,4500,29_29_30_30_5_31_6_6_5_31_32
5429,49,1330256340,5,18,5,1330257600,1260,3987540,3991980,4440,29_29_30_30_5_31_6_6_5_31_32_5
5430,49,1330257600,5,18,32,1330260780,3180,3988800,3991980,3180,29_29_30_30_5_31_6_6_5_31_32_5_5
5431,169,1330257600,1,18,1,1330263060,5460,595860,2190660,1594800,50_50_50_50_50_50_50_50_50_50_50_50_50_50_50_50_50_1_1_50_50_50_50_1
5432,71,1330257840,5,18,99,1330257840,0,3996240,3996240,0,29_29_1_1_7_7_1_7_1_7_7_7_7_7_1_7_1_7_7_7_7_7_7_1_1_7_7_7_7_7_7_7_7_1_1_7_7_7_7_1_1_1_1_7_7_1_7_1_7_7_7_7_7_7_7_1_7_7_7_1_7_7_7_7_7_7_7_1_7_1_7_7_7_7_7_7_7_1_7_7_7_32_1_32_32_5_5_32_7_7_32_32_32_32_32_32_32_32_32_32_7_32_7_32_32_32_32_32_32_32_32_32_32_32_32_32_32_32_32_32_32_32_6_6_5_5
5433,146,1330260060,4,5,4,1330260120,60,4732860,6670800,1937940,16_16_16_16_16_16_16_1_16_1_16_1_1_16_1_16_16_2_1_1_16_1_2_16_2_2_3_3_3_3_21_21_3_3_3_3_3_21_3_21_3_3_3_3_21_3_21_3_18_18_18_18_18_18_3_3_3_3_4_4_4_4_4_4_4_4_4_4_4_4_4_4_4_4_4_4_18_18_4_4_4_4_4_3_3_4
5434,146,1330260120,4,5,4,1330263420,3300,4732920,6670800,1937880,16_16_16_16_16_16_16_1_16_1_16_1_1_16_1_16_16_2_1_1_16_1_2_16_2_2_3_3_3_3_21_21_3_3_3_3_3_21_3_21_3_3_3_3_21_3_21_3_18_18_18_18_18_18_3_3_3_3_4_4_4_4_4_4_4_4_4_4_4_4_4_4_4_4_4_4_18_18_4_4_4_4_4_3_3_4_4
5435,213,1330260360,1,9,0,1330279920,19560,1223940,3206820,1982880,0_0_0_0_0_1_0_1_0_0_0_0_0_0_0_0_1_1_0_0_0_0_0_0_0_1_1_0_0_0_0_0_0_0_0_0_0_0_0_0_0_1_1_1_0_1_0_0_0_0_0_0_0_0_0_0_1_0_1_0_0_0_0_0_0_0_0_0_0_0_0_0_0_0_0_0_0_0_0_1_1_0_0_0_0_0_0_0_0_0_0_0_0_0_1_1
5436,142,1330260420,5,9,5,1330260480,60,4501980,7299960,2797980,0_0_0_0_0_0_0_1_1_0_0_0_0_0_0_0_0_1_1_0_0_0_0_0_0_1_1_0_0_0_0_0_0_1_1_0_0_0_0_0_0_0_1_0_1_0_0_0_1_1_1_1_27_27_27_27_1_27_27_1_27_27_27_27_27_27_27_27_27_27_27_27_27_27_27_27_2_2_2_2_2_2_3_3_3_2_2_3_3_3_2_2_3_3_4_4_15_4_15_4_4_4_4_4_4_4_4_4_4_4_4_4_4_4_4_4_4_4_4_4_4_4_4_4_4_4_4_4_4_4_4_4_15_15_15_15_15_15_5
5437,142,1330260420,15,9,5,1330260420,0,4501980,7299960,2797980,0_0_0_0_0_0_0_1_1_0_0_0_0_0_0_0_0_1_1_0_0_0_0_0_0_1_1_0_0_0_0_0_0_1_1_0_0_0_0_0_0_0_1_0_1_0_0_0_1_1_1_1_27_27_27_27_1_27_27_1_27_27_27_27_27_27_27_27_27_27_27_27_27_27_27_27_2_2_2_2_2_2_3_3_3_2_2_3_3_3_2_2_3_3_4_4_15_4_15_4_4_4_4_4_4_4_4_4_4_4_4_4_4_4_4_4_4_4_4_4_4_4_4_4_4_4_4_4_4_4_4_4_15_15_15_15_15_15
5438,142,1330260480,5,9,6,1330293600,33120,4502040,7299960,2797920,0_0_0_0_0_0_0_1_1_0_0_0_0_0_0_0_0_1_1_0_0_0_0_0_0_1_1_0_0_0_0_0_0_1_1_0_0_0_0_0_0_0_1_0_1_0_0_0_1_1_1_1_27_27_27_27_1_27_27_1_27_27_27_27_27_27_27_27_27_27_27_27_27_27_27_27_2_2_2_2_2_2_3_3_3_2_2_3_3_3_2_2_3_3_4_4_15_4_15_4_4_4_4_4_4_4_4_4_4_4_4_4_4_4_4_4_4_4_4_4_4_4_4_4_4_4_4_4_4_4_4_4_15_15_15_15_15_15_5_5
5439,214,1330260540,1,9,1,1330264320,3780,264120,341760,77640,22_22_16_16_16_16_16_16_16_16_19_19_16_19_19_16_16_16_1
5440,210,1330260720,10,16,1,1330261020,300,274080,1118160,844080,10_10_10_10_10_10_10_10_10_10_1_1_10_10
5441,49,1330260780,32,18,99,1330260780,0,3991980,3991980,0,29_29_30_30_5_31_6_6_5_31_32_5_5_32
5442,210,1330261020,1,9,1,1330261080,60,274380,1118160,843780,10_10_10_10_10_10_10_10_10_10_1_1_10_10_1
5443,210,1330261080,1,9,2,1330267080,6000,274440,1118160,843720,10_10_10_10_10_10_10_10_10_10_1_1_10_10_1_1
5444,217,1330262400,8,9,8,1330264320,1920,435600,557700,122100,16_16_16_16_16_16_16_16_8_8_16_16_16_16_16_16_16_16_16_8_8_16_8
5445,169,1330263060,1,18,50,1330264620,1560,601320,2190660,1589340,50_50_50_50_50_50_50_50_50_50_50_50_50_50_50_50_50_1_1_50_50_50_50_1_1
5446,107,1330263120,1,18,1,1330267320,4200,2336520,4991760,2655240,8_8_8_8_28_28_28_28_28_28_8_8_8_8_16_16_16_16_16_1_16_16_16_1_16_16_16_16_1_16_1_16_16_16_16_16_16_16_1_16_1_16_16_16_16_16_1_1_16_16_16_1_1_16_16_16_16_16_16_16_16_16_1
5447,146,1330263420,4,5,5,1330341600,78180,4736220,6670800,1934580,16_16_16_16_16_16_16_1_16_1_16_1_1_16_1_16_16_2_1_1_16_1_2_16_2_2_3_3_3_3_21_21_3_3_3_3_3_21_3_21_3_3_3_3_21_3_21_3_18_18_18_18_18_18_3_3_3_3_4_4_4_4_4_4_4_4_4_4_4_4_4_4_4_4_4_4_18_18_4_4_4_4_4_3_3_4_4_4
5448,19,1330264140,14,17,14,1330293060,28920,377940,608940,231000,14_14_14_14_14_14_6_6_14_5_5_14_14_14_14
5449,214,1330264320,1,9,6,1330293600,29280,267900,341760,73860,22_22_16_16_16_16_16_16_16_16_19_19_16_19_19_16_16_16_1_1
5450,217,1330264320,8,9,2,1330350000,85680,437520,557700,120180,16_16_16_16_16_16_16_16_8_8_16_16_16_16_16_16_16_16_16_8_8_16_8_8
5451,177,1330264380,5,9,5,1330272060,7680,1507440,1713060,205620,10_10_10_10_10_10_10_10_10_10_10_10_10_10_10_10_1_9_1_9_2_2_2_2_5
5452,63,1330264440,18,19,5,1330272120,7680,3412980,6232860,2819880,16_16_16_16_16_16_16_16_16_0_0_16_16_0_16_16_0_16_16_0_0_16_16_16_0_0_16_0_0_16_0_16_0_0_0_16_1_1_1_16_16_16_0_1_1_1_16_0_0_16_16_0_16_0_16_0_0_2_2_1_1_0_0_0_0_2_2_2_2_2_2_0_1_0_1_1_0_0_0_1_1_0_0_1_1_1_0_0_0_0_0_2_2_2_2_0_0_0_0_0_0_1_1_1_1_0_0_16_0_16_16_16_16_16_0_0_1_1_2_2_1_1_16_0_2_16_2_2_2_0_1_1_1_1_1_16_16_1_1_1_3_3_18_3_18_3_3_3_3_3_18_18_18_18_3_3_3_3_18_18_18_18_18_18_18_5_5_5_18
5453,123,1330264500,4,19,4,1330272360,7860,3309720,3545820,236100,16_16_16_16_16_16_16_16_16_16_16_16_1_1_2_2_3_3_3_14_14_3_3_3_14_14_14_14_14_14_14_14_14_15_14_15_15_15_15_15_3_3_4
5454,169,1330264620,50,10,50,1330264740,120,602880,2190660,1587780,50_50_50_50_50_50_50_50_50_50_50_50_50_50_50_50_50_1_1_50_50_50_50_1_1_50
5455,196,1330264620,7,12,1,1330267440,2820,463920,3281700,2817780,7_7_7_7_7_7_7_7_7_7_7_7_7_7_7_7_7_7_7_7
5456,169,1330264740,50,8,50,1330269660,4920,603000,2190660,1587660,50_50_50_50_50_50_50_50_50_50_50_50_50_50_50_50_50_1_1_50_50_50_50_1_1_50_50
5457,24,1330265280,16,14,16,1330265880,600,17340,1547520,1530180,16_16
5458,76,1330265700,3,3,3,1330267080,1380,4724100,7552500,2828400,3_3_3_3_3_3_3_3_3_18_3_18_18_18_18_18_3_3_3_1_1_3_17_17_17_18_17_17_18_18_18_18_18_17_17_18_3_3_18_17_18_18_17_18_18_17_17_17_5_5_5_5_1_1_17_17_17_2_2_17_17_17_5_5_5_5_5_5_17_17_5_5_5_17_5_5_5_5_5_17_17_17_1_1_1_1_1_1_1_1_2_2_34_34_5_5_5_5_6_6_3
5459,24,1330265880,16,20,16,1330291560,25680,17940,1547520,1529580,16_16_16
5460,210,1330267080,2,3,2,1330270260,3180,280440,1118160,837720,10_10_10_10_10_10_10_10_10_10_1_1_10_10_1_1_2
5461,76,1330267080,3,3,4,1330293540,26460,4725480,7552500,2827020,3_3_3_3_3_3_3_3_3_18_3_18_18_18_18_18_3_3_3_1_1_3_17_17_17_18_17_17_18_18_18_18_18_17_17_18_3_3_18_17_18_18_17_18_18_17_17_17_5_5_5_5_1_1_17_17_17_2_2_17_17_17_5_5_5_5_5_5_17_17_5_5_5_17_5_5_5_5_5_17_17_17_1_1_1_1_1_1_1_1_2_2_34_34_5_5_5_5_6_6_3_3
5462,107,1330267320,1,18,1,1330591860,324540,2340720,4991760,2651040,8_8_8_8_28_28_28_28_28_28_8_8_8_8_16_16_16_16_16_1_16_16_16_1_16_16_16_16_1_16_1_16_16_16_16_16_16_16_1_16_1_16_16_16_16_16_1_1_16_16_16_1_1_16_16_16_16_16_16_16_16_16_1_1
5463,196,1330267440,1,18,1,1330268400,960,466740,3281700,2814960,7_7_7_7_7_7_7_7_7_7_7_7_7_7_7_7_7_7_7_7_1
5464,57,1330267740,26,13,26,1330281780,14040,0,2756640,2756640,26
5465,196,1330268400,1,18,1,1330268460,60,467700,3281700,2814000,7_7_7_7_7_7_7_7_7_7_7_7_7_7_7_7_7_7_7_7_1_1
5466,196,1330268460,1,18,1,1330272000,3540,467760,3281700,2813940,7_7_7_7_7_7_7_7_7_7_7_7_7_7_7_7_7_7_7_7_1_1_1
5467,169,1330269660,50,8,50,1330269720,60,607920,2190660,1582740,50_50_50_50_50_50_50_50_50_50_50_50_50_50_50_50_50_1_1_50_50_50_50_1_1_50_50_50
5468,169,1330269720,50,8,50,1330292820,23100,607980,2190660,1582680,50_50_50_50_50_50_50_50_50_50_50_50_50_50_50_50_50_1_1_50_50_50_50_1_1_50_50_50_50
5469,210,1330270260,2,3,9,1330503240,232980,283620,1118160,834540,10_10_10_10_10_10_10_10_10_10_1_1_10_10_1_1_2_2
5470,196,1330272000,1,18,7,1330273860,1860,471300,3281700,2810400,7_7_7_7_7_7_7_7_7_7_7_7_7_7_7_7_7_7_7_7_1_1_1_1
5471,177,1330272060,5,9,5,1330344840,72780,1515120,1713060,197940,10_10_10_10_10_10_10_10_10_10_10_10_10_10_10_10_1_9_1_9_2_2_2_2_5_5
5472,63,1330272120,5,2,18,1330280700,8580,3420660,6232860,2812200,16_16_16_16_16_16_16_16_16_0_0_16_16_0_16_16_0_16_16_0_0_16_16_16_0_0_16_0_0_16_0_16_0_0_0_16_1_1_1_16_16_16_0_1_1_1_16_0_0_16_16_0_16_0_16_0_0_2_2_1_1_0_0_0_0_2_2_2_2_2_2_0_1_0_1_1_0_0_0_1_1_0_0_1_1_1_0_0_0_0_0_2_2_2_2_0_0_0_0_0_0_1_1_1_1_0_0_16_0_16_16_16_16_16_0_0_1_1_2_2_1_1_16_0_2_16_2_2_2_0_1_1_1_1_1_16_16_1_1_1_3_3_18_3_18_3_3_3_3_3_18_18_18_18_3_3_3_3_18_18_18_18_18_18_18_5_5_5_18_5
5473,123,1330272360,4,19,4,1330281540,9180,3317580,3545820,228240,16_16_16_16_16_16_16_16_16_16_16_16_1_1_2_2_3_3_3_14_14_3_3_3_14_14_14_14_14_14_14_14_14_15_14_15_15_15_15_15_3_3_4_4
5474,196,1330273860,7,8,7,1330281300,7440,473160,3281700,2808540,7_7_7_7_7_7_7_7_7_7_7_7_7_7_7_7_7_7_7_7_1_1_1_1_7
5475,216,1330279080,19,0,19,1330286400,7320,305580,496500,190920,19_19_19_19_19_19_19_19_19_19_19_19_19_19_19_19_19
5476,213,1330279920,0,11,0,1330298160,18240,1243500,3206820,1963320,0_0_0_0_0_1_0_1_0_0_0_0_0_0_0_0_1_1_0_0_0_0_0_0_0_1_1_0_0_0_0_0_0_0_0_0_0_0_0_0_0_1_1_1_0_1_0_0_0_0_0_0_0_0_0_0_1_0_1_0_0_0_0_0_0_0_0_0_0_0_0_0_0_0_0_0_0_0_0_1_1_0_0_0_0_0_0_0_0_0_0_0_0_0_1_1_0
5477,63,1330280700,18,22,18,1330306440,25740,3429240,6232860,2803620,16_16_16_16_16_16_16_16_16_0_0_16_16_0_16_16_0_16_16_0_0_16_16_16_0_0_16_0_0_16_0_16_0_0_0_16_1_1_1_16_16_16_0_1_1_1_16_0_0_16_16_0_16_0_16_0_0_2_2_1_1_0_0_0_0_2_2_2_2_2_2_0_1_0_1_1_0_0_0_1_1_0_0_1_1_1_0_0_0_0_0_2_2_2_2_0_0_0_0_0_0_1_1_1_1_0_0_16_0_16_16_16_16_16_0_0_1_1_2_2_1_1_16_0_2_16_2_2_2_0_1_1_1_1_1_16_16_1_1_1_3_3_18_3_18_3_3_3_3_3_18_18_18_18_3_3_3_3_18_18_18_18_18_18_18_5_5_5_18_5_18
5478,196,1330281300,7,8,1,1330331400,50100,480600,3281700,2801100,7_7_7_7_7_7_7_7_7_7_7_7_7_7_7_7_7_7_7_7_1_1_1_1_7_7
5479,123,1330281540,4,23,4,1330285740,4200,3326760,3545820,219060,16_16_16_16_16_16_16_16_16_16_16_16_1_1_2_2_3_3_3_14_14_3_3_3_14_14_14_14_14_14_14_14_14_15_14_15_15_15_15_15_3_3_4_4_4
5480,57,1330281780,26,13,26,1330284000,2220,14040,2756640,2742600,26_26
5481,57,1330284000,26,13,26,1330287360,3360,16260,2756640,2740380,26_26_26
5482,123,1330285740,4,23,5,1330498800,213060,3330960,3545820,214860,16_16_16_16_16_16_16_16_16_16_16_16_1_1_2_2_3_3_3_14_14_3_3_3_14_14_14_14_14_14_14_14_14_15_14_15_15_15_15_15_3_3_4_4_4_4
5483,102,1330285740,4,23,4,1330293360,7620,2989980,3198240,208260,43_43_43_43_16_16_8_1_16_1_8_16_16_16_2_2_3_3_13_13_13_13_15_15_3_3_4
5484,216,1330286400,19,11,19,1330317780,31380,312900,496500,183600,19_19_19_19_19_19_19_19_19_19_19_19_19_19_19_19_19_19
5485,57,1330287360,26,13,26,1330290420,3060,19620,2756640,2737020,26_26_26_26_26
5486,57,1330287360,26,13,26,1330287360,0,19620,2756640,2737020,26_26_26_26
5487,57,1330290420,26,13,26,1330290420,0,22680,2756640,2733960,26_26_26_26_26_26
5488,57,1330290420,26,13,26,1330295280,4860,22680,2756640,2733960,26_26_26_26_26_26_26
5489,24,1330291560,16,20,16,1330295880,4320,43620,1547520,1503900,16_16_16_16
5490,169,1330292820,50,8,50,1330292880,60,631080,2190660,1559580,50_50_50_50_50_50_50_50_50_50_50_50_50_50_50_50_50_1_1_50_50_50_50_1_1_50_50_50_50_50
5491,169,1330292880,50,0,50,1330318140,25260,631140,2190660,1559520,50_50_50_50_50_50_50_50_50_50_50_50_50_50_50_50_50_1_1_50_50_50_50_1_1_50_50_50_50_50_50
5492,19,1330293060,14,17,14,1330351200,58140,406860,608940,202080,14_14_14_14_14_14_6_6_14_5_5_14_14_14_14_14
5493,102,1330293360,4,23,4,1330295160,1800,2997600,3198240,200640,43_43_43_43_16_16_8_1_16_1_8_16_16_16_2_2_3_3_13_13_13_13_15_15_3_3_4_4_4
5494,102,1330293360,4,23,4,1330293360,0,2997600,3198240,200640,43_43_43_43_16_16_8_1_16_1_8_16_16_16_2_2_3_3_13_13_13_13_15_15_3_3_4_4
5495,76,1330293540,4,23,3,1330293600,60,4751940,7552500,2800560,3_3_3_3_3_3_3_3_3_18_3_18_18_18_18_18_3_3_3_1_1_3_17_17_17_18_17_17_18_18_18_18_18_17_17_18_3_3_18_17_18_18_17_18_18_17_17_17_5_5_5_5_1_1_17_17_17_2_2_17_17_17_5_5_5_5_5_5_17_17_5_5_5_17_5_5_5_5_5_17_17_17_1_1_1_1_1_1_1_1_2_2_34_34_5_5_5_5_6_6_3_3_4
5496,76,1330293600,3,4,3,1330298100,4500,4752000,7552500,2800500,3_3_3_3_3_3_3_3_3_18_3_18_18_18_18_18_3_3_3_1_1_3_17_17_17_18_17_17_18_18_18_18_18_17_17_18_3_3_18_17_18_18_17_18_18_17_17_17_5_5_5_5_1_1_17_17_17_2_2_17_17_17_5_5_5_5_5_5_17_17_5_5_5_17_5_5_5_5_5_17_17_17_1_1_1_1_1_1_1_1_2_2_34_34_5_5_5_5_6_6_3_3_4_3
5497,152,1330293600,17,44,17,1330293600,0,1046160,3766500,2720340,17_17_17_17_17_17_17_17_17_17_17_17_1_1_2_2_17
5498,214,1330293600,6,24,6,1330297200,3600,297180,341760,44580,22_22_16_16_16_16_16_16_16_16_19_19_16_19_19_16_16_16_1_1_6
5499,184,1330293600,2,3,2,1330298100,4500,1796400,1800900,4500,10_10_10_10_10_10_10_10_10_10_10_10_1_1_10_1_1_10_10_9_10_9_1_1_9_9_2_2_5_5_6_6_6_6_2
5500,142,1330293600,6,7,6,1330297200,3600,4535160,7299960,2764800,0_0_0_0_0_0_0_1_1_0_0_0_0_0_0_0_0_1_1_0_0_0_0_0_0_1_1_0_0_0_0_0_0_1_1_0_0_0_0_0_0_0_1_0_1_0_0_0_1_1_1_1_27_27_27_27_1_27_27_1_27_27_27_27_27_27_27_27_27_27_27_27_27_27_27_27_2_2_2_2_2_2_3_3_3_2_2_3_3_3_2_2_3_3_4_4_15_4_15_4_4_4_4_4_4_4_4_4_4_4_4_4_4_4_4_4_4_4_4_4_4_4_4_4_4_4_4_4_4_4_4_4_15_15_15_15_15_15_5_5_6
5501,66,1330293600,2,3,2,1330298100,4500,4813200,4817700,4500,3_3_4_4_4_4_4_4_4_4_4_4_4_4_4_4_4_4_4_4_4_3_3_4_4_4_4_4_4_4_4_4_5_5_5_5_5_5_5_5_6_6_5_5_5_5_4_4_5_5_5_5_5_5_5_5_5_5_6_6_6_6_6_6_5_5_2
5502,152,1330293600,17,12,17,1330298100,4500,1046160,3766500,2720340,17_17_17_17_17_17_17_17_17_17_17_17_1_1_2_2_17_17
5503,102,1330295160,4,23,5,1330491000,195840,2999400,3198240,198840,43_43_43_43_16_16_8_1_16_1_8_16_16_16_2_2_3_3_13_13_13_13_15_15_3_3_4_4_4_4
5504,57,1330295280,26,32,26,1330295340,60,27540,2756640,2729100,26_26_26_26_26_26_26_26
5505,57,1330295340,26,13,26,1330295400,60,27600,2756640,2729040,26_26_26_26_26_26_26_26_26
5506,57,1330295400,26,13,26,1330296120,720,27660,2756640,2728980,26_26_26_26_26_26_26_26_26_26
5507,24,1330295880,16,11,16,1330318500,22620,47940,1547520,1499580,16_16_16_16_16
5508,57,1330296120,26,13,26,1330318680,22560,28380,2756640,2728260,26_26_26_26_26_26_26_26_26_26_26
5509,214,1330297200,6,24,2,1330333680,36480,300780,341760,40980,22_22_16_16_16_16_16_16_16_16_19_19_16_19_19_16_16_16_1_1_6_6
5510,142,1330297200,6,7,15,1330334220,37020,4538760,7299960,2761200,0_0_0_0_0_0_0_1_1_0_0_0_0_0_0_0_0_1_1_0_0_0_0_0_0_1_1_0_0_0_0_0_0_1_1_0_0_0_0_0_0_0_1_0_1_0_0_0_1_1_1_1_27_27_27_27_1_27_27_1_27_27_27_27_27_27_27_27_27_27_27_27_27_27_27_27_2_2_2_2_2_2_3_3_3_2_2_3_3_3_2_2_3_3_4_4_15_4_15_4_4_4_4_4_4_4_4_4_4_4_4_4_4_4_4_4_4_4_4_4_4_4_4_4_4_4_4_4_4_4_4_4_15_15_15_15_15_15_5_5_6_6
5511,76,1330298100,3,4,4,1330300800,2700,4756500,7552500,2796000,3_3_3_3_3_3_3_3_3_18_3_18_18_18_18_18_3_3_3_1_1_3_17_17_17_18_17_17_18_18_18_18_18_17_17_18_3_3_18_17_18_18_17_18_18_17_17_17_5_5_5_5_1_1_17_17_17_2_2_17_17_17_5_5_5_5_5_5_17_17_5_5_5_17_5_5_5_5_5_17_17_17_1_1_1_1_1_1_1_1_2_2_34_34_5_5_5_5_6_6_3_3_4_3_3
5512,152,1330298100,17,12,3,1332247800,1949700,1050660,3766500,2715840,17_17_17_17_17_17_17_17_17_17_17_17_1_1_2_2_17_17_17_17
5513,152,1330298100,17,44,17,1330298100,0,1050660,3766500,2715840,17_17_17_17_17_17_17_17_17_17_17_17_1_1_2_2_17_17_17
5514,66,1330298100,2,3,99,1330298100,0,4817700,4817700,0,3_3_4_4_4_4_4_4_4_4_4_4_4_4_4_4_4_4_4_4_4_3_3_4_4_4_4_4_4_4_4_4_5_5_5_5_5_5_5_5_6_6_5_5_5_5_4_4_5_5_5_5_5_5_5_5_5_5_6_6_6_6_6_6_5_5_2_2
5515,184,1330298100,2,3,99,1330298100,0,1800900,1800900,0,10_10_10_10_10_10_10_10_10_10_10_10_1_1_10_1_1_10_10_9_10_9_1_1_9_9_2_2_5_5_6_6_6_6_2_2
5516,213,1330298160,0,11,2,1330321140,22980,1261740,3206820,1945080,0_0_0_0_0_1_0_1_0_0_0_0_0_0_0_0_1_1_0_0_0_0_0_0_0_1_1_0_0_0_0_0_0_0_0_0_0_0_0_0_0_1_1_1_0_1_0_0_0_0_0_0_0_0_0_0_1_0_1_0_0_0_0_0_0_0_0_0_0_0_0_0_0_0_0_0_0_0_0_1_1_0_0_0_0_0_0_0_0_0_0_0_0_0_1_1_0_0
5517,10,1330298280,0,11,0,1330318500,20220,0,979740,979740,0
5518,76,1330300800,4,23,4,1330300800,0,4759200,7552500,2793300,3_3_3_3_3_3_3_3_3_18_3_18_18_18_18_18_3_3_3_1_1_3_17_17_17_18_17_17_18_18_18_18_18_17_17_18_3_3_18_17_18_18_17_18_18_17_17_17_5_5_5_5_1_1_17_17_17_2_2_17_17_17_5_5_5_5_5_5_17_17_5_5_5_17_5_5_5_5_5_17_17_17_1_1_1_1_1_1_1_1_2_2_34_34_5_5_5_5_6_6_3_3_4_3_3_4
5519,76,1330300800,4,23,4,1330314000,13200,4759200,7552500,2793300,3_3_3_3_3_3_3_3_3_18_3_18_18_18_18_18_3_3_3_1_1_3_17_17_17_18_17_17_18_18_18_18_18_17_17_18_3_3_18_17_18_18_17_18_18_17_17_17_5_5_5_5_1_1_17_17_17_2_2_17_17_17_5_5_5_5_5_5_17_17_5_5_5_17_5_5_5_5_5_17_17_17_1_1_1_1_1_1_1_1_2_2_34_34_5_5_5_5_6_6_3_3_4_3_3_4_4
5520,63,1330306440,18,22,18,1330306800,360,3454980,6232860,2777880,16_16_16_16_16_16_16_16_16_0_0_16_16_0_16_16_0_16_16_0_0_16_16_16_0_0_16_0_0_16_0_16_0_0_0_16_1_1_1_16_16_16_0_1_1_1_16_0_0_16_16_0_16_0_16_0_0_2_2_1_1_0_0_0_0_2_2_2_2_2_2_0_1_0_1_1_0_0_0_1_1_0_0_1_1_1_0_0_0_0_0_2_2_2_2_0_0_0_0_0_0_1_1_1_1_0_0_16_0_16_16_16_16_16_0_0_1_1_2_2_1_1_16_0_2_16_2_2_2_0_1_1_1_1_1_16_16_1_1_1_3_3_18_3_18_3_3_3_3_3_18_18_18_18_3_3_3_3_18_18_18_18_18_18_18_5_5_5_18_5_18_18
5521,63,1330306800,18,23,18,1330317960,11160,3455340,6232860,2777520,16_16_16_16_16_16_16_16_16_0_0_16_16_0_16_16_0_16_16_0_0_16_16_16_0_0_16_0_0_16_0_16_0_0_0_16_1_1_1_16_16_16_0_1_1_1_16_0_0_16_16_0_16_0_16_0_0_2_2_1_1_0_0_0_0_2_2_2_2_2_2_0_1_0_1_1_0_0_0_1_1_0_0_1_1_1_0_0_0_0_0_2_2_2_2_0_0_0_0_0_0_1_1_1_1_0_0_16_0_16_16_16_16_16_0_0_1_1_2_2_1_1_16_0_2_16_2_2_2_0_1_1_1_1_1_16_16_1_1_1_3_3_18_3_18_3_3_3_3_3_18_18_18_18_3_3_3_3_18_18_18_18_18_18_18_5_5_5_18_5_18_18_18
5522,76,1330314000,4,23,4,1330317600,3600,4772400,7552500,2780100,3_3_3_3_3_3_3_3_3_18_3_18_18_18_18_18_3_3_3_1_1_3_17_17_17_18_17_17_18_18_18_18_18_17_17_18_3_3_18_17_18_18_17_18_18_17_17_17_5_5_5_5_1_1_17_17_17_2_2_17_17_17_5_5_5_5_5_5_17_17_5_5_5_17_5_5_5_5_5_17_17_17_1_1_1_1_1_1_1_1_2_2_34_34_5_5_5_5_6_6_3_3_4_3_3_4_4_4_4
5523,76,1330314000,4,23,4,1330314000,0,4772400,7552500,2780100,3_3_3_3_3_3_3_3_3_18_3_18_18_18_18_18_3_3_3_1_1_3_17_17_17_18_17_17_18_18_18_18_18_17_17_18_3_3_18_17_18_18_17_18_18_17_17_17_5_5_5_5_1_1_17_17_17_2_2_17_17_17_5_5_5_5_5_5_17_17_5_5_5_17_5_5_5_5_5_17_17_17_1_1_1_1_1_1_1_1_2_2_34_34_5_5_5_5_6_6_3_3_4_3_3_4_4_4
5524,76,1330317600,4,23,3,1330380000,62400,4776000,7552500,2776500,3_3_3_3_3_3_3_3_3_18_3_18_18_18_18_18_3_3_3_1_1_3_17_17_17_18_17_17_18_18_18_18_18_17_17_18_3_3_18_17_18_18_17_18_18_17_17_17_5_5_5_5_1_1_17_17_17_2_2_17_17_17_5_5_5_5_5_5_17_17_5_5_5_17_5_5_5_5_5_17_17_17_1_1_1_1_1_1_1_1_2_2_34_34_5_5_5_5_6_6_3_3_4_3_3_4_4_4_4_4
5525,216,1330317780,19,11,19,1330318200,420,344280,496500,152220,19_19_19_19_19_19_19_19_19_19_19_19_19_19_19_19_19_19_19
5526,63,1330317960,18,23,18,1330318200,240,3466500,6232860,2766360,16_16_16_16_16_16_16_16_16_0_0_16_16_0_16_16_0_16_16_0_0_16_16_16_0_0_16_0_0_16_0_16_0_0_0_16_1_1_1_16_16_16_0_1_1_1_16_0_0_16_16_0_16_0_16_0_0_2_2_1_1_0_0_0_0_2_2_2_2_2_2_0_1_0_1_1_0_0_0_1_1_0_0_1_1_1_0_0_0_0_0_2_2_2_2_0_0_0_0_0_0_1_1_1_1_0_0_16_0_16_16_16_16_16_0_0_1_1_2_2_1_1_16_0_2_16_2_2_2_0_1_1_1_1_1_16_16_1_1_1_3_3_18_3_18_3_3_3_3_3_18_18_18_18_3_3_3_3_18_18_18_18_18_18_18_5_5_5_18_5_18_18_18_18
5527,169,1330318140,50,0,50,1330318980,840,656400,2190660,1534260,50_50_50_50_50_50_50_50_50_50_50_50_50_50_50_50_50_1_1_50_50_50_50_1_1_50_50_50_50_50_50_50
5528,218,1330318200,1,9,1,1330319280,1080,1217880,1974480,756600,19_19_19_19_19_19_1_1_1_1_1
5529,63,1330318200,18,19,5,1330318800,600,3466740,6232860,2766120,16_16_16_16_16_16_16_16_16_0_0_16_16_0_16_16_0_16_16_0_0_16_16_16_0_0_16_0_0_16_0_16_0_0_0_16_1_1_1_16_16_16_0_1_1_1_16_0_0_16_16_0_16_0_16_0_0_2_2_1_1_0_0_0_0_2_2_2_2_2_2_0_1_0_1_1_0_0_0_1_1_0_0_1_1_1_0_0_0_0_0_2_2_2_2_0_0_0_0_0_0_1_1_1_1_0_0_16_0_16_16_16_16_16_0_0_1_1_2_2_1_1_16_0_2_16_2_2_2_0_1_1_1_1_1_16_16_1_1_1_3_3_18_3_18_3_3_3_3_3_18_18_18_18_3_3_3_3_18_18_18_18_18_18_18_5_5_5_18_5_18_18_18_18_18
5530,216,1330318200,19,0,19,1330327320,9120,344700,496500,151800,19_19_19_19_19_19_19_19_19_19_19_19_19_19_19_19_19_19_19_19
5531,10,1330318500,0,11,0,1330318740,240,20220,979740,959520,0_0
5532,24,1330318500,16,11,1,1331188500,870000,70560,1547520,1476960,16_16_16_16_16_16
5533,57,1330318680,26,33,26,1330350300,31620,50940,2756640,2705700,26_26_26_26_26_26_26_26_26_26_26_26_26
5534,57,1330318680,26,32,26,1330318680,0,50940,2756640,2705700,26_26_26_26_26_26_26_26_26_26_26_26
5535,10,1330318740,0,14,1,1330318800,60,20460,979740,959280,0_0_0
5536,10,1330318800,1,18,1,1330324800,6000,20520,979740,959220,0_0_0_1
5537,63,1330318800,5,2,5,1330324800,6000,3467340,6232860,2765520,16_16_16_16_16_16_16_16_16_0_0_16_16_0_16_16_0_16_16_0_0_16_16_16_0_0_16_0_0_16_0_16_0_0_0_16_1_1_1_16_16_16_0_1_1_1_16_0_0_16_16_0_16_0_16_0_0_2_2_1_1_0_0_0_0_2_2_2_2_2_2_0_1_0_1_1_0_0_0_1_1_0_0_1_1_1_0_0_0_0_0_2_2_2_2_0_0_0_0_0_0_1_1_1_1_0_0_16_0_16_16_16_16_16_0_0_1_1_2_2_1_1_16_0_2_16_2_2_2_0_1_1_1_1_1_16_16_1_1_1_3_3_18_3_18_3_3_3_3_3_18_18_18_18_3_3_3_3_18_18_18_18_18_18_18_5_5_5_18_5_18_18_18_18_18_5
5538,169,1330318980,50,10,1,1330326000,7020,657240,2190660,1533420,50_50_50_50_50_50_50_50_50_50_50_50_50_50_50_50_50_1_1_50_50_50_50_1_1_50_50_50_50_50_50_50_50
5539,218,1330319280,1,9,13,1330532460,213180,1218960,1974480,755520,19_19_19_19_19_19_1_1_1_1_1_1
5540,54,1330319340,5,9,5,1330320240,900,558540,1314000,755460,7_7_7_7_7_7_7_7_7_7_1_1_5
5541,54,1330320240,5,9,1,1330320300,60,559440,1314000,754560,7_7_7_7_7_7_7_7_7_7_1_1_5_5
5542,54,1330320300,1,9,1,1330320360,60,559500,1314000,754500,7_7_7_7_7_7_7_7_7_7_1_1_5_5_1
5543,54,1330320360,1,9,2,1330521780,201420,559560,1314000,754440,7_7_7_7_7_7_7_7_7_7_1_1_5_5_1_1
5544,213,1330321140,2,4,2,1330324620,3480,1284720,3206820,1922100,0_0_0_0_0_1_0_1_0_0_0_0_0_0_0_0_1_1_0_0_0_0_0_0_0_1_1_0_0_0_0_0_0_0_0_0_0_0_0_0_0_1_1_1_0_1_0_0_0_0_0_0_0_0_0_0_1_0_1_0_0_0_0_0_0_0_0_0_0_0_0_0_0_0_0_0_0_0_0_1_1_0_0_0_0_0_0_0_0_0_0_0_0_0_1_1_0_0_2
5545,103,1330321860,5,9,5,1330333560,11700,4520880,4719960,199080,19_19_19_19_19_19_19_1_1_19_19_19_19_1_1_19_19_19_19_19_1_1_2_2_9_2_2_9_9_9_9_9_14_14_14_14_13_13_13_13_13_14_13_14_14_14_13_13_13_13_13_13_44_44_44_44_44_13_44_13_13_13_44_44_44_44_44_44_5
5546,213,1330324620,2,4,3,1330324680,60,1288200,3206820,1918620,0_0_0_0_0_1_0_1_0_0_0_0_0_0_0_0_1_1_0_0_0_0_0_0_0_1_1_0_0_0_0_0_0_0_0_0_0_0_0_0_0_1_1_1_0_1_0_0_0_0_0_0_0_0_0_0_1_0_1_0_0_0_0_0_0_0_0_0_0_0_0_0_0_0_0_0_0_0_0_1_1_0_0_0_0_0_0_0_0_0_0_0_0_0_1_1_0_0_2_2
5547,213,1330324680,3,3,3,1330329840,5160,1288260,3206820,1918560,0_0_0_0_0_1_0_1_0_0_0_0_0_0_0_0_1_1_0_0_0_0_0_0_0_1_1_0_0_0_0_0_0_0_0_0_0_0_0_0_0_1_1_1_0_1_0_0_0_0_0_0_0_0_0_0_1_0_1_0_0_0_0_0_0_0_0_0_0_0_0_0_0_0_0_0_0_0_0_1_1_0_0_0_0_0_0_0_0_0_0_0_0_0_1_1_0_0_2_2_3
5548,10,1330324800,1,18,0,1330326780,1980,26520,979740,953220,0_0_0_1_1
5549,63,1330324800,5,2,5,1330329600,4800,3473340,6232860,2759520,16_16_16_16_16_16_16_16_16_0_0_16_16_0_16_16_0_16_16_0_0_16_16_16_0_0_16_0_0_16_0_16_0_0_0_16_1_1_1_16_16_16_0_1_1_1_16_0_0_16_16_0_16_0_16_0_0_2_2_1_1_0_0_0_0_2_2_2_2_2_2_0_1_0_1_1_0_0_0_1_1_0_0_1_1_1_0_0_0_0_0_2_2_2_2_0_0_0_0_0_0_1_1_1_1_0_0_16_0_16_16_16_16_16_0_0_1_1_2_2_1_1_16_0_2_16_2_2_2_0_1_1_1_1_1_16_16_1_1_1_3_3_18_3_18_3_3_3_3_3_18_18_18_18_3_3_3_3_18_18_18_18_18_18_18_5_5_5_18_5_18_18_18_18_18_5_5
5550,113,1330325520,5,6,5,1330332720,7200,3502260,3646740,144480,16_16_16_16_1_1_2_2_48_3_3_48_15_15_4_3_3_3_4_4_3_3_3_4_5
5551,98,1330326000,5,2,5,1330329600,3600,4586580,7319880,2733300,34_34_2_2_35_35_34_34_2_2_3_3_3_3_3_3_18_18_3_3_3_18_3_3_3_18_18_18_18_3_3_18_18_18_18_18_18_18_18_3_3_18_39_3_3_39_3_3_3_3_4_4_5_5_5_5_5_5_4_4_4_5_3_5_5_3_5_4_4_4_5_5_5_5_6_6_6_6_5_5_5_5_5_5_5_5_5_5_5_5_6_6_5_5_34_34_6_6_5_5_5_5_5_5_5_5_5_5_5_5_2_2_5_18_5_18_18_18_6_6_5_5_5_5_5
5552,169,1330326000,1,18,1,1330331400,5400,664260,2190660,1526400,50_50_50_50_50_50_50_50_50_50_50_50_50_50_50_50_50_1_1_50_50_50_50_1_1_50_50_50_50_50_50_50_50_1
5553,10,1330326780,0,14,0,1330339080,12300,28500,979740,951240,0_0_0_1_1_0_0
5554,10,1330326780,0,14,0,1330326780,0,28500,979740,951240,0_0_0_1_1_0
5555,216,1330327320,19,14,19,1330350600,23280,353820,496500,142680,19_19_19_19_19_19_19_19_19_19_19_19_19_19_19_19_19_19_19_19_19
5556,98,1330329600,5,2,6,1330380000,50400,4590180,7319880,2729700,34_34_2_2_35_35_34_34_2_2_3_3_3_3_3_3_18_18_3_3_3_18_3_3_3_18_18_18_18_3_3_18_18_18_18_18_18_18_18_3_3_18_39_3_3_39_3_3_3_3_4_4_5_5_5_5_5_5_4_4_4_5_3_5_5_3_5_4_4_4_5_5_5_5_6_6_6_6_5_5_5_5_5_5_5_5_5_5_5_5_6_6_5_5_34_34_6_6_5_5_5_5_5_5_5_5_5_5_5_5_2_2_5_18_5_18_18_18_6_6_5_5_5_5_5_5
5557,63,1330329600,5,2,18,1330342440,12840,3478140,6232860,2754720,16_16_16_16_16_16_16_16_16_0_0_16_16_0_16_16_0_16_16_0_0_16_16_16_0_0_16_0_0_16_0_16_0_0_0_16_1_1_1_16_16_16_0_1_1_1_16_0_0_16_16_0_16_0_16_0_0_2_2_1_1_0_0_0_0_2_2_2_2_2_2_0_1_0_1_1_0_0_0_1_1_0_0_1_1_1_0_0_0_0_0_2_2_2_2_0_0_0_0_0_0_1_1_1_1_0_0_16_0_16_16_16_16_16_0_0_1_1_2_2_1_1_16_0_2_16_2_2_2_0_1_1_1_1_1_16_16_1_1_1_3_3_18_3_18_3_3_3_3_3_18_18_18_18_3_3_3_3_18_18_18_18_18_18_18_5_5_5_18_5_18_18_18_18_18_5_5_5
5558,213,1330329840,3,3,4,1330329900,60,1293420,3206820,1913400,0_0_0_0_0_1_0_1_0_0_0_0_0_0_0_0_1_1_0_0_0_0_0_0_0_1_1_0_0_0_0_0_0_0_0_0_0_0_0_0_0_1_1_1_0_1_0_0_0_0_0_0_0_0_0_0_1_0_1_0_0_0_0_0_0_0_0_0_0_0_0_0_0_0_0_0_0_0_0_1_1_0_0_0_0_0_0_0_0_0_0_0_0_0_1_1_0_0_2_2_3_3
5559,213,1330329900,3,3,3,1330334820,4920,1293480,3206820,1913340,0_0_0_0_0_1_0_1_0_0_0_0_0_0_0_0_1_1_0_0_0_0_0_0_0_1_1_0_0_0_0_0_0_0_0_0_0_0_0_0_0_1_1_1_0_1_0_0_0_0_0_0_0_0_0_0_1_0_1_0_0_0_0_0_0_0_0_0_0_0_0_0_0_0_0_0_0_0_0_1_1_0_0_0_0_0_0_0_0_0_0_0_0_0_1_1_0_0_2_2_3_3_4_3
5560,213,1330329900,4,5,3,1330329900,0,1293480,3206820,1913340,0_0_0_0_0_1_0_1_0_0_0_0_0_0_0_0_1_1_0_0_0_0_0_0_0_1_1_0_0_0_0_0_0_0_0_0_0_0_0_0_0_1_1_1_0_1_0_0_0_0_0_0_0_0_0_0_1_0_1_0_0_0_0_0_0_0_0_0_0_0_0_0_0_0_0_0_0_0_0_1_1_0_0_0_0_0_0_0_0_0_0_0_0_0_1_1_0_0_2_2_3_3_4
5561,193,1330331400,52,37,52,1330347600,16200,0,187200,187200,52
5562,169,1330331400,1,18,50,1330351200,19800,669660,2190660,1521000,50_50_50_50_50_50_50_50_50_50_50_50_50_50_50_50_50_1_1_50_50_50_50_1_1_50_50_50_50_50_50_50_50_1_1
5563,196,1330331400,1,18,1,1330350600,19200,530700,3281700,2751000,7_7_7_7_7_7_7_7_7_7_7_7_7_7_7_7_7_7_7_7_1_1_1_1_7_7_1
5564,113,1330332720,5,6,5,1330406460,73740,3509460,3646740,137280,16_16_16_16_1_1_2_2_48_3_3_48_15_15_4_3_3_3_4_4_3_3_3_4_5_5
5565,134,1330332780,5,6,5,1330339980,7200,3519360,3656580,137220,0_0_0_0_0_0_0_0_0_0_1_1_2_2_3_3_13_13_13_13_13_13_13_13_15_15_3_3_4_4_4_4_4_4_5
5566,103,1330333560,5,9,5,1330344960,11400,4532580,4719960,187380,19_19_19_19_19_19_19_1_1_19_19_19_19_1_1_19_19_19_19_19_1_1_2_2_9_2_2_9_9_9_9_9_14_14_14_14_13_13_13_13_13_14_13_14_14_14_13_13_13_13_13_13_44_44_44_44_44_13_44_13_13_13_44_44_44_44_44_44_5_5
5567,214,1330333680,2,3,5,1330333740,60,337260,341760,4500,22_22_16_16_16_16_16_16_16_16_19_19_16_19_19_16_16_16_1_1_6_6_2
5568,214,1330333740,5,9,5,1330333800,60,337320,341760,4440,22_22_16_16_16_16_16_16_16_16_19_19_16_19_19_16_16_16_1_1_6_6_2_5
5569,214,1330333800,5,9,2,1330338180,4380,337380,341760,4380,22_22_16_16_16_16_16_16_16_16_19_19_16_19_19_16_16_16_1_1_6_6_2_5_5
5570,142,1330334220,15,9,15,1330348560,14340,4575780,7299960,2724180,0_0_0_0_0_0_0_1_1_0_0_0_0_0_0_0_0_1_1_0_0_0_0_0_0_1_1_0_0_0_0_0_0_1_1_0_0_0_0_0_0_0_1_0_1_0_0_0_1_1_1_1_27_27_27_27_1_27_27_1_27_27_27_27_27_27_27_27_27_27_27_27_27_27_27_27_2_2_2_2_2_2_3_3_3_2_2_3_3_3_2_2_3_3_4_4_15_4_15_4_4_4_4_4_4_4_4_4_4_4_4_4_4_4_4_4_4_4_4_4_4_4_4_4_4_4_4_4_4_4_4_4_15_15_15_15_15_15_5_5_6_6_15
5571,213,1330334820,3,3,4,1330334880,60,1298400,3206820,1908420,0_0_0_0_0_1_0_1_0_0_0_0_0_0_0_0_1_1_0_0_0_0_0_0_0_1_1_0_0_0_0_0_0_0_0_0_0_0_0_0_0_1_1_1_0_1_0_0_0_0_0_0_0_0_0_0_1_0_1_0_0_0_0_0_0_0_0_0_0_0_0_0_0_0_0_0_0_0_0_1_1_0_0_0_0_0_0_0_0_0_0_0_0_0_1_1_0_0_2_2_3_3_4_3_3
5572,213,1330334880,4,5,2,1330341120,6240,1298460,3206820,1908360,0_0_0_0_0_1_0_1_0_0_0_0_0_0_0_0_1_1_0_0_0_0_0_0_0_1_1_0_0_0_0_0_0_0_0_0_0_0_0_0_0_1_1_1_0_1_0_0_0_0_0_0_0_0_0_0_1_0_1_0_0_0_0_0_0_0_0_0_0_0_0_0_0_0_0_0_0_0_0_1_1_0_0_0_0_0_0_0_0_0_0_0_0_0_1_1_0_0_2_2_3_3_4_3_3_4
5573,214,1330338180,2,3,99,1330338180,0,341760,341760,0,22_22_16_16_16_16_16_16_16_16_19_19_16_19_19_16_16_16_1_1_6_6_2_5_5_2
5574,10,1330339080,0,14,1,1330428000,88920,40800,979740,938940,0_0_0_1_1_0_0_0
5575,134,1330339980,5,6,5,1330413660,73680,3526560,3656580,130020,0_0_0_0_0_0_0_0_0_0_1_1_2_2_3_3_13_13_13_13_13_13_13_13_15_15_3_3_4_4_4_4_4_4_5_5
5576,213,1330341120,2,3,2,1330341180,60,1304700,3206820,1902120,0_0_0_0_0_1_0_1_0_0_0_0_0_0_0_0_1_1_0_0_0_0_0_0_0_1_1_0_0_0_0_0_0_0_0_0_0_0_0_0_0_1_1_1_0_1_0_0_0_0_0_0_0_0_0_0_1_0_1_0_0_0_0_0_0_0_0_0_0_0_0_0_0_0_0_0_0_0_0_1_1_0_0_0_0_0_0_0_0_0_0_0_0_0_1_1_0_0_2_2_3_3_4_3_3_4_2
5577,213,1330341180,2,3,4,1330357620,16440,1304760,3206820,1902060,0_0_0_0_0_1_0_1_0_0_0_0_0_0_0_0_1_1_0_0_0_0_0_0_0_1_1_0_0_0_0_0_0_0_0_0_0_0_0_0_0_1_1_1_0_1_0_0_0_0_0_0_0_0_0_0_1_0_1_0_0_0_0_0_0_0_0_0_0_0_0_0_0_0_0_0_0_0_0_1_1_0_0_0_0_0_0_0_0_0_0_0_0_0_1_1_0_0_2_2_3_3_4_3_3_4_2_2
5578,146,1330341600,5,6,5,1330358100,16500,4814400,6670800,1856400,16_16_16_16_16_16_16_1_16_1_16_1_1_16_1_16_16_2_1_1_16_1_2_16_2_2_3_3_3_3_21_21_3_3_3_3_3_21_3_21_3_3_3_3_21_3_21_3_18_18_18_18_18_18_3_3_3_3_4_4_4_4_4_4_4_4_4_4_4_4_4_4_4_4_4_4_18_18_4_4_4_4_4_3_3_4_4_4_5
5579,63,1330342440,18,19,18,1330342500,60,3490980,6232860,2741880,16_16_16_16_16_16_16_16_16_0_0_16_16_0_16_16_0_16_16_0_0_16_16_16_0_0_16_0_0_16_0_16_0_0_0_16_1_1_1_16_16_16_0_1_1_1_16_0_0_16_16_0_16_0_16_0_0_2_2_1_1_0_0_0_0_2_2_2_2_2_2_0_1_0_1_1_0_0_0_1_1_0_0_1_1_1_0_0_0_0_0_2_2_2_2_0_0_0_0_0_0_1_1_1_1_0_0_16_0_16_16_16_16_16_0_0_1_1_2_2_1_1_16_0_2_16_2_2_2_0_1_1_1_1_1_16_16_1_1_1_3_3_18_3_18_3_3_3_3_3_18_18_18_18_3_3_3_3_18_18_18_18_18_18_18_5_5_5_18_5_18_18_18_18_18_5_5_5_18
5580,63,1330342500,18,19,18,1330344960,2460,3491040,6232860,2741820,16_16_16_16_16_16_16_16_16_0_0_16_16_0_16_16_0_16_16_0_0_16_16_16_0_0_16_0_0_16_0_16_0_0_0_16_1_1_1_16_16_16_0_1_1_1_16_0_0_16_16_0_16_0_16_0_0_2_2_1_1_0_0_0_0_2_2_2_2_2_2_0_1_0_1_1_0_0_0_1_1_0_0_1_1_1_0_0_0_0_0_2_2_2_2_0_0_0_0_0_0_1_1_1_1_0_0_16_0_16_16_16_16_16_0_0_1_1_2_2_1_1_16_0_2_16_2_2_2_0_1_1_1_1_1_16_16_1_1_1_3_3_18_3_18_3_3_3_3_3_18_18_18_18_3_3_3_3_18_18_18_18_18_18_18_5_5_5_18_5_18_18_18_18_18_5_5_5_18_18
5581,220,1330344360,0,14,0,1330350600,6240,0,2714040,2714040,0
5582,177,1330344840,5,9,5,1330344900,60,1587900,1713060,125160,10_10_10_10_10_10_10_10_10_10_10_10_10_10_10_10_1_9_1_9_2_2_2_2_5_5_5
5583,177,1330344900,5,9,6,1330380000,35100,1587960,1713060,125100,10_10_10_10_10_10_10_10_10_10_10_10_10_10_10_10_1_9_1_9_2_2_2_2_5_5_5_5
5584,63,1330344960,18,19,5,1330351920,6960,3493500,6232860,2739360,16_16_16_16_16_16_16_16_16_0_0_16_16_0_16_16_0_16_16_0_0_16_16_16_0_0_16_0_0_16_0_16_0_0_0_16_1_1_1_16_16_16_0_1_1_1_16_0_0_16_16_0_16_0_16_0_0_2_2_1_1_0_0_0_0_2_2_2_2_2_2_0_1_0_1_1_0_0_0_1_1_0_0_1_1_1_0_0_0_0_0_2_2_2_2_0_0_0_0_0_0_1_1_1_1_0_0_16_0_16_16_16_16_16_0_0_1_1_2_2_1_1_16_0_2_16_2_2_2_0_1_1_1_1_1_16_16_1_1_1_3_3_18_3_18_3_3_3_3_3_18_18_18_18_3_3_3_3_18_18_18_18_18_18_18_5_5_5_18_5_18_18_18_18_18_5_5_5_18_18_18
5585,103,1330344960,5,9,5,1330345140,180,4543980,4719960,175980,19_19_19_19_19_19_19_1_1_19_19_19_19_1_1_19_19_19_19_19_1_1_2_2_9_2_2_9_9_9_9_9_14_14_14_14_13_13_13_13_13_14_13_14_14_14_13_13_13_13_13_13_44_44_44_44_44_13_44_13_13_13_44_44_44_44_44_44_5_5_5
5586,103,1330345140,5,9,6,1330380000,34860,4544160,4719960,175800,19_19_19_19_19_19_19_1_1_19_19_19_19_1_1_19_19_19_19_19_1_1_2_2_9_2_2_9_9_9_9_9_14_14_14_14_13_13_13_13_13_14_13_14_14_14_13_13_13_13_13_13_44_44_44_44_44_13_44_13_13_13_44_44_44_44_44_44_5_5_5_5
5587,193,1330347600,52,37,26,1330351200,3600,16200,187200,171000,52_52
5588,142,1330348560,15,9,5,1330350900,2340,4590120,7299960,2709840,0_0_0_0_0_0_0_1_1_0_0_0_0_0_0_0_0_1_1_0_0_0_0_0_0_1_1_0_0_0_0_0_0_1_1_0_0_0_0_0_0_0_1_0_1_0_0_0_1_1_1_1_27_27_27_27_1_27_27_1_27_27_27_27_27_27_27_27_27_27_27_27_27_27_27_27_2_2_2_2_2_2_3_3_3_2_2_3_3_3_2_2_3_3_4_4_15_4_15_4_4_4_4_4_4_4_4_4_4_4_4_4_4_4_4_4_4_4_4_4_4_4_4_4_4_4_4_4_4_4_4_4_15_15_15_15_15_15_5_5_6_6_15_15
5589,217,1330350000,2,3,2,1330350060,60,523200,557700,34500,16_16_16_16_16_16_16_16_8_8_16_16_16_16_16_16_16_16_16_8_8_16_8_8_2
5590,217,1330350060,2,3,8,1330350420,360,523260,557700,34440,16_16_16_16_16_16_16_16_8_8_16_16_16_16_16_16_16_16_16_8_8_16_8_8_2_2
5591,57,1330350300,26,33,26,1330352040,1740,82560,2756640,2674080,26_26_26_26_26_26_26_26_26_26_26_26_26_26
5592,217,1330350420,8,9,2,1330350480,60,523620,557700,34080,16_16_16_16_16_16_16_16_8_8_16_16_16_16_16_16_16_16_16_8_8_16_8_8_2_2_8
5593,217,1330350480,2,3,8,1330350600,120,523680,557700,34020,16_16_16_16_16_16_16_16_8_8_16_16_16_16_16_16_16_16_16_8_8_16_8_8_2_2_8_2
5594,220,1330350600,0,14,0,1330364760,14160,6240,2714040,2707800,0_0
5595,196,1330350600,1,18,7,1330355580,4980,549900,3281700,2731800,7_7_7_7_7_7_7_7_7_7_7_7_7_7_7_7_7_7_7_7_1_1_1_1_7_7_1_1
5596,217,1330350600,8,9,5,1330350660,60,523800,557700,33900,16_16_16_16_16_16_16_16_8_8_16_16_16_16_16_16_16_16_16_8_8_16_8_8_2_2_8_2_8
5597,216,1330350600,19,14,8,1330415520,64920,377100,496500,119400,19_19_19_19_19_19_19_19_19_19_19_19_19_19_19_19_19_19_19_19_19_19
5598,217,1330350660,5,9,5,1330350720,60,523860,557700,33840,16_16_16_16_16_16_16_16_8_8_16_16_16_16_16_16_16_16_16_8_8_16_8_8_2_2_8_2_8_5
5599,217,1330350720,5,9,2,1330354980,4260,523920,557700,33780,16_16_16_16_16_16_16_16_8_8_16_16_16_16_16_16_16_16_16_8_8_16_8_8_2_2_8_2_8_5_5
5600,142,1330350900,5,9,5,1330351740,840,4592460,7299960,2707500,0_0_0_0_0_0_0_1_1_0_0_0_0_0_0_0_0_1_1_0_0_0_0_0_0_1_1_0_0_0_0_0_0_1_1_0_0_0_0_0_0_0_1_0_1_0_0_0_1_1_1_1_27_27_27_27_1_27_27_1_27_27_27_27_27_27_27_27_27_27_27_27_27_27_27_27_2_2_2_2_2_2_3_3_3_2_2_3_3_3_2_2_3_3_4_4_15_4_15_4_4_4_4_4_4_4_4_4_4_4_4_4_4_4_4_4_4_4_4_4_4_4_4_4_4_4_4_4_4_4_4_4_15_15_15_15_15_15_5_5_6_6_15_15_5
5601,169,1330351200,50,10,3,1330380000,28800,689460,2190660,1501200,50_50_50_50_50_50_50_50_50_50_50_50_50_50_50_50_50_1_1_50_50_50_50_1_1_50_50_50_50_50_50_50_50_1_1_50
5602,193,1330351200,26,47,26,1330354800,3600,19800,187200,167400,52_52_26
5603,19,1330351200,14,17,14,1330378140,26940,465000,608940,143940,14_14_14_14_14_14_6_6_14_5_5_14_14_14_14_14_14
5604,142,1330351740,5,9,6,1330380000,28260,4593300,7299960,2706660,0_0_0_0_0_0_0_1_1_0_0_0_0_0_0_0_0_1_1_0_0_0_0_0_0_1_1_0_0_0_0_0_0_1_1_0_0_0_0_0_0_0_1_0_1_0_0_0_1_1_1_1_27_27_27_27_1_27_27_1_27_27_27_27_27_27_27_27_27_27_27_27_27_27_27_27_2_2_2_2_2_2_3_3_3_2_2_3_3_3_2_2_3_3_4_4_15_4_15_4_4_4_4_4_4_4_4_4_4_4_4_4_4_4_4_4_4_4_4_4_4_4_4_4_4_4_4_4_4_4_4_4_15_15_15_15_15_15_5_5_6_6_15_15_5_5
5605,63,1330351920,5,2,6,1330380000,28080,3500460,6232860,2732400,16_16_16_16_16_16_16_16_16_0_0_16_16_0_16_16_0_16_16_0_0_16_16_16_0_0_16_0_0_16_0_16_0_0_0_16_1_1_1_16_16_16_0_1_1_1_16_0_0_16_16_0_16_0_16_0_0_2_2_1_1_0_0_0_0_2_2_2_2_2_2_0_1_0_1_1_0_0_0_1_1_0_0_1_1_1_0_0_0_0_0_2_2_2_2_0_0_0_0_0_0_1_1_1_1_0_0_16_0_16_16_16_16_16_0_0_1_1_2_2_1_1_16_0_2_16_2_2_2_0_1_1_1_1_1_16_16_1_1_1_3_3_18_3_18_3_3_3_3_3_18_18_18_18_3_3_3_3_18_18_18_18_18_18_18_5_5_5_18_5_18_18_18_18_18_5_5_5_18_18_18_5
5606,57,1330352040,26,13,26,1330353360,1320,84300,2756640,2672340,26_26_26_26_26_26_26_26_26_26_26_26_26_26_26
5607,159,1330352820,16,20,16,1330378980,26160,0,2480580,2480580,16
5608,57,1330353360,26,13,26,1330366020,12660,85620,2756640,2671020,26_26_26_26_26_26_26_26_26_26_26_26_26_26_26_26
5609,4,1330353600,10,13,10,1330369740,16140,0,1326000,1326000,10
5610,193,1330354800,26,47,5,1330405740,50940,23400,187200,163800,52_52_26_26
5611,217,1330354980,2,3,16,1330380000,25020,528180,557700,29520,16_16_16_16_16_16_16_16_8_8_16_16_16_16_16_16_16_16_16_8_8_16_8_8_2_2_8_2_8_5_5_2
5612,196,1330355580,7,8,7,1330379100,23520,554880,3281700,2726820,7_7_7_7_7_7_7_7_7_7_7_7_7_7_7_7_7_7_7_7_1_1_1_1_7_7_1_1_7
5613,213,1330357620,4,5,4,1330357680,60,1321200,3206820,1885620,0_0_0_0_0_1_0_1_0_0_0_0_0_0_0_0_1_1_0_0_0_0_0_0_0_1_1_0_0_0_0_0_0_0_0_0_0_0_0_0_0_1_1_1_0_1_0_0_0_0_0_0_0_0_0_0_1_0_1_0_0_0_0_0_0_0_0_0_0_0_0_0_0_0_0_0_0_0_0_1_1_0_0_0_0_0_0_0_0_0_0_0_0_0_1_1_0_0_2_2_3_3_4_3_3_4_2_2_4
5614,213,1330357680,4,5,4,1330366320,8640,1321260,3206820,1885560,0_0_0_0_0_1_0_1_0_0_0_0_0_0_0_0_1_1_0_0_0_0_0_0_0_1_1_0_0_0_0_0_0_0_0_0_0_0_0_0_0_1_1_1_0_1_0_0_0_0_0_0_0_0_0_0_1_0_1_0_0_0_0_0_0_0_0_0_0_0_0_0_0_0_0_0_0_0_0_1_1_0_0_0_0_0_0_0_0_0_0_0_0_0_1_1_0_0_2_2_3_3_4_3_3_4_2_2_4_4
5615,146,1330358100,5,6,6,1330380000,21900,4830900,6670800,1839900,16_16_16_16_16_16_16_1_16_1_16_1_1_16_1_16_16_2_1_1_16_1_2_16_2_2_3_3_3_3_21_21_3_3_3_3_3_21_3_21_3_3_3_3_21_3_21_3_18_18_18_18_18_18_3_3_3_3_4_4_4_4_4_4_4_4_4_4_4_4_4_4_4_4_4_4_18_18_4_4_4_4_4_3_3_4_4_4_5_5
5616,220,1330364760,0,0,0,1330402620,37860,20400,2714040,2693640,0_0_0
5617,57,1330366020,26,32,26,1330405080,39060,98280,2756640,2658360,26_26_26_26_26_26_26_26_26_26_26_26_26_26_26_26_26
5618,213,1330366320,4,22,4,1330367280,960,1329900,3206820,1876920,0_0_0_0_0_1_0_1_0_0_0_0_0_0_0_0_1_1_0_0_0_0_0_0_0_1_1_0_0_0_0_0_0_0_0_0_0_0_0_0_0_1_1_1_0_1_0_0_0_0_0_0_0_0_0_0_1_0_1_0_0_0_0_0_0_0_0_0_0_0_0_0_0_0_0_0_0_0_0_1_1_0_0_0_0_0_0_0_0_0_0_0_0_0_1_1_0_0_2_2_3_3_4_3_3_4_2_2_4_4_4
5619,89,1330366620,19,11,19,1330394100,27480,565500,1736340,1170840,19_19_19
5620,213,1330367280,4,22,4,1330373460,6180,1330860,3206820,1875960,0_0_0_0_0_1_0_1_0_0_0_0_0_0_0_0_1_1_0_0_0_0_0_0_0_1_1_0_0_0_0_0_0_0_0_0_0_0_0_0_0_1_1_1_0_1_0_0_0_0_0_0_0_0_0_0_1_0_1_0_0_0_0_0_0_0_0_0_0_0_0_0_0_0_0_0_0_0_0_1_1_0_0_0_0_0_0_0_0_0_0_0_0_0_1_1_0_0_2_2_3_3_4_3_3_4_2_2_4_4_4_4
5621,4,1330369740,10,13,10,1330371960,2220,16140,1326000,1309860,10_10
5622,4,1330371960,10,13,10,1330384980,13020,18360,1326000,1307640,10_10_10
5623,213,1330373460,4,22,4,1330404180,30720,1337040,3206820,1869780,0_0_0_0_0_1_0_1_0_0_0_0_0_0_0_0_1_1_0_0_0_0_0_0_0_1_1_0_0_0_0_0_0_0_0_0_0_0_0_0_0_1_1_1_0_1_0_0_0_0_0_0_0_0_0_0_1_0_1_0_0_0_0_0_0_0_0_0_0_0_0_0_0_0_0_0_0_0_0_1_1_0_0_0_0_0_0_0_0_0_0_0_0_0_1_1_0_0_2_2_3_3_4_3_3_4_2_2_4_4_4_4_4
5624,19,1330378140,14,17,14,1330436700,58560,491940,608940,117000,14_14_14_14_14_14_6_6_14_5_5_14_14_14_14_14_14_14
5625,159,1330378980,16,20,16,1330394220,15240,26160,2480580,2454420,16_16
5626,196,1330379100,7,8,1,1330412400,33300,578400,3281700,2703300,7_7_7_7_7_7_7_7_7_7_7_7_7_7_7_7_7_7_7_7_1_1_1_1_7_7_1_1_7_7
5627,63,1330380000,6,7,6,1330383600,3600,3528540,6232860,2704320,16_16_16_16_16_16_16_16_16_0_0_16_16_0_16_16_0_16_16_0_0_16_16_16_0_0_16_0_0_16_0_16_0_0_0_16_1_1_1_16_16_16_0_1_1_1_16_0_0_16_16_0_16_0_16_0_0_2_2_1_1_0_0_0_0_2_2_2_2_2_2_0_1_0_1_1_0_0_0_1_1_0_0_1_1_1_0_0_0_0_0_2_2_2_2_0_0_0_0_0_0_1_1_1_1_0_0_16_0_16_16_16_16_16_0_0_1_1_2_2_1_1_16_0_2_16_2_2_2_0_1_1_1_1_1_16_16_1_1_1_3_3_18_3_18_3_3_3_3_3_18_18_18_18_3_3_3_3_18_18_18_18_18_18_18_5_5_5_18_5_18_18_18_18_18_5_5_5_18_18_18_5_6
5628,217,1330380000,6,24,6,1330383600,3600,553200,557700,4500,16_16_16_16_16_16_16_16_8_8_16_16_16_16_16_16_16_16_16_8_8_16_8_8_2_2_8_2_8_5_5_2_16_6
5629,146,1330380000,6,7,6,1330383600,3600,4852800,6670800,1818000,16_16_16_16_16_16_16_1_16_1_16_1_1_16_1_16_16_2_1_1_16_1_2_16_2_2_3_3_3_3_21_21_3_3_3_3_3_21_3_21_3_3_3_3_21_3_21_3_18_18_18_18_18_18_3_3_3_3_4_4_4_4_4_4_4_4_4_4_4_4_4_4_4_4_4_4_18_18_4_4_4_4_4_3_3_4_4_4_5_5_6
5630,217,1330380000,16,25,6,1330380000,0,553200,557700,4500,16_16_16_16_16_16_16_16_8_8_16_16_16_16_16_16_16_16_16_8_8_16_8_8_2_2_8_2_8_5_5_2_16
5631,103,1330380000,6,7,6,1330383600,3600,4579020,4719960,140940,19_19_19_19_19_19_19_1_1_19_19_19_19_1_1_19_19_19_19_19_1_1_2_2_9_2_2_9_9_9_9_9_14_14_14_14_13_13_13_13_13_14_13_14_14_14_13_13_13_13_13_13_44_44_44_44_44_13_44_13_13_13_44_44_44_44_44_44_5_5_5_5_6
5632,169,1330380000,3,4,3,1330384500,4500,718260,2190660,1472400,50_50_50_50_50_50_50_50_50_50_50_50_50_50_50_50_50_1_1_50_50_50_50_1_1_50_50_50_50_50_50_50_50_1_1_50_3
5633,98,1330380000,6,7,6,1330383600,3600,4640580,7319880,2679300,34_34_2_2_35_35_34_34_2_2_3_3_3_3_3_3_18_18_3_3_3_18_3_3_3_18_18_18_18_3_3_18_18_18_18_18_18_18_18_3_3_18_39_3_3_39_3_3_3_3_4_4_5_5_5_5_5_5_4_4_4_5_3_5_5_3_5_4_4_4_5_5_5_5_6_6_6_6_5_5_5_5_5_5_5_5_5_5_5_5_6_6_5_5_34_34_6_6_5_5_5_5_5_5_5_5_5_5_5_5_2_2_5_18_5_18_18_18_6_6_5_5_5_5_5_5_6
5634,76,1330380000,3,4,3,1330384500,4500,4838400,7552500,2714100,3_3_3_3_3_3_3_3_3_18_3_18_18_18_18_18_3_3_3_1_1_3_17_17_17_18_17_17_18_18_18_18_18_17_17_18_3_3_18_17_18_18_17_18_18_17_17_17_5_5_5_5_1_1_17_17_17_2_2_17_17_17_5_5_5_5_5_5_17_17_5_5_5_17_5_5_5_5_5_17_17_17_1_1_1_1_1_1_1_1_2_2_34_34_5_5_5_5_6_6_3_3_4_3_3_4_4_4_4_4_3
5635,142,1330380000,6,7,6,1330383600,3600,4621560,7299960,2678400,0_0_0_0_0_0_0_1_1_0_0_0_0_0_0_0_0_1_1_0_0_0_0_0_0_1_1_0_0_0_0_0_0_1_1_0_0_0_0_0_0_0_1_0_1_0_0_0_1_1_1_1_27_27_27_27_1_27_27_1_27_27_27_27_27_27_27_27_27_27_27_27_27_27_27_27_2_2_2_2_2_2_3_3_3_2_2_3_3_3_2_2_3_3_4_4_15_4_15_4_4_4_4_4_4_4_4_4_4_4_4_4_4_4_4_4_4_4_4_4_4_4_4_4_4_4_4_4_4_4_4_4_15_15_15_15_15_15_5_5_6_6_15_15_5_5_6
5636,177,1330380000,6,7,6,1330383600,3600,1623060,1713060,90000,10_10_10_10_10_10_10_10_10_10_10_10_10_10_10_10_1_9_1_9_2_2_2_2_5_5_5_5_6
5637,103,1330383600,6,7,45,1330427940,44340,4582620,4719960,137340,19_19_19_19_19_19_19_1_1_19_19_19_19_1_1_19_19_19_19_19_1_1_2_2_9_2_2_9_9_9_9_9_14_14_14_14_13_13_13_13_13_14_13_14_14_14_13_13_13_13_13_13_44_44_44_44_44_13_44_13_13_13_44_44_44_44_44_44_5_5_5_5_6_6
5638,98,1330383600,6,7,34,1330863660,480060,4644180,7319880,2675700,34_34_2_2_35_35_34_34_2_2_3_3_3_3_3_3_18_18_3_3_3_18_3_3_3_18_18_18_18_3_3_18_18_18_18_18_18_18_18_3_3_18_39_3_3_39_3_3_3_3_4_4_5_5_5_5_5_5_4_4_4_5_3_5_5_3_5_4_4_4_5_5_5_5_6_6_6_6_5_5_5_5_5_5_5_5_5_5_5_5_6_6_5_5_34_34_6_6_5_5_5_5_5_5_5_5_5_5_5_5_2_2_5_18_5_18_18_18_6_6_5_5_5_5_5_5_6_6
5639,146,1330383600,6,7,5,1330412400,28800,4856400,6670800,1814400,16_16_16_16_16_16_16_1_16_1_16_1_1_16_1_16_16_2_1_1_16_1_2_16_2_2_3_3_3_3_21_21_3_3_3_3_3_21_3_21_3_3_3_3_21_3_21_3_18_18_18_18_18_18_3_3_3_3_4_4_4_4_4_4_4_4_4_4_4_4_4_4_4_4_4_4_18_18_4_4_4_4_4_3_3_4_4_4_5_5_6_6
5640,142,1330383600,6,7,5,1330409880,26280,4625160,7299960,2674800,0_0_0_0_0_0_0_1_1_0_0_0_0_0_0_0_0_1_1_0_0_0_0_0_0_1_1_0_0_0_0_0_0_1_1_0_0_0_0_0_0_0_1_0_1_0_0_0_1_1_1_1_27_27_27_27_1_27_27_1_27_27_27_27_27_27_27_27_27_27_27_27_27_27_27_27_2_2_2_2_2_2_3_3_3_2_2_3_3_3_2_2_3_3_4_4_15_4_15_4_4_4_4_4_4_4_4_4_4_4_4_4_4_4_4_4_4_4_4_4_4_4_4_4_4_4_4_4_4_4_4_4_15_15_15_15_15_15_5_5_6_6_15_15_5_5_6_6
5641,177,1330383600,6,7,6,1330466400,82800,1626660,1713060,86400,10_10_10_10_10_10_10_10_10_10_10_10_10_10_10_10_1_9_1_9_2_2_2_2_5_5_5_5_6_6
5642,63,1330383600,6,7,5,1330405200,21600,3532140,6232860,2700720,16_16_16_16_16_16_16_16_16_0_0_16_16_0_16_16_0_16_16_0_0_16_16_16_0_0_16_0_0_16_0_16_0_0_0_16_1_1_1_16_16_16_0_1_1_1_16_0_0_16_16_0_16_0_16_0_0_2_2_1_1_0_0_0_0_2_2_2_2_2_2_0_1_0_1_1_0_0_0_1_1_0_0_1_1_1_0_0_0_0_0_2_2_2_2_0_0_0_0_0_0_1_1_1_1_0_0_16_0_16_16_16_16_16_0_0_1_1_2_2_1_1_16_0_2_16_2_2_2_0_1_1_1_1_1_16_16_1_1_1_3_3_18_3_18_3_3_3_3_3_18_18_18_18_3_3_3_3_18_18_18_18_18_18_18_5_5_5_18_5_18_18_18_18_18_5_5_5_18_18_18_5_6_6
5643,217,1330383600,6,24,16,1330384500,900,556800,557700,900,16_16_16_16_16_16_16_16_8_8_16_16_16_16_16_16_16_16_16_8_8_16_8_8_2_2_8_2_8_5_5_2_16_6_6
5644,76,1330384500,3,4,3,1330409460,24960,4842900,7552500,2709600,3_3_3_3_3_3_3_3_3_18_3_18_18_18_18_18_3_3_3_1_1_3_17_17_17_18_17_17_18_18_18_18_18_17_17_18_3_3_18_17_18_18_17_18_18_17_17_17_5_5_5_5_1_1_17_17_17_2_2_17_17_17_5_5_5_5_5_5_17_17_5_5_5_17_5_5_5_5_5_17_17_17_1_1_1_1_1_1_1_1_2_2_34_34_5_5_5_5_6_6_3_3_4_3_3_4_4_4_4_4_3_3
5645,217,1330384500,16,25,99,1330384500,0,557700,557700,0,16_16_16_16_16_16_16_16_8_8_16_16_16_16_16_16_16_16_16_8_8_16_8_8_2_2_8_2_8_5_5_2_16_6_6_16
5646,169,1330384500,3,4,50,1330405800,21300,722760,2190660,1467900,50_50_50_50_50_50_50_50_50_50_50_50_50_50_50_50_50_1_1_50_50_50_50_1_1_50_50_50_50_50_50_50_50_1_1_50_3_3
5647,4,1330384980,10,13,10,1330419600,34620,31380,1326000,1294620,10_10_10_10
5648,89,1330394100,19,11,19,1330394160,60,592980,1736340,1143360,19_19_19_19
5649,89,1330394160,19,11,1,1330404780,10620,593040,1736340,1143300,19_19_19_19_19
5650,159,1330394220,16,11,16,1330404960,10740,41400,2480580,2439180,16_16_16
5651,220,1330402620,0,0,1,1330404840,2220,58260,2714040,2655780,0_0_0_0
5652,213,1330404180,4,22,4,1330405200,1020,1367760,3206820,1839060,0_0_0_0_0_1_0_1_0_0_0_0_0_0_0_0_1_1_0_0_0_0_0_0_0_1_1_0_0_0_0_0_0_0_0_0_0_0_0_0_0_1_1_1_0_1_0_0_0_0_0_0_0_0_0_0_1_0_1_0_0_0_0_0_0_0_0_0_0_0_0_0_0_0_0_0_0_0_0_1_1_0_0_0_0_0_0_0_0_0_0_0_0_0_1_1_0_0_2_2_3_3_4_3_3_4_2_2_4_4_4_4_4_4
5653,89,1330404780,1,9,19,1330404960,180,603660,1736340,1132680,19_19_19_19_19_1
5654,220,1330404840,1,9,0,1330405740,900,60480,2714040,2653560,0_0_0_0_1
5655,159,1330404960,16,11,16,1330405260,300,52140,2480580,2428440,16_16_16_16
5656,89,1330404960,19,11,1,1330409820,4860,603840,1736340,1132500,19_19_19_19_19_1_19
5657,57,1330405080,26,32,26,1330405500,420,137340,2756640,2619300,26_26_26_26_26_26_26_26_26_26_26_26_26_26_26_26_26_26
5658,213,1330405200,4,5,4,1330427880,22680,1368780,3206820,1838040,0_0_0_0_0_1_0_1_0_0_0_0_0_0_0_0_1_1_0_0_0_0_0_0_0_1_1_0_0_0_0_0_0_0_0_0_0_0_0_0_0_1_1_1_0_1_0_0_0_0_0_0_0_0_0_0_1_0_1_0_0_0_0_0_0_0_0_0_0_0_0_0_0_0_0_0_0_0_0_1_1_0_0_0_0_0_0_0_0_0_0_0_0_0_1_1_0_0_2_2_3_3_4_3_3_4_2_2_4_4_4_4_4_4_4
5659,63,1330405200,5,2,5,1330411200,6000,3553740,6232860,2679120,16_16_16_16_16_16_16_16_16_0_0_16_16_0_16_16_0_16_16_0_0_16_16_16_0_0_16_0_0_16_0_16_0_0_0_16_1_1_1_16_16_16_0_1_1_1_16_0_0_16_16_0_16_0_16_0_0_2_2_1_1_0_0_0_0_2_2_2_2_2_2_0_1_0_1_1_0_0_0_1_1_0_0_1_1_1_0_0_0_0_0_2_2_2_2_0_0_0_0_0_0_1_1_1_1_0_0_16_0_16_16_16_16_16_0_0_1_1_2_2_1_1_16_0_2_16_2_2_2_0_1_1_1_1_1_16_16_1_1_1_3_3_18_3_18_3_3_3_3_3_18_18_18_18_3_3_3_3_18_18_18_18_18_18_18_5_5_5_18_5_18_18_18_18_18_5_5_5_18_18_18_5_6_6_5
5660,159,1330405260,16,14,16,1330436880,31620,52440,2480580,2428140,16_16_16_16_16
5661,57,1330405500,26,33,26,1330436520,31020,137760,2756640,2618880,26_26_26_26_26_26_26_26_26_26_26_26_26_26_26_26_26_26_26
5662,220,1330405740,0,1,1,1330409820,4080,61380,2714040,2652660,0_0_0_0_1_0
5663,193,1330405740,5,18,5,1330411200,5460,74340,187200,112860,52_52_26_26_5
5664,169,1330405800,50,10,2,1330430880,25080,744060,2190660,1446600,50_50_50_50_50_50_50_50_50_50_50_50_50_50_50_50_50_1_1_50_50_50_50_1_1_50_50_50_50_50_50_50_50_1_1_50_3_3_50
5665,113,1330406460,5,6,5,1330413660,7200,3583200,3646740,63540,16_16_16_16_1_1_2_2_48_3_3_48_15_15_4_3_3_3_4_4_3_3_3_4_5_5_5
5666,76,1330409460,3,3,3,1330412700,3240,4867860,7552500,2684640,3_3_3_3_3_3_3_3_3_18_3_18_18_18_18_18_3_3_3_1_1_3_17_17_17_18_17_17_18_18_18_18_18_17_17_18_3_3_18_17_18_18_17_18_18_17_17_17_5_5_5_5_1_1_17_17_17_2_2_17_17_17_5_5_5_5_5_5_17_17_5_5_5_17_5_5_5_5_5_17_17_17_1_1_1_1_1_1_1_1_2_2_34_34_5_5_5_5_6_6_3_3_4_3_3_4_4_4_4_4_3_3_3
5667,220,1330409820,1,9,0,1330438140,28320,65460,2714040,2648580,0_0_0_0_1_0_1
5668,89,1330409820,1,9,19,1330419960,10140,608700,1736340,1127640,19_19_19_19_19_1_19_1
5669,142,1330409880,5,9,5,1330414800,4920,4651440,7299960,2648520,0_0_0_0_0_0_0_1_1_0_0_0_0_0_0_0_0_1_1_0_0_0_0_0_0_1_1_0_0_0_0_0_0_1_1_0_0_0_0_0_0_0_1_0_1_0_0_0_1_1_1_1_27_27_27_27_1_27_27_1_27_27_27_27_27_27_27_27_27_27_27_27_27_27_27_27_2_2_2_2_2_2_3_3_3_2_2_3_3_3_2_2_3_3_4_4_15_4_15_4_4_4_4_4_4_4_4_4_4_4_4_4_4_4_4_4_4_4_4_4_4_4_4_4_4_4_4_4_4_4_4_4_15_15_15_15_15_15_5_5_6_6_15_15_5_5_6_6_5
5670,63,1330411200,5,2,5,1330412400,1200,3559740,6232860,2673120,16_16_16_16_16_16_16_16_16_0_0_16_16_0_16_16_0_16_16_0_0_16_16_16_0_0_16_0_0_16_0_16_0_0_0_16_1_1_1_16_16_16_0_1_1_1_16_0_0_16_16_0_16_0_16_0_0_2_2_1_1_0_0_0_0_2_2_2_2_2_2_0_1_0_1_1_0_0_0_1_1_0_0_1_1_1_0_0_0_0_0_2_2_2_2_0_0_0_0_0_0_1_1_1_1_0_0_16_0_16_16_16_16_16_0_0_1_1_2_2_1_1_16_0_2_16_2_2_2_0_1_1_1_1_1_16_16_1_1_1_3_3_18_3_18_3_3_3_3_3_18_18_18_18_3_3_3_3_18_18_18_18_18_18_18_5_5_5_18_5_18_18_18_18_18_5_5_5_18_18_18_5_6_6_5_5
5671,193,1330411200,5,18,6,1330466400,55200,79800,187200,107400,52_52_26_26_5_5
5672,63,1330412400,5,2,5,1330422600,10200,3560940,6232860,2671920,16_16_16_16_16_16_16_16_16_0_0_16_16_0_16_16_0_16_16_0_0_16_16_16_0_0_16_0_0_16_0_16_0_0_0_16_1_1_1_16_16_16_0_1_1_1_16_0_0_16_16_0_16_0_16_0_0_2_2_1_1_0_0_0_0_2_2_2_2_2_2_0_1_0_1_1_0_0_0_1_1_0_0_1_1_1_0_0_0_0_0_2_2_2_2_0_0_0_0_0_0_1_1_1_1_0_0_16_0_16_16_16_16_16_0_0_1_1_2_2_1_1_16_0_2_16_2_2_2_0_1_1_1_1_1_16_16_1_1_1_3_3_18_3_18_3_3_3_3_3_18_18_18_18_3_3_3_3_18_18_18_18_18_18_18_5_5_5_18_5_18_18_18_18_18_5_5_5_18_18_18_5_6_6_5_5_5
5673,146,1330412400,5,6,5,1330429260,16860,4885200,6670800,1785600,16_16_16_16_16_16_16_1_16_1_16_1_1_16_1_16_16_2_1_1_16_1_2_16_2_2_3_3_3_3_21_21_3_3_3_3_3_21_3_21_3_3_3_3_21_3_21_3_18_18_18_18_18_18_3_3_3_3_4_4_4_4_4_4_4_4_4_4_4_4_4_4_4_4_4_4_18_18_4_4_4_4_4_3_3_4_4_4_5_5_6_6_5
5674,196,1330412400,1,18,1,1330428000,15600,611700,3281700,2670000,7_7_7_7_7_7_7_7_7_7_7_7_7_7_7_7_7_7_7_7_1_1_1_1_7_7_1_1_7_7_1
5675,76,1330412700,3,4,3,1330421400,8700,4871100,7552500,2681400,3_3_3_3_3_3_3_3_3_18_3_18_18_18_18_18_3_3_3_1_1_3_17_17_17_18_17_17_18_18_18_18_18_17_17_18_3_3_18_17_18_18_17_18_18_17_17_17_5_5_5_5_1_1_17_17_17_2_2_17_17_17_5_5_5_5_5_5_17_17_5_5_5_17_5_5_5_5_5_17_17_17_1_1_1_1_1_1_1_1_2_2_34_34_5_5_5_5_6_6_3_3_4_3_3_4_4_4_4_4_3_3_3_3
5676,113,1330413660,5,6,6,1330466400,52740,3590400,3646740,56340,16_16_16_16_1_1_2_2_48_3_3_48_15_15_4_3_3_3_4_4_3_3_3_4_5_5_5_5
5677,134,1330413660,5,6,5,1330429200,15540,3600240,3656580,56340,0_0_0_0_0_0_0_0_0_0_1_1_2_2_3_3_13_13_13_13_13_13_13_13_15_15_3_3_4_4_4_4_4_4_5_5_5
5678,142,1330414800,5,9,15,1330414860,60,4656360,7299960,2643600,0_0_0_0_0_0_0_1_1_0_0_0_0_0_0_0_0_1_1_0_0_0_0_0_0_1_1_0_0_0_0_0_0_1_1_0_0_0_0_0_0_0_1_0_1_0_0_0_1_1_1_1_27_27_27_27_1_27_27_1_27_27_27_27_27_27_27_27_27_27_27_27_27_27_27_27_2_2_2_2_2_2_3_3_3_2_2_3_3_3_2_2_3_3_4_4_15_4_15_4_4_4_4_4_4_4_4_4_4_4_4_4_4_4_4_4_4_4_4_4_4_4_4_4_4_4_4_4_4_4_4_4_15_15_15_15_15_15_5_5_6_6_15_15_5_5_6_6_5_5
5679,142,1330414860,5,9,5,1330414920,60,4656420,7299960,2643540,0_0_0_0_0_0_0_1_1_0_0_0_0_0_0_0_0_1_1_0_0_0_0_0_0_1_1_0_0_0_0_0_0_1_1_0_0_0_0_0_0_0_1_0_1_0_0_0_1_1_1_1_27_27_27_27_1_27_27_1_27_27_27_27_27_27_27_27_27_27_27_27_27_27_27_27_2_2_2_2_2_2_3_3_3_2_2_3_3_3_2_2_3_3_4_4_15_4_15_4_4_4_4_4_4_4_4_4_4_4_4_4_4_4_4_4_4_4_4_4_4_4_4_4_4_4_4_4_4_4_4_4_15_15_15_15_15_15_5_5_6_6_15_15_5_5_6_6_5_5_15_5
5680,142,1330414860,15,9,5,1330414860,0,4656420,7299960,2643540,0_0_0_0_0_0_0_1_1_0_0_0_0_0_0_0_0_1_1_0_0_0_0_0_0_1_1_0_0_0_0_0_0_1_1_0_0_0_0_0_0_0_1_0_1_0_0_0_1_1_1_1_27_27_27_27_1_27_27_1_27_27_27_27_27_27_27_27_27_27_27_27_27_27_27_27_2_2_2_2_2_2_3_3_3_2_2_3_3_3_2_2_3_3_4_4_15_4_15_4_4_4_4_4_4_4_4_4_4_4_4_4_4_4_4_4_4_4_4_4_4_4_4_4_4_4_4_4_4_4_4_4_15_15_15_15_15_15_5_5_6_6_15_15_5_5_6_6_5_5_15
5681,142,1330414920,5,9,15,1330414980,60,4656480,7299960,2643480,0_0_0_0_0_0_0_1_1_0_0_0_0_0_0_0_0_1_1_0_0_0_0_0_0_1_1_0_0_0_0_0_0_1_1_0_0_0_0_0_0_0_1_0_1_0_0_0_1_1_1_1_27_27_27_27_1_27_27_1_27_27_27_27_27_27_27_27_27_27_27_27_27_27_27_27_2_2_2_2_2_2_3_3_3_2_2_3_3_3_2_2_3_3_4_4_15_4_15_4_4_4_4_4_4_4_4_4_4_4_4_4_4_4_4_4_4_4_4_4_4_4_4_4_4_4_4_4_4_4_4_4_15_15_15_15_15_15_5_5_6_6_15_15_5_5_6_6_5_5_15_5_5
5682,142,1330414980,5,9,5,1330422180,7200,4656540,7299960,2643420,0_0_0_0_0_0_0_1_1_0_0_0_0_0_0_0_0_1_1_0_0_0_0_0_0_1_1_0_0_0_0_0_0_1_1_0_0_0_0_0_0_0_1_0_1_0_0_0_1_1_1_1_27_27_27_27_1_27_27_1_27_27_27_27_27_27_27_27_27_27_27_27_27_27_27_27_2_2_2_2_2_2_3_3_3_2_2_3_3_3_2_2_3_3_4_4_15_4_15_4_4_4_4_4_4_4_4_4_4_4_4_4_4_4_4_4_4_4_4_4_4_4_4_4_4_4_4_4_4_4_4_4_15_15_15_15_15_15_5_5_6_6_15_15_5_5_6_6_5_5_15_5_5_15_5
5683,142,1330414980,15,9,5,1330414980,0,4656540,7299960,2643420,0_0_0_0_0_0_0_1_1_0_0_0_0_0_0_0_0_1_1_0_0_0_0_0_0_1_1_0_0_0_0_0_0_1_1_0_0_0_0_0_0_0_1_0_1_0_0_0_1_1_1_1_27_27_27_27_1_27_27_1_27_27_27_27_27_27_27_27_27_27_27_27_27_27_27_27_2_2_2_2_2_2_3_3_3_2_2_3_3_3_2_2_3_3_4_4_15_4_15_4_4_4_4_4_4_4_4_4_4_4_4_4_4_4_4_4_4_4_4_4_4_4_4_4_4_4_4_4_4_4_4_4_15_15_15_15_15_15_5_5_6_6_15_15_5_5_6_6_5_5_15_5_5_15
5684,216,1330415520,8,9,8,1330436160,20640,442020,496500,54480,19_19_19_19_19_19_19_19_19_19_19_19_19_19_19_19_19_19_19_19_19_19_8
5685,4,1330419600,10,16,10,1330428360,8760,66000,1326000,1260000,10_10_10_10_10
5686,89,1330419960,19,14,19,1330444020,24060,618840,1736340,1117500,19_19_19_19_19_1_19_1_19
5687,76,1330421400,3,4,3,1330431000,9600,4879800,7552500,2672700,3_3_3_3_3_3_3_3_3_18_3_18_18_18_18_18_3_3_3_1_1_3_17_17_17_18_17_17_18_18_18_18_18_17_17_18_3_3_18_17_18_18_17_18_18_17_17_17_5_5_5_5_1_1_17_17_17_2_2_17_17_17_5_5_5_5_5_5_17_17_5_5_5_17_5_5_5_5_5_17_17_17_1_1_1_1_1_1_1_1_2_2_34_34_5_5_5_5_6_6_3_3_4_3_3_4_4_4_4_4_3_3_3_3_3
5688,142,1330422180,5,9,15,1330422240,60,4663740,7299960,2636220,0_0_0_0_0_0_0_1_1_0_0_0_0_0_0_0_0_1_1_0_0_0_0_0_0_1_1_0_0_0_0_0_0_1_1_0_0_0_0_0_0_0_1_0_1_0_0_0_1_1_1_1_27_27_27_27_1_27_27_1_27_27_27_27_27_27_27_27_27_27_27_27_27_27_27_27_2_2_2_2_2_2_3_3_3_2_2_3_3_3_2_2_3_3_4_4_15_4_15_4_4_4_4_4_4_4_4_4_4_4_4_4_4_4_4_4_4_4_4_4_4_4_4_4_4_4_4_4_4_4_4_4_15_15_15_15_15_15_5_5_6_6_15_15_5_5_6_6_5_5_15_5_5_15_5_5
5689,142,1330422240,15,9,18,1330423560,1320,4663800,7299960,2636160,0_0_0_0_0_0_0_1_1_0_0_0_0_0_0_0_0_1_1_0_0_0_0_0_0_1_1_0_0_0_0_0_0_1_1_0_0_0_0_0_0_0_1_0_1_0_0_0_1_1_1_1_27_27_27_27_1_27_27_1_27_27_27_27_27_27_27_27_27_27_27_27_27_27_27_27_2_2_2_2_2_2_3_3_3_2_2_3_3_3_2_2_3_3_4_4_15_4_15_4_4_4_4_4_4_4_4_4_4_4_4_4_4_4_4_4_4_4_4_4_4_4_4_4_4_4_4_4_4_4_4_4_15_15_15_15_15_15_5_5_6_6_15_15_5_5_6_6_5_5_15_5_5_15_5_5_15
5690,63,1330422600,5,2,3,1330424880,2280,3571140,6232860,2661720,16_16_16_16_16_16_16_16_16_0_0_16_16_0_16_16_0_16_16_0_0_16_16_16_0_0_16_0_0_16_0_16_0_0_0_16_1_1_1_16_16_16_0_1_1_1_16_0_0_16_16_0_16_0_16_0_0_2_2_1_1_0_0_0_0_2_2_2_2_2_2_0_1_0_1_1_0_0_0_1_1_0_0_1_1_1_0_0_0_0_0_2_2_2_2_0_0_0_0_0_0_1_1_1_1_0_0_16_0_16_16_16_16_16_0_0_1_1_2_2_1_1_16_0_2_16_2_2_2_0_1_1_1_1_1_16_16_1_1_1_3_3_18_3_18_3_3_3_3_3_18_18_18_18_3_3_3_3_18_18_18_18_18_18_18_5_5_5_18_5_18_18_18_18_18_5_5_5_18_18_18_5_6_6_5_5_5_5
5691,142,1330423560,18,9,15,1330423680,120,4665120,7299960,2634840,0_0_0_0_0_0_0_1_1_0_0_0_0_0_0_0_0_1_1_0_0_0_0_0_0_1_1_0_0_0_0_0_0_1_1_0_0_0_0_0_0_0_1_0_1_0_0_0_1_1_1_1_27_27_27_27_1_27_27_1_27_27_27_27_27_27_27_27_27_27_27_27_27_27_27_27_2_2_2_2_2_2_3_3_3_2_2_3_3_3_2_2_3_3_4_4_15_4_15_4_4_4_4_4_4_4_4_4_4_4_4_4_4_4_4_4_4_4_4_4_4_4_4_4_4_4_4_4_4_4_4_4_15_15_15_15_15_15_5_5_6_6_15_15_5_5_6_6_5_5_15_5_5_15_5_5_15_18
5692,142,1330423680,15,9,18,1330423860,180,4665240,7299960,2634720,0_0_0_0_0_0_0_1_1_0_0_0_0_0_0_0_0_1_1_0_0_0_0_0_0_1_1_0_0_0_0_0_0_1_1_0_0_0_0_0_0_0_1_0_1_0_0_0_1_1_1_1_27_27_27_27_1_27_27_1_27_27_27_27_27_27_27_27_27_27_27_27_27_27_27_27_2_2_2_2_2_2_3_3_3_2_2_3_3_3_2_2_3_3_4_4_15_4_15_4_4_4_4_4_4_4_4_4_4_4_4_4_4_4_4_4_4_4_4_4_4_4_4_4_4_4_4_4_4_4_4_4_15_15_15_15_15_15_5_5_6_6_15_15_5_5_6_6_5_5_15_5_5_15_5_5_15_18_15
5693,142,1330423860,18,9,4,1332892800,2468940,4665420,7299960,2634540,0_0_0_0_0_0_0_1_1_0_0_0_0_0_0_0_0_1_1_0_0_0_0_0_0_1_1_0_0_0_0_0_0_1_1_0_0_0_0_0_0_0_1_0_1_0_0_0_1_1_1_1_27_27_27_27_1_27_27_1_27_27_27_27_27_27_27_27_27_27_27_27_27_27_27_27_2_2_2_2_2_2_3_3_3_2_2_3_3_3_2_2_3_3_4_4_15_4_15_4_4_4_4_4_4_4_4_4_4_4_4_4_4_4_4_4_4_4_4_4_4_4_4_4_4_4_4_4_4_4_4_4_15_15_15_15_15_15_5_5_6_6_15_15_5_5_6_6_5_5_15_5_5_15_5_5_15_18_15_18
5694,63,1330424880,3,4,5,1330428000,3120,3573420,6232860,2659440,16_16_16_16_16_16_16_16_16_0_0_16_16_0_16_16_0_16_16_0_0_16_16_16_0_0_16_0_0_16_0_16_0_0_0_16_1_1_1_16_16_16_0_1_1_1_16_0_0_16_16_0_16_0_16_0_0_2_2_1_1_0_0_0_0_2_2_2_2_2_2_0_1_0_1_1_0_0_0_1_1_0_0_1_1_1_0_0_0_0_0_2_2_2_2_0_0_0_0_0_0_1_1_1_1_0_0_16_0_16_16_16_16_16_0_0_1_1_2_2_1_1_16_0_2_16_2_2_2_0_1_1_1_1_1_16_16_1_1_1_3_3_18_3_18_3_3_3_3_3_18_18_18_18_3_3_3_3_18_18_18_18_18_18_18_5_5_5_18_5_18_18_18_18_18_5_5_5_18_18_18_5_6_6_5_5_5_5_3
5695,213,1330427880,4,5,5,1330436220,8340,1391460,3206820,1815360,0_0_0_0_0_1_0_1_0_0_0_0_0_0_0_0_1_1_0_0_0_0_0_0_0_1_1_0_0_0_0_0_0_0_0_0_0_0_0_0_0_1_1_1_0_1_0_0_0_0_0_0_0_0_0_0_1_0_1_0_0_0_0_0_0_0_0_0_0_0_0_0_0_0_0_0_0_0_0_1_1_0_0_0_0_0_0_0_0_0_0_0_0_0_1_1_0_0_2_2_3_3_4_3_3_4_2_2_4_4_4_4_4_4_4_4
5696,103,1330427940,45,5,45,1330429080,1140,4626960,4719960,93000,19_19_19_19_19_19_19_1_1_19_19_19_19_1_1_19_19_19_19_19_1_1_2_2_9_2_2_9_9_9_9_9_14_14_14_14_13_13_13_13_13_14_13_14_14_14_13_13_13_13_13_13_44_44_44_44_44_13_44_13_13_13_44_44_44_44_44_44_5_5_5_5_6_6_45
5697,196,1330428000,1,18,7,1330438380,10380,627300,3281700,2654400,7_7_7_7_7_7_7_7_7_7_7_7_7_7_7_7_7_7_7_7_1_1_1_1_7_7_1_1_7_7_1_1
5698,63,1330428000,5,2,18,1330429680,1680,3576540,6232860,2656320,16_16_16_16_16_16_16_16_16_0_0_16_16_0_16_16_0_16_16_0_0_16_16_16_0_0_16_0_0_16_0_16_0_0_0_16_1_1_1_16_16_16_0_1_1_1_16_0_0_16_16_0_16_0_16_0_0_2_2_1_1_0_0_0_0_2_2_2_2_2_2_0_1_0_1_1_0_0_0_1_1_0_0_1_1_1_0_0_0_0_0_2_2_2_2_0_0_0_0_0_0_1_1_1_1_0_0_16_0_16_16_16_16_16_0_0_1_1_2_2_1_1_16_0_2_16_2_2_2_0_1_1_1_1_1_16_16_1_1_1_3_3_18_3_18_3_3_3_3_3_18_18_18_18_3_3_3_3_18_18_18_18_18_18_18_5_5_5_18_5_18_18_18_18_18_5_5_5_18_18_18_5_6_6_5_5_5_5_3_5
5699,10,1330428000,1,18,1,1330431840,3840,129720,979740,850020,0_0_0_1_1_0_0_0_1
5700,4,1330428360,10,16,10,1330431600,3240,74760,1326000,1251240,10_10_10_10_10_10
5701,103,1330429080,45,5,45,1330429080,0,4628100,4719960,91860,19_19_19_19_19_19_19_1_1_19_19_19_19_1_1_19_19_19_19_19_1_1_2_2_9_2_2_9_9_9_9_9_14_14_14_14_13_13_13_13_13_14_13_14_14_14_13_13_13_13_13_13_44_44_44_44_44_13_44_13_13_13_44_44_44_44_44_44_5_5_5_5_6_6_45_45
5702,103,1330429080,45,5,45,1330437180,8100,4628100,4719960,91860,19_19_19_19_19_19_19_1_1_19_19_19_19_1_1_19_19_19_19_19_1_1_2_2_9_2_2_9_9_9_9_9_14_14_14_14_13_13_13_13_13_14_13_14_14_14_13_13_13_13_13_13_44_44_44_44_44_13_44_13_13_13_44_44_44_44_44_44_5_5_5_5_6_6_45_45_45
5703,134,1330429200,5,6,5,1330437960,8760,3615780,3656580,40800,0_0_0_0_0_0_0_0_0_0_1_1_2_2_3_3_13_13_13_13_13_13_13_13_15_15_3_3_4_4_4_4_4_4_5_5_5_5
5704,146,1330429260,5,6,6,1330898400,469140,4902060,6670800,1768740,16_16_16_16_16_16_16_1_16_1_16_1_1_16_1_16_16_2_1_1_16_1_2_16_2_2_3_3_3_3_21_21_3_3_3_3_3_21_3_21_3_3_3_3_21_3_21_3_18_18_18_18_18_18_3_3_3_3_4_4_4_4_4_4_4_4_4_4_4_4_4_4_4_4_4_4_18_18_4_4_4_4_4_3_3_4_4_4_5_5_6_6_5_5
5705,63,1330429680,18,19,3,1330430880,1200,3578220,6232860,2654640,16_16_16_16_16_16_16_16_16_0_0_16_16_0_16_16_0_16_16_0_0_16_16_16_0_0_16_0_0_16_0_16_0_0_0_16_1_1_1_16_16_16_0_1_1_1_16_0_0_16_16_0_16_0_16_0_0_2_2_1_1_0_0_0_0_2_2_2_2_2_2_0_1_0_1_1_0_0_0_1_1_0_0_1_1_1_0_0_0_0_0_2_2_2_2_0_0_0_0_0_0_1_1_1_1_0_0_16_0_16_16_16_16_16_0_0_1_1_2_2_1_1_16_0_2_16_2_2_2_0_1_1_1_1_1_16_16_1_1_1_3_3_18_3_18_3_3_3_3_3_18_18_18_18_3_3_3_3_18_18_18_18_18_18_18_5_5_5_18_5_18_18_18_18_18_5_5_5_18_18_18_5_6_6_5_5_5_5_3_5_18
5706,63,1330430880,3,4,3,1330431060,180,3579420,6232860,2653440,16_16_16_16_16_16_16_16_16_0_0_16_16_0_16_16_0_16_16_0_0_16_16_16_0_0_16_0_0_16_0_16_0_0_0_16_1_1_1_16_16_16_0_1_1_1_16_0_0_16_16_0_16_0_16_0_0_2_2_1_1_0_0_0_0_2_2_2_2_2_2_0_1_0_1_1_0_0_0_1_1_0_0_1_1_1_0_0_0_0_0_2_2_2_2_0_0_0_0_0_0_1_1_1_1_0_0_16_0_16_16_16_16_16_0_0_1_1_2_2_1_1_16_0_2_16_2_2_2_0_1_1_1_1_1_16_16_1_1_1_3_3_18_3_18_3_3_3_3_3_18_18_18_18_3_3_3_3_18_18_18_18_18_18_18_5_5_5_18_5_18_18_18_18_18_5_5_5_18_18_18_5_6_6_5_5_5_5_3_5_18_3
5707,169,1330430880,2,4,50,1330432260,1380,769140,2190660,1421520,50_50_50_50_50_50_50_50_50_50_50_50_50_50_50_50_50_1_1_50_50_50_50_1_1_50_50_50_50_50_50_50_50_1_1_50_3_3_50_2
5708,76,1330431000,3,3,4,1330459920,28920,4889400,7552500,2663100,3_3_3_3_3_3_3_3_3_18_3_18_18_18_18_18_3_3_3_1_1_3_17_17_17_18_17_17_18_18_18_18_18_17_17_18_3_3_18_17_18_18_17_18_18_17_17_17_5_5_5_5_1_1_17_17_17_2_2_17_17_17_5_5_5_5_5_5_17_17_5_5_5_17_5_5_5_5_5_17_17_17_1_1_1_1_1_1_1_1_2_2_34_34_5_5_5_5_6_6_3_3_4_3_3_4_4_4_4_4_3_3_3_3_3_3
5709,63,1330431060,3,3,3,1330435560,4500,3579600,6232860,2653260,16_16_16_16_16_16_16_16_16_0_0_16_16_0_16_16_0_16_16_0_0_16_16_16_0_0_16_0_0_16_0_16_0_0_0_16_1_1_1_16_16_16_0_1_1_1_16_0_0_16_16_0_16_0_16_0_0_2_2_1_1_0_0_0_0_2_2_2_2_2_2_0_1_0_1_1_0_0_0_1_1_0_0_1_1_1_0_0_0_0_0_2_2_2_2_0_0_0_0_0_0_1_1_1_1_0_0_16_0_16_16_16_16_16_0_0_1_1_2_2_1_1_16_0_2_16_2_2_2_0_1_1_1_1_1_16_16_1_1_1_3_3_18_3_18_3_3_3_3_3_18_18_18_18_3_3_3_3_18_18_18_18_18_18_18_5_5_5_18_5_18_18_18_18_18_5_5_5_18_18_18_5_6_6_5_5_5_5_3_5_18_3_3
5710,4,1330431600,10,16,1,1330432500,900,78000,1326000,1248000,10_10_10_10_10_10_10
5711,10,1330431840,1,18,2,1330444320,12480,133560,979740,846180,0_0_0_1_1_0_0_0_1_1
5712,169,1330432260,50,18,2,1330435380,3120,770520,2190660,1420140,50_50_50_50_50_50_50_50_50_50_50_50_50_50_50_50_50_1_1_50_50_50_50_1_1_50_50_50_50_50_50_50_50_1_1_50_3_3_50_2_50
5713,4,1330432500,1,18,1,1330435500,3000,78900,1326000,1247100,10_10_10_10_10_10_10_1
5714,169,1330435380,2,4,50,1330436760,1380,773640,2190660,1417020,50_50_50_50_50_50_50_50_50_50_50_50_50_50_50_50_50_1_1_50_50_50_50_1_1_50_50_50_50_50_50_50_50_1_1_50_3_3_50_2_50_2
5715,4,1330435500,1,18,10,1330438320,2820,81900,1326000,1244100,10_10_10_10_10_10_10_1_1
5716,63,1330435560,3,3,18,1330439940,4380,3584100,6232860,2648760,16_16_16_16_16_16_16_16_16_0_0_16_16_0_16_16_0_16_16_0_0_16_16_16_0_0_16_0_0_16_0_16_0_0_0_16_1_1_1_16_16_16_0_1_1_1_16_0_0_16_16_0_16_0_16_0_0_2_2_1_1_0_0_0_0_2_2_2_2_2_2_0_1_0_1_1_0_0_0_1_1_0_0_1_1_1_0_0_0_0_0_2_2_2_2_0_0_0_0_0_0_1_1_1_1_0_0_16_0_16_16_16_16_16_0_0_1_1_2_2_1_1_16_0_2_16_2_2_2_0_1_1_1_1_1_16_16_1_1_1_3_3_18_3_18_3_3_3_3_3_18_18_18_18_3_3_3_3_18_18_18_18_18_18_18_5_5_5_18_5_18_18_18_18_18_5_5_5_18_18_18_5_6_6_5_5_5_5_3_5_18_3_3_3
5717,216,1330436160,8,9,8,1330436220,60,462660,496500,33840,19_19_19_19_19_19_19_19_19_19_19_19_19_19_19_19_19_19_19_19_19_19_8_8
5718,213,1330436220,5,9,2,1330437060,840,1399800,3206820,1807020,0_0_0_0_0_1_0_1_0_0_0_0_0_0_0_0_1_1_0_0_0_0_0_0_0_1_1_0_0_0_0_0_0_0_0_0_0_0_0_0_0_1_1_1_0_1_0_0_0_0_0_0_0_0_0_0_1_0_1_0_0_0_0_0_0_0_0_0_0_0_0_0_0_0_0_0_0_0_0_1_1_0_0_0_0_0_0_0_0_0_0_0_0_0_1_1_0_0_2_2_3_3_4_3_3_4_2_2_4_4_4_4_4_4_4_4_5
5719,216,1330436220,8,9,2,1330437180,960,462720,496500,33780,19_19_19_19_19_19_19_19_19_19_19_19_19_19_19_19_19_19_19_19_19_19_8_8_8
5720,57,1330436520,26,33,26,1330439520,3000,168780,2756640,2587860,26_26_26_26_26_26_26_26_26_26_26_26_26_26_26_26_26_26_26_26
5721,19,1330436700,14,17,14,1330441560,4860,550500,608940,58440,14_14_14_14_14_14_6_6_14_5_5_14_14_14_14_14_14_14_14
5722,169,1330436760,50,18,50,1330443600,6840,775020,2190660,1415640,50_50_50_50_50_50_50_50_50_50_50_50_50_50_50_50_50_1_1_50_50_50_50_1_1_50_50_50_50_50_50_50_50_1_1_50_3_3_50_2_50_2_50
5723,159,1330436880,16,20,16,1330438200,1320,84060,2480580,2396520,16_16_16_16_16_16
5724,213,1330437060,2,3,3,1330437120,60,1400640,3206820,1806180,0_0_0_0_0_1_0_1_0_0_0_0_0_0_0_0_1_1_0_0_0_0_0_0_0_1_1_0_0_0_0_0_0_0_0_0_0_0_0_0_0_1_1_1_0_1_0_0_0_0_0_0_0_0_0_0_1_0_1_0_0_0_0_0_0_0_0_0_0_0_0_0_0_0_0_0_0_0_0_1_1_0_0_0_0_0_0_0_0_0_0_0_0_0_1_1_0_0_2_2_3_3_4_3_3_4_2_2_4_4_4_4_4_4_4_4_5_2
5725,213,1330437120,3,3,4,1330437240,120,1400700,3206820,1806120,0_0_0_0_0_1_0_1_0_0_0_0_0_0_0_0_1_1_0_0_0_0_0_0_0_1_1_0_0_0_0_0_0_0_0_0_0_0_0_0_0_1_1_1_0_1_0_0_0_0_0_0_0_0_0_0_1_0_1_0_0_0_0_0_0_0_0_0_0_0_0_0_0_0_0_0_0_0_0_1_1_0_0_0_0_0_0_0_0_0_0_0_0_0_1_1_0_0_2_2_3_3_4_3_3_4_2_2_4_4_4_4_4_4_4_4_5_2_3
5726,103,1330437180,45,5,5,1330440300,3120,4636200,4719960,83760,19_19_19_19_19_19_19_1_1_19_19_19_19_1_1_19_19_19_19_19_1_1_2_2_9_2_2_9_9_9_9_9_14_14_14_14_13_13_13_13_13_14_13_14_14_14_13_13_13_13_13_13_44_44_44_44_44_13_44_13_13_13_44_44_44_44_44_44_5_5_5_5_6_6_45_45_45_45
5727,216,1330437180,2,3,2,1330439100,1920,463680,496500,32820,19_19_19_19_19_19_19_19_19_19_19_19_19_19_19_19_19_19_19_19_19_19_8_8_8_2
5728,213,1330437240,4,5,5,1330437900,660,1400820,3206820,1806000,0_0_0_0_0_1_0_1_0_0_0_0_0_0_0_0_1_1_0_0_0_0_0_0_0_1_1_0_0_0_0_0_0_0_0_0_0_0_0_0_0_1_1_1_0_1_0_0_0_0_0_0_0_0_0_0_1_0_1_0_0_0_0_0_0_0_0_0_0_0_0_0_0_0_0_0_0_0_0_1_1_0_0_0_0_0_0_0_0_0_0_0_0_0_1_1_0_0_2_2_3_3_4_3_3_4_2_2_4_4_4_4_4_4_4_4_5_2_3_4
5729,213,1330437900,5,9,2,1330441560,3660,1401480,3206820,1805340,0_0_0_0_0_1_0_1_0_0_0_0_0_0_0_0_1_1_0_0_0_0_0_0_0_1_1_0_0_0_0_0_0_0_0_0_0_0_0_0_0_1_1_1_0_1_0_0_0_0_0_0_0_0_0_0_1_0_1_0_0_0_0_0_0_0_0_0_0_0_0_0_0_0_0_0_0_0_0_1_1_0_0_0_0_0_0_0_0_0_0_0_0_0_1_1_0_0_2_2_3_3_4_3_3_4_2_2_4_4_4_4_4_4_4_4_5_2_3_4_5
5730,134,1330437960,5,6,5,1330438020,60,3624540,3656580,32040,0_0_0_0_0_0_0_0_0_0_1_1_2_2_3_3_13_13_13_13_13_13_13_13_15_15_3_3_4_4_4_4_4_4_5_5_5_5_5
5731,134,1330438020,5,6,6,1330466400,28380,3624600,3656580,31980,0_0_0_0_0_0_0_0_0_0_1_1_2_2_3_3_13_13_13_13_13_13_13_13_15_15_3_3_4_4_4_4_4_4_5_5_5_5_5_5
5732,220,1330438140,0,1,0,1330438260,120,93780,2714040,2620260,0_0_0_0_1_0_1_0
5733,159,1330438200,16,14,16,1330465200,27000,85380,2480580,2395200,16_16_16_16_16_16_16
5734,220,1330438260,0,14,0,1330444020,5760,93900,2714040,2620140,0_0_0_0_1_0_1_0_0
5735,4,1330438320,10,16,10,1330438320,0,84720,1326000,1241280,10_10_10_10_10_10_10_1_1_10
5736,4,1330438320,10,16,10,1330444560,6240,84720,1326000,1241280,10_10_10_10_10_10_10_1_1_10_10
5737,196,1330438380,7,8,7,1330465140,26760,637680,3281700,2644020,7_7_7_7_7_7_7_7_7_7_7_7_7_7_7_7_7_7_7_7_1_1_1_1_7_7_1_1_7_7_1_1_7
5738,216,1330439100,2,3,5,1330439280,180,465600,496500,30900,19_19_19_19_19_19_19_19_19_19_19_19_19_19_19_19_19_19_19_19_19_19_8_8_8_2_2
5739,216,1330439280,5,9,5,1330440120,840,465780,496500,30720,19_19_19_19_19_19_19_19_19_19_19_19_19_19_19_19_19_19_19_19_19_19_8_8_8_2_2_5
5740,57,1330439520,26,13,26,1330449720,10200,171780,2756640,2584860,26_26_26_26_26_26_26_26_26_26_26_26_26_26_26_26_26_26_26_26_26
5741,63,1330439940,18,19,16,1330440000,60,3588480,6232860,2644380,16_16_16_16_16_16_16_16_16_0_0_16_16_0_16_16_0_16_16_0_0_16_16_16_0_0_16_0_0_16_0_16_0_0_0_16_1_1_1_16_16_16_0_1_1_1_16_0_0_16_16_0_16_0_16_0_0_2_2_1_1_0_0_0_0_2_2_2_2_2_2_0_1_0_1_1_0_0_0_1_1_0_0_1_1_1_0_0_0_0_0_2_2_2_2_0_0_0_0_0_0_1_1_1_1_0_0_16_0_16_16_16_16_16_0_0_1_1_2_2_1_1_16_0_2_16_2_2_2_0_1_1_1_1_1_16_16_1_1_1_3_3_18_3_18_3_3_3_3_3_18_18_18_18_3_3_3_3_18_18_18_18_18_18_18_5_5_5_18_5_18_18_18_18_18_5_5_5_18_18_18_5_6_6_5_5_5_5_3_5_18_3_3_3_18
5742,63,1330440000,16,19,18,1330440060,60,3588540,6232860,2644320,16_16_16_16_16_16_16_16_16_0_0_16_16_0_16_16_0_16_16_0_0_16_16_16_0_0_16_0_0_16_0_16_0_0_0_16_1_1_1_16_16_16_0_1_1_1_16_0_0_16_16_0_16_0_16_0_0_2_2_1_1_0_0_0_0_2_2_2_2_2_2_0_1_0_1_1_0_0_0_1_1_0_0_1_1_1_0_0_0_0_0_2_2_2_2_0_0_0_0_0_0_1_1_1_1_0_0_16_0_16_16_16_16_16_0_0_1_1_2_2_1_1_16_0_2_16_2_2_2_0_1_1_1_1_1_16_16_1_1_1_3_3_18_3_18_3_3_3_3_3_18_18_18_18_3_3_3_3_18_18_18_18_18_18_18_5_5_5_18_5_18_18_18_18_18_5_5_5_18_18_18_5_6_6_5_5_5_5_3_5_18_3_3_3_18_16
5743,63,1330440060,18,19,16,1330444500,4440,3588600,6232860,2644260,16_16_16_16_16_16_16_16_16_0_0_16_16_0_16_16_0_16_16_0_0_16_16_16_0_0_16_0_0_16_0_16_0_0_0_16_1_1_1_16_16_16_0_1_1_1_16_0_0_16_16_0_16_0_16_0_0_2_2_1_1_0_0_0_0_2_2_2_2_2_2_0_1_0_1_1_0_0_0_1_1_0_0_1_1_1_0_0_0_0_0_2_2_2_2_0_0_0_0_0_0_1_1_1_1_0_0_16_0_16_16_16_16_16_0_0_1_1_2_2_1_1_16_0_2_16_2_2_2_0_1_1_1_1_1_16_16_1_1_1_3_3_18_3_18_3_3_3_3_3_18_18_18_18_3_3_3_3_18_18_18_18_18_18_18_5_5_5_18_5_18_18_18_18_18_5_5_5_18_18_18_5_6_6_5_5_5_5_3_5_18_3_3_3_18_16_18
5744,216,1330440120,5,9,8,1330440660,540,466620,496500,29880,19_19_19_19_19_19_19_19_19_19_19_19_19_19_19_19_19_19_19_19_19_19_8_8_8_2_2_5_5
5745,103,1330440300,5,9,5,1330444260,3960,4639320,4719960,80640,19_19_19_19_19_19_19_1_1_19_19_19_19_1_1_19_19_19_19_19_1_1_2_2_9_2_2_9_9_9_9_9_14_14_14_14_13_13_13_13_13_14_13_14_14_14_13_13_13_13_13_13_44_44_44_44_44_13_44_13_13_13_44_44_44_44_44_44_5_5_5_5_6_6_45_45_45_45_5
5746,216,1330440660,8,9,6,1330466400,25740,467160,496500,29340,19_19_19_19_19_19_19_19_19_19_19_19_19_19_19_19_19_19_19_19_19_19_8_8_8_2_2_5_5_8
5747,19,1330441560,14,17,6,1330466400,24840,555360,608940,53580,14_14_14_14_14_14_6_6_14_5_5_14_14_14_14_14_14_14_14_14
5748,213,1330441560,2,3,3,1330441620,60,1405140,3206820,1801680,0_0_0_0_0_1_0_1_0_0_0_0_0_0_0_0_1_1_0_0_0_0_0_0_0_1_1_0_0_0_0_0_0_0_0_0_0_0_0_0_0_1_1_1_0_1_0_0_0_0_0_0_0_0_0_0_1_0_1_0_0_0_0_0_0_0_0_0_0_0_0_0_0_0_0_0_0_0_0_1_1_0_0_0_0_0_0_0_0_0_0_0_0_0_1_1_0_0_2_2_3_3_4_3_3_4_2_2_4_4_4_4_4_4_4_4_5_2_3_4_5_2
5749,213,1330441620,3,3,4,1330441740,120,1405200,3206820,1801620,0_0_0_0_0_1_0_1_0_0_0_0_0_0_0_0_1_1_0_0_0_0_0_0_0_1_1_0_0_0_0_0_0_0_0_0_0_0_0_0_0_1_1_1_0_1_0_0_0_0_0_0_0_0_0_0_1_0_1_0_0_0_0_0_0_0_0_0_0_0_0_0_0_0_0_0_0_0_0_1_1_0_0_0_0_0_0_0_0_0_0_0_0_0_1_1_0_0_2_2_3_3_4_3_3_4_2_2_4_4_4_4_4_4_4_4_5_2_3_4_5_2_3
5750,213,1330441740,4,5,6,1330466400,24660,1405320,3206820,1801500,0_0_0_0_0_1_0_1_0_0_0_0_0_0_0_0_1_1_0_0_0_0_0_0_0_1_1_0_0_0_0_0_0_0_0_0_0_0_0_0_0_1_1_1_0_1_0_0_0_0_0_0_0_0_0_0_1_0_1_0_0_0_0_0_0_0_0_0_0_0_0_0_0_0_0_0_0_0_0_1_1_0_0_0_0_0_0_0_0_0_0_0_0_0_1_1_0_0_2_2_3_3_4_3_3_4_2_2_4_4_4_4_4_4_4_4_5_2_3_4_5_2_3_4
5751,169,1330443600,50,10,50,1330451760,8160,781860,2190660,1408800,50_50_50_50_50_50_50_50_50_50_50_50_50_50_50_50_50_1_1_50_50_50_50_1_1_50_50_50_50_50_50_50_50_1_1_50_3_3_50_2_50_2_50_50
5752,220,1330444020,0,14,0,1330444800,780,99660,2714040,2614380,0_0_0_0_1_0_1_0_0_0
5753,89,1330444020,19,14,19,1330452360,8340,642900,1736340,1093440,19_19_19_19_19_1_19_1_19_19
5754,103,1330444260,5,9,6,1330466400,22140,4643280,4719960,76680,19_19_19_19_19_19_19_1_1_19_19_19_19_1_1_19_19_19_19_19_1_1_2_2_9_2_2_9_9_9_9_9_14_14_14_14_13_13_13_13_13_14_13_14_14_14_13_13_13_13_13_13_44_44_44_44_44_13_44_13_13_13_44_44_44_44_44_44_5_5_5_5_6_6_45_45_45_45_5_5
5755,10,1330444320,2,3,2,1330448820,4500,146040,979740,833700,0_0_0_1_1_0_0_0_1_1_2
5756,63,1330444500,16,19,5,1330444920,420,3593040,6232860,2639820,16_16_16_16_16_16_16_16_16_0_0_16_16_0_16_16_0_16_16_0_0_16_16_16_0_0_16_0_0_16_0_16_0_0_0_16_1_1_1_16_16_16_0_1_1_1_16_0_0_16_16_0_16_0_16_0_0_2_2_1_1_0_0_0_0_2_2_2_2_2_2_0_1_0_1_1_0_0_0_1_1_0_0_1_1_1_0_0_0_0_0_2_2_2_2_0_0_0_0_0_0_1_1_1_1_0_0_16_0_16_16_16_16_16_0_0_1_1_2_2_1_1_16_0_2_16_2_2_2_0_1_1_1_1_1_16_16_1_1_1_3_3_18_3_18_3_3_3_3_3_18_18_18_18_3_3_3_3_18_18_18_18_18_18_18_5_5_5_18_5_18_18_18_18_18_5_5_5_18_18_18_5_6_6_5_5_5_5_3_5_18_3_3_3_18_16_18_16
5757,4,1330444560,10,16,10,1330457280,12720,90960,1326000,1235040,10_10_10_10_10_10_10_1_1_10_10_10
5758,220,1330444800,0,0,0,1330491240,46440,100440,2714040,2613600,0_0_0_0_1_0_1_0_0_0_0
5759,63,1330444920,5,2,18,1330447860,2940,3593460,6232860,2639400,16_16_16_16_16_16_16_16_16_0_0_16_16_0_16_16_0_16_16_0_0_16_16_16_0_0_16_0_0_16_0_16_0_0_0_16_1_1_1_16_16_16_0_1_1_1_16_0_0_16_16_0_16_0_16_0_0_2_2_1_1_0_0_0_0_2_2_2_2_2_2_0_1_0_1_1_0_0_0_1_1_0_0_1_1_1_0_0_0_0_0_2_2_2_2_0_0_0_0_0_0_1_1_1_1_0_0_16_0_16_16_16_16_16_0_0_1_1_2_2_1_1_16_0_2_16_2_2_2_0_1_1_1_1_1_16_16_1_1_1_3_3_18_3_18_3_3_3_3_3_18_18_18_18_3_3_3_3_18_18_18_18_18_18_18_5_5_5_18_5_18_18_18_18_18_5_5_5_18_18_18_5_6_6_5_5_5_5_3_5_18_3_3_3_18_16_18_16_5
5760,63,1330447860,18,19,18,1330453200,5340,3596400,6232860,2636460,16_16_16_16_16_16_16_16_16_0_0_16_16_0_16_16_0_16_16_0_0_16_16_16_0_0_16_0_0_16_0_16_0_0_0_16_1_1_1_16_16_16_0_1_1_1_16_0_0_16_16_0_16_0_16_0_0_2_2_1_1_0_0_0_0_2_2_2_2_2_2_0_1_0_1_1_0_0_0_1_1_0_0_1_1_1_0_0_0_0_0_2_2_2_2_0_0_0_0_0_0_1_1_1_1_0_0_16_0_16_16_16_16_16_0_0_1_1_2_2_1_1_16_0_2_16_2_2_2_0_1_1_1_1_1_16_16_1_1_1_3_3_18_3_18_3_3_3_3_3_18_18_18_18_3_3_3_3_18_18_18_18_18_18_18_5_5_5_18_5_18_18_18_18_18_5_5_5_18_18_18_5_6_6_5_5_5_5_3_5_18_3_3_3_18_16_18_16_5_18
5761,10,1330448820,2,3,9,1330466400,17580,150540,979740,829200,0_0_0_1_1_0_0_0_1_1_2_2
5762,57,1330449720,26,13,26,1330452000,2280,181980,2756640,2574660,26_26_26_26_26_26_26_26_26_26_26_26_26_26_26_26_26_26_26_26_26_26
5763,169,1330451760,50,0,6,1330466400,14640,790020,2190660,1400640,50_50_50_50_50_50_50_50_50_50_50_50_50_50_50_50_50_1_1_50_50_50_50_1_1_50_50_50_50_50_50_50_50_1_1_50_3_3_50_2_50_2_50_50_50
5764,57,1330452000,26,32,26,1330490400,38400,184260,2756640,2572380,26_26_26_26_26_26_26_26_26_26_26_26_26_26_26_26_26_26_26_26_26_26_26
5765,89,1330452360,19,11,19,1330472040,19680,651240,1736340,1085100,19_19_19_19_19_1_19_1_19_19_19
5766,63,1330453200,18,22,6,1330466400,13200,3601740,6232860,2631120,16_16_16_16_16_16_16_16_16_0_0_16_16_0_16_16_0_16_16_0_0_16_16_16_0_0_16_0_0_16_0_16_0_0_0_16_1_1_1_16_16_16_0_1_1_1_16_0_0_16_16_0_16_0_16_0_0_2_2_1_1_0_0_0_0_2_2_2_2_2_2_0_1_0_1_1_0_0_0_1_1_0_0_1_1_1_0_0_0_0_0_2_2_2_2_0_0_0_0_0_0_1_1_1_1_0_0_16_0_16_16_16_16_16_0_0_1_1_2_2_1_1_16_0_2_16_2_2_2_0_1_1_1_1_1_16_16_1_1_1_3_3_18_3_18_3_3_3_3_3_18_18_18_18_3_3_3_3_18_18_18_18_18_18_18_5_5_5_18_5_18_18_18_18_18_5_5_5_18_18_18_5_6_6_5_5_5_5_3_5_18_3_3_3_18_16_18_16_5_18_18
5767,4,1330457280,10,13,10,1330471740,14460,103680,1326000,1222320,10_10_10_10_10_10_10_1_1_10_10_10_10
5768,76,1330459920,4,23,3,1330466400,6480,4918320,7552500,2634180,3_3_3_3_3_3_3_3_3_18_3_18_18_18_18_18_3_3_3_1_1_3_17_17_17_18_17_17_18_18_18_18_18_17_17_18_3_3_18_17_18_18_17_18_18_17_17_17_5_5_5_5_1_1_17_17_17_2_2_17_17_17_5_5_5_5_5_5_17_17_5_5_5_17_5_5_5_5_5_17_17_17_1_1_1_1_1_1_1_1_2_2_34_34_5_5_5_5_6_6_3_3_4_3_3_4_4_4_4_4_3_3_3_3_3_3_4
5769,196,1330465140,7,8,7,1330494960,29820,664440,3281700,2617260,7_7_7_7_7_7_7_7_7_7_7_7_7_7_7_7_7_7_7_7_1_1_1_1_7_7_1_1_7_7_1_1_7_7
5770,159,1330465200,16,20,1,1330507800,42600,112380,2480580,2368200,16_16_16_16_16_16_16_16
5771,134,1330466400,6,7,6,1330470000,3600,3652980,3656580,3600,0_0_0_0_0_0_0_0_0_0_1_1_2_2_3_3_13_13_13_13_13_13_13_13_15_15_3_3_4_4_4_4_4_4_5_5_5_5_5_5_6
5772,193,1330466400,6,7,6,1330470000,3600,135000,187200,52200,52_52_26_26_5_5_6
5773,76,1330466400,3,4,3,1330466400,0,4924800,7552500,2627700,3_3_3_3_3_3_3_3_3_18_3_18_18_18_18_18_3_3_3_1_1_3_17_17_17_18_17_17_18_18_18_18_18_17_17_18_3_3_18_17_18_18_17_18_18_17_17_17_5_5_5_5_1_1_17_17_17_2_2_17_17_17_5_5_5_5_5_5_17_17_5_5_5_17_5_5_5_5_5_17_17_17_1_1_1_1_1_1_1_1_2_2_34_34_5_5_5_5_6_6_3_3_4_3_3_4_4_4_4_4_3_3_3_3_3_3_4_3
5774,76,1330466400,3,4,3,1330470900,4500,4924800,7552500,2627700,3_3_3_3_3_3_3_3_3_18_3_18_18_18_18_18_3_3_3_1_1_3_17_17_17_18_17_17_18_18_18_18_18_17_17_18_3_3_18_17_18_18_17_18_18_17_17_17_5_5_5_5_1_1_17_17_17_2_2_17_17_17_5_5_5_5_5_5_17_17_5_5_5_17_5_5_5_5_5_17_17_17_1_1_1_1_1_1_1_1_2_2_34_34_5_5_5_5_6_6_3_3_4_3_3_4_4_4_4_4_3_3_3_3_3_3_4_3_3
5775,10,1330466400,9,17,9,1330470900,4500,168120,979740,811620,0_0_0_1_1_0_0_0_1_1_2_2_9
5776,131,1330466400,6,7,6,1330470000,3600,4206300,6825900,2619600,16_16_16_16_16_16_16_16_16_16_16_16_16_16_16_16_16_16_16_16_16_16_16_16_16_16_1_1_1_1_2_2_3_3_3_3_18_18_18_18_18_3_3_3_3_18_18_18_18_18_18_18_18_18_18_18_18_18_18_18_18_18_18_18_5_5_5_5_5_5_5_5_5_5_5_5_6_6_5_5_6_6_5_5_5_5_5_5_5_5_5_5_6
5777,155,1330466400,9,17,9,1330470900,4500,1876200,3225180,1348980,0_0_0_0_0_0_0_0_1_1_1_1_2_2_9
5778,103,1330466400,6,7,6,1330470000,3600,4665420,4719960,54540,19_19_19_19_19_19_19_1_1_19_19_19_19_1_1_19_19_19_19_19_1_1_2_2_9_2_2_9_9_9_9_9_14_14_14_14_13_13_13_13_13_14_13_14_14_14_13_13_13_13_13_13_44_44_44_44_44_13_44_13_13_13_44_44_44_44_44_44_5_5_5_5_6_6_45_45_45_45_5_5_6
5779,19,1330466400,6,7,6,1330470000,3600,580200,608940,28740,14_14_14_14_14_14_6_6_14_5_5_14_14_14_14_14_14_14_14_14_6
5780,63,1330466400,6,7,3,1330466400,0,3614940,6232860,2617920,16_16_16_16_16_16_16_16_16_0_0_16_16_0_16_16_0_16_16_0_0_16_16_16_0_0_16_0_0_16_0_16_0_0_0_16_1_1_1_16_16_16_0_1_1_1_16_0_0_16_16_0_16_0_16_0_0_2_2_1_1_0_0_0_0_2_2_2_2_2_2_0_1_0_1_1_0_0_0_1_1_0_0_1_1_1_0_0_0_0_0_2_2_2_2_0_0_0_0_0_0_1_1_1_1_0_0_16_0_16_16_16_16_16_0_0_1_1_2_2_1_1_16_0_2_16_2_2_2_0_1_1_1_1_1_16_16_1_1_1_3_3_18_3_18_3_3_3_3_3_18_18_18_18_3_3_3_3_18_18_18_18_18_18_18_5_5_5_18_5_18_18_18_18_18_5_5_5_18_18_18_5_6_6_5_5_5_5_3_5_18_3_3_3_18_16_18_16_5_18_18_6
5781,63,1330466400,3,4,6,1330470000,3600,3614940,6232860,2617920,16_16_16_16_16_16_16_16_16_0_0_16_16_0_16_16_0_16_16_0_0_16_16_16_0_0_16_0_0_16_0_16_0_0_0_16_1_1_1_16_16_16_0_1_1_1_16_0_0_16_16_0_16_0_16_0_0_2_2_1_1_0_0_0_0_2_2_2_2_2_2_0_1_0_1_1_0_0_0_1_1_0_0_1_1_1_0_0_0_0_0_2_2_2_2_0_0_0_0_0_0_1_1_1_1_0_0_16_0_16_16_16_16_16_0_0_1_1_2_2_1_1_16_0_2_16_2_2_2_0_1_1_1_1_1_16_16_1_1_1_3_3_18_3_18_3_3_3_3_3_18_18_18_18_3_3_3_3_18_18_18_18_18_18_18_5_5_5_18_5_18_18_18_18_18_5_5_5_18_18_18_5_6_6_5_5_5_5_3_5_18_3_3_3_18_16_18_16_5_18_18_6_3
5782,216,1330466400,6,7,6,1330470000,3600,492900,496500,3600,19_19_19_19_19_19_19_19_19_19_19_19_19_19_19_19_19_19_19_19_19_19_8_8_8_2_2_5_5_8_6
5783,169,1330466400,6,7,6,1330470000,3600,804660,2190660,1386000,50_50_50_50_50_50_50_50_50_50_50_50_50_50_50_50_50_1_1_50_50_50_50_1_1_50_50_50_50_50_50_50_50_1_1_50_3_3_50_2_50_2_50_50_50_6
5784,113,1330466400,6,7,6,1330470000,3600,3643140,3646740,3600,16_16_16_16_1_1_2_2_48_3_3_48_15_15_4_3_3_3_4_4_3_3_3_4_5_5_5_5_6
5785,213,1330466400,6,7,6,1330470000,3600,1429980,3206820,1776840,0_0_0_0_0_1_0_1_0_0_0_0_0_0_0_0_1_1_0_0_0_0_0_0_0_1_1_0_0_0_0_0_0_0_0_0_0_0_0_0_0_1_1_1_0_1_0_0_0_0_0_0_0_0_0_0_1_0_1_0_0_0_0_0_0_0_0_0_0_0_0_0_0_0_0_0_0_0_0_1_1_0_0_0_0_0_0_0_0_0_0_0_0_0_1_1_0_0_2_2_3_3_4_3_3_4_2_2_4_4_4_4_4_4_4_4_5_2_3_4_5_2_3_4_6
5786,177,1330466400,6,7,6,1330470000,3600,1709460,1713060,3600,10_10_10_10_10_10_10_10_10_10_10_10_10_10_10_10_1_9_1_9_2_2_2_2_5_5_5_5_6_6_6
5787,193,1330470000,6,7,5,1330516800,46800,138600,187200,48600,52_52_26_26_5_5_6_6
5788,63,1330470000,6,7,18,1330470300,300,3618540,6232860,2614320,16_16_16_16_16_16_16_16_16_0_0_16_16_0_16_16_0_16_16_0_0_16_16_16_0_0_16_0_0_16_0_16_0_0_0_16_1_1_1_16_16_16_0_1_1_1_16_0_0_16_16_0_16_0_16_0_0_2_2_1_1_0_0_0_0_2_2_2_2_2_2_0_1_0_1_1_0_0_0_1_1_0_0_1_1_1_0_0_0_0_0_2_2_2_2_0_0_0_0_0_0_1_1_1_1_0_0_16_0_16_16_16_16_16_0_0_1_1_2_2_1_1_16_0_2_16_2_2_2_0_1_1_1_1_1_16_16_1_1_1_3_3_18_3_18_3_3_3_3_3_18_18_18_18_3_3_3_3_18_18_18_18_18_18_18_5_5_5_18_5_18_18_18_18_18_5_5_5_18_18_18_5_6_6_5_5_5_5_3_5_18_3_3_3_18_16_18_16_5_18_18_6_3_6
5789,134,1330470000,6,7,99,1330470000,0,3656580,3656580,0,0_0_0_0_0_0_0_0_0_0_1_1_2_2_3_3_13_13_13_13_13_13_13_13_15_15_3_3_4_4_4_4_4_4_5_5_5_5_5_5_6_6
5790,213,1330470000,6,7,5,1330495680,25680,1433580,3206820,1773240,0_0_0_0_0_1_0_1_0_0_0_0_0_0_0_0_1_1_0_0_0_0_0_0_0_1_1_0_0_0_0_0_0_0_0_0_0_0_0_0_0_1_1_1_0_1_0_0_0_0_0_0_0_0_0_0_1_0_1_0_0_0_0_0_0_0_0_0_0_0_0_0_0_0_0_0_0_0_0_1_1_0_0_0_0_0_0_0_0_0_0_0_0_0_1_1_0_0_2_2_3_3_4_3_3_4_2_2_4_4_4_4_4_4_4_4_5_2_3_4_5_2_3_4_6_6
5791,216,1330470000,6,7,99,1330470000,0,496500,496500,0,19_19_19_19_19_19_19_19_19_19_19_19_19_19_19_19_19_19_19_19_19_19_8_8_8_2_2_5_5_8_6_6
5792,131,1330470000,6,7,5,1330497000,27000,4209900,6825900,2616000,16_16_16_16_16_16_16_16_16_16_16_16_16_16_16_16_16_16_16_16_16_16_16_16_16_16_1_1_1_1_2_2_3_3_3_3_18_18_18_18_18_3_3_3_3_18_18_18_18_18_18_18_18_18_18_18_18_18_18_18_18_18_18_18_5_5_5_5_5_5_5_5_5_5_5_5_6_6_5_5_6_6_5_5_5_5_5_5_5_5_5_5_6_6
5793,113,1330470000,6,7,99,1330470000,0,3646740,3646740,0,16_16_16_16_1_1_2_2_48_3_3_48_15_15_4_3_3_3_4_4_3_3_3_4_5_5_5_5_6_6
5794,169,1330470000,6,7,3,1330470600,600,808260,2190660,1382400,50_50_50_50_50_50_50_50_50_50_50_50_50_50_50_50_50_1_1_50_50_50_50_1_1_50_50_50_50_50_50_50_50_1_1_50_3_3_50_2_50_2_50_50_50_6_6
5795,103,1330470000,6,7,5,1330500000,30000,4669020,4719960,50940,19_19_19_19_19_19_19_1_1_19_19_19_19_1_1_19_19_19_19_19_1_1_2_2_9_2_2_9_9_9_9_9_14_14_14_14_13_13_13_13_13_14_13_14_14_14_13_13_13_13_13_13_44_44_44_44_44_13_44_13_13_13_44_44_44_44_44_44_5_5_5_5_6_6_45_45_45_45_5_5_6_6
5796,19,1330470000,6,7,5,1330491600,21600,583800,608940,25140,14_14_14_14_14_14_6_6_14_5_5_14_14_14_14_14_14_14_14_14_6_6
5797,177,1330470000,6,7,99,1330470000,0,1713060,1713060,0,10_10_10_10_10_10_10_10_10_10_10_10_10_10_10_10_1_9_1_9_2_2_2_2_5_5_5_5_6_6_6_6
5798,63,1330470300,18,22,3,1330470900,600,3618840,6232860,2614020,16_16_16_16_16_16_16_16_16_0_0_16_16_0_16_16_0_16_16_0_0_16_16_16_0_0_16_0_0_16_0_16_0_0_0_16_1_1_1_16_16_16_0_1_1_1_16_0_0_16_16_0_16_0_16_0_0_2_2_1_1_0_0_0_0_2_2_2_2_2_2_0_1_0_1_1_0_0_0_1_1_0_0_1_1_1_0_0_0_0_0_2_2_2_2_0_0_0_0_0_0_1_1_1_1_0_0_16_0_16_16_16_16_16_0_0_1_1_2_2_1_1_16_0_2_16_2_2_2_0_1_1_1_1_1_16_16_1_1_1_3_3_18_3_18_3_3_3_3_3_18_18_18_18_3_3_3_3_18_18_18_18_18_18_18_5_5_5_18_5_18_18_18_18_18_5_5_5_18_18_18_5_6_6_5_5_5_5_3_5_18_3_3_3_18_16_18_16_5_18_18_6_3_6_18
5799,169,1330470600,3,22,3,1330485360,14760,808860,2190660,1381800,50_50_50_50_50_50_50_50_50_50_50_50_50_50_50_50_50_1_1_50_50_50_50_1_1_50_50_50_50_50_50_50_50_1_1_50_3_3_50_2_50_2_50_50_50_6_6_3
5800,76,1330470900,3,4,3,1330470900,0,4929300,7552500,2623200,3_3_3_3_3_3_3_3_3_18_3_18_18_18_18_18_3_3_3_1_1_3_17_17_17_18_17_17_18_18_18_18_18_17_17_18_3_3_18_17_18_18_17_18_18_17_17_17_5_5_5_5_1_1_17_17_17_2_2_17_17_17_5_5_5_5_5_5_17_17_5_5_5_17_5_5_5_5_5_17_17_17_1_1_1_1_1_1_1_1_2_2_34_34_5_5_5_5_6_6_3_3_4_3_3_4_4_4_4_4_3_3_3_3_3_3_4_3_3_3
5801,76,1330470900,3,4,4,1330471560,660,4929300,7552500,2623200,3_3_3_3_3_3_3_3_3_18_3_18_18_18_18_18_3_3_3_1_1_3_17_17_17_18_17_17_18_18_18_18_18_17_17_18_3_3_18_17_18_18_17_18_18_17_17_17_5_5_5_5_1_1_17_17_17_2_2_17_17_17_5_5_5_5_5_5_17_17_5_5_5_17_5_5_5_5_5_17_17_17_1_1_1_1_1_1_1_1_2_2_34_34_5_5_5_5_6_6_3_3_4_3_3_4_4_4_4_4_3_3_3_3_3_3_4_3_3_3_3
5802,155,1330470900,9,17,9,1330549620,78720,1880700,3225180,1344480,0_0_0_0_0_0_0_0_1_1_1_1_2_2_9_9
5803,10,1330470900,9,17,9,1330545900,75000,172620,979740,807120,0_0_0_1_1_0_0_0_1_1_2_2_9_9
5804,63,1330470900,3,4,18,1330471680,780,3619440,6232860,2613420,16_16_16_16_16_16_16_16_16_0_0_16_16_0_16_16_0_16_16_0_0_16_16_16_0_0_16_0_0_16_0_16_0_0_0_16_1_1_1_16_16_16_0_1_1_1_16_0_0_16_16_0_16_0_16_0_0_2_2_1_1_0_0_0_0_2_2_2_2_2_2_0_1_0_1_1_0_0_0_1_1_0_0_1_1_1_0_0_0_0_0_2_2_2_2_0_0_0_0_0_0_1_1_1_1_0_0_16_0_16_16_16_16_16_0_0_1_1_2_2_1_1_16_0_2_16_2_2_2_0_1_1_1_1_1_16_16_1_1_1_3_3_18_3_18_3_3_3_3_3_18_18_18_18_3_3_3_3_18_18_18_18_18_18_18_5_5_5_18_5_18_18_18_18_18_5_5_5_18_18_18_5_6_6_5_5_5_5_3_5_18_3_3_3_18_16_18_16_5_18_18_6_3_6_18_3
5805,76,1330471560,4,23,4,1330471620,60,4929960,7552500,2622540,3_3_3_3_3_3_3_3_3_18_3_18_18_18_18_18_3_3_3_1_1_3_17_17_17_18_17_17_18_18_18_18_18_17_17_18_3_3_18_17_18_18_17_18_18_17_17_17_5_5_5_5_1_1_17_17_17_2_2_17_17_17_5_5_5_5_5_5_17_17_5_5_5_17_5_5_5_5_5_17_17_17_1_1_1_1_1_1_1_1_2_2_34_34_5_5_5_5_6_6_3_3_4_3_3_4_4_4_4_4_3_3_3_3_3_3_4_3_3_3_3_4
5806,76,1330471620,4,23,4,1330490040,18420,4930020,7552500,2622480,3_3_3_3_3_3_3_3_3_18_3_18_18_18_18_18_3_3_3_1_1_3_17_17_17_18_17_17_18_18_18_18_18_17_17_18_3_3_18_17_18_18_17_18_18_17_17_17_5_5_5_5_1_1_17_17_17_2_2_17_17_17_5_5_5_5_5_5_17_17_5_5_5_17_5_5_5_5_5_17_17_17_1_1_1_1_1_1_1_1_2_2_34_34_5_5_5_5_6_6_3_3_4_3_3_4_4_4_4_4_3_3_3_3_3_3_4_3_3_3_3_4_4
5807,63,1330471680,18,23,18,1330489980,18300,3620220,6232860,2612640,16_16_16_16_16_16_16_16_16_0_0_16_16_0_16_16_0_16_16_0_0_16_16_16_0_0_16_0_0_16_0_16_0_0_0_16_1_1_1_16_16_16_0_1_1_1_16_0_0_16_16_0_16_0_16_0_0_2_2_1_1_0_0_0_0_2_2_2_2_2_2_0_1_0_1_1_0_0_0_1_1_0_0_1_1_1_0_0_0_0_0_2_2_2_2_0_0_0_0_0_0_1_1_1_1_0_0_16_0_16_16_16_16_16_0_0_1_1_2_2_1_1_16_0_2_16_2_2_2_0_1_1_1_1_1_16_16_1_1_1_3_3_18_3_18_3_3_3_3_3_18_18_18_18_3_3_3_3_18_18_18_18_18_18_18_5_5_5_18_5_18_18_18_18_18_5_5_5_18_18_18_5_6_6_5_5_5_5_3_5_18_3_3_3_18_16_18_16_5_18_18_6_3_6_18_3_18
5808,4,1330471740,10,13,10,1330471800,60,118140,1326000,1207860,10_10_10_10_10_10_10_1_1_10_10_10_10_10
5809,4,1330471800,10,11,10,1330482660,10860,118200,1326000,1207800,10_10_10_10_10_10_10_1_1_10_10_10_10_10_10
5810,89,1330472040,19,11,1,1330496400,24360,670920,1736340,1065420,19_19_19_19_19_1_19_1_19_19_19_19
5811,17,1330473780,19,11,19,1330491180,17400,0,626460,626460,19
5812,4,1330482660,10,11,10,1330493520,10860,129060,1326000,1196940,10_10_10_10_10_10_10_1_1_10_10_10_10_10_10_10
5813,169,1330485360,3,22,50,1330491180,5820,823620,2190660,1367040,50_50_50_50_50_50_50_50_50_50_50_50_50_50_50_50_50_1_1_50_50_50_50_1_1_50_50_50_50_50_50_50_50_1_1_50_3_3_50_2_50_2_50_50_50_6_6_3_3
5814,63,1330489980,18,23,5,1330491600,1620,3638520,6232860,2594340,16_16_16_16_16_16_16_16_16_0_0_16_16_0_16_16_0_16_16_0_0_16_16_16_0_0_16_0_0_16_0_16_0_0_0_16_1_1_1_16_16_16_0_1_1_1_16_0_0_16_16_0_16_0_16_0_0_2_2_1_1_0_0_0_0_2_2_2_2_2_2_0_1_0_1_1_0_0_0_1_1_0_0_1_1_1_0_0_0_0_0_2_2_2_2_0_0_0_0_0_0_1_1_1_1_0_0_16_0_16_16_16_16_16_0_0_1_1_2_2_1_1_16_0_2_16_2_2_2_0_1_1_1_1_1_16_16_1_1_1_3_3_18_3_18_3_3_3_3_3_18_18_18_18_3_3_3_3_18_18_18_18_18_18_18_5_5_5_18_5_18_18_18_18_18_5_5_5_18_18_18_5_6_6_5_5_5_5_3_5_18_3_3_3_18_16_18_16_5_18_18_6_3_6_18_3_18_18
5815,76,1330490040,4,23,3,1330495320,5280,4948440,7552500,2604060,3_3_3_3_3_3_3_3_3_18_3_18_18_18_18_18_3_3_3_1_1_3_17_17_17_18_17_17_18_18_18_18_18_17_17_18_3_3_18_17_18_18_17_18_18_17_17_17_5_5_5_5_1_1_17_17_17_2_2_17_17_17_5_5_5_5_5_5_17_17_5_5_5_17_5_5_5_5_5_17_17_17_1_1_1_1_1_1_1_1_2_2_34_34_5_5_5_5_6_6_3_3_4_3_3_4_4_4_4_4_3_3_3_3_3_3_4_3_3_3_3_4_4_4
5816,57,1330490400,26,32,26,1330492800,2400,222660,2756640,2533980,26_26_26_26_26_26_26_26_26_26_26_26_26_26_26_26_26_26_26_26_26_26_26_26
5817,102,1330491000,5,6,5,1330494000,3000,3195240,3198240,3000,43_43_43_43_16_16_8_1_16_1_8_16_16_16_2_2_3_3_13_13_13_13_15_15_3_3_4_4_4_4_5
5818,169,1330491180,50,0,5,1330507560,16380,829440,2190660,1361220,50_50_50_50_50_50_50_50_50_50_50_50_50_50_50_50_50_1_1_50_50_50_50_1_1_50_50_50_50_50_50_50_50_1_1_50_3_3_50_2_50_2_50_50_50_6_6_3_3_50
5819,17,1330491180,19,11,1,1330491360,180,17400,626460,609060,19_19
5820,220,1330491240,0,0,1,1330491360,120,146880,2714040,2567160,0_0_0_0_1_0_1_0_0_0_0_0
5821,17,1330491360,1,9,19,1330492200,840,17580,626460,608880,19_19_1
5822,220,1330491360,1,9,0,1330492020,660,147000,2714040,2567040,0_0_0_0_1_0_1_0_0_0_0_0_1
5823,63,1330491600,5,2,5,1330497000,5400,3640140,6232860,2592720,16_16_16_16_16_16_16_16_16_0_0_16_16_0_16_16_0_16_16_0_0_16_16_16_0_0_16_0_0_16_0_16_0_0_0_16_1_1_1_16_16_16_0_1_1_1_16_0_0_16_16_0_16_0_16_0_0_2_2_1_1_0_0_0_0_2_2_2_2_2_2_0_1_0_1_1_0_0_0_1_1_0_0_1_1_1_0_0_0_0_0_2_2_2_2_0_0_0_0_0_0_1_1_1_1_0_0_16_0_16_16_16_16_16_0_0_1_1_2_2_1_1_16_0_2_16_2_2_2_0_1_1_1_1_1_16_16_1_1_1_3_3_18_3_18_3_3_3_3_3_18_18_18_18_3_3_3_3_18_18_18_18_18_18_18_5_5_5_18_5_18_18_18_18_18_5_5_5_18_18_18_5_6_6_5_5_5_5_3_5_18_3_3_3_18_16_18_16_5_18_18_6_3_6_18_3_18_18_5
5824,19,1330491600,5,18,5,1330495140,3540,605400,608940,3540,14_14_14_14_14_14_6_6_14_5_5_14_14_14_14_14_14_14_14_14_6_6_5
5825,154,1330491600,16,14,1,1330500600,9000,0,115500,115500,16
5826,220,1330492020,0,1,1,1330492800,780,147660,2714040,2566380,0_0_0_0_1_0_1_0_0_0_0_0_1_0_0
5827,220,1330492020,0,21,0,1330492020,0,147660,2714040,2566380,0_0_0_0_1_0_1_0_0_0_0_0_1_0
5828,17,1330492200,19,21,19,1330495260,3060,18420,626460,608040,19_19_1_19
5829,220,1330492800,1,9,0,1330495320,2520,148440,2714040,2565600,0_0_0_0_1_0_1_0_0_0_0_0_1_0_0_1
5830,57,1330492800,26,33,8,1330495200,2400,225060,2756640,2531580,26_26_26_26_26_26_26_26_26_26_26_26_26_26_26_26_26_26_26_26_26_26_26_26_26
5831,4,1330493520,10,16,10,1330506300,12780,139920,1326000,1186080,10_10_10_10_10_10_10_1_1_10_10_10_10_10_10_10_10
5832,102,1330494000,5,6,99,1330494000,0,3198240,3198240,0,43_43_43_43_16_16_8_1_16_1_8_16_16_16_2_2_3_3_13_13_13_13_15_15_3_3_4_4_4_4_5_5
5833,196,1330494960,7,12,1,1330498800,3840,694260,3281700,2587440,7_7_7_7_7_7_7_7_7_7_7_7_7_7_7_7_7_7_7_7_1_1_1_1_7_7_1_1_7_7_1_1_7_7_7
5834,19,1330495140,5,18,99,1330495140,0,608940,608940,0,14_14_14_14_14_14_6_6_14_5_5_14_14_14_14_14_14_14_14_14_6_6_5_5
5835,57,1330495200,8,18,8,1330497600,2400,227460,2756640,2529180,26_26_26_26_26_26_26_26_26_26_26_26_26_26_26_26_26_26_26_26_26_26_26_26_26_8
5836,17,1330495260,19,21,1,1330496340,1080,21480,626460,604980,19_19_1_19_19
5837,220,1330495320,0,1,0,1330524420,29100,150960,2714040,2563080,0_0_0_0_1_0_1_0_0_0_0_0_1_0_0_1_0
5838,76,1330495320,3,4,4,1330501080,5760,4953720,7552500,2598780,3_3_3_3_3_3_3_3_3_18_3_18_18_18_18_18_3_3_3_1_1_3_17_17_17_18_17_17_18_18_18_18_18_17_17_18_3_3_18_17_18_18_17_18_18_17_17_17_5_5_5_5_1_1_17_17_17_2_2_17_17_17_5_5_5_5_5_5_17_17_5_5_5_17_5_5_5_5_5_17_17_17_1_1_1_1_1_1_1_1_2_2_34_34_5_5_5_5_6_6_3_3_4_3_3_4_4_4_4_4_3_3_3_3_3_3_4_3_3_3_3_4_4_4_3
5839,213,1330495680,5,9,5,1330495740,60,1459260,3206820,1747560,0_0_0_0_0_1_0_1_0_0_0_0_0_0_0_0_1_1_0_0_0_0_0_0_0_1_1_0_0_0_0_0_0_0_0_0_0_0_0_0_0_1_1_1_0_1_0_0_0_0_0_0_0_0_0_0_1_0_1_0_0_0_0_0_0_0_0_0_0_0_0_0_0_0_0_0_0_0_0_1_1_0_0_0_0_0_0_0_0_0_0_0_0_0_1_1_0_0_2_2_3_3_4_3_3_4_2_2_4_4_4_4_4_4_4_4_5_2_3_4_5_2_3_4_6_6_5
5840,213,1330495740,5,9,0,1330918140,422400,1459320,3206820,1747500,0_0_0_0_0_1_0_1_0_0_0_0_0_0_0_0_1_1_0_0_0_0_0_0_0_1_1_0_0_0_0_0_0_0_0_0_0_0_0_0_0_1_1_1_0_1_0_0_0_0_0_0_0_0_0_0_1_0_1_0_0_0_0_0_0_0_0_0_0_0_0_0_0_0_0_0_0_0_0_1_1_0_0_0_0_0_0_0_0_0_0_0_0_0_1_1_0_0_2_2_3_3_4_3_3_4_2_2_4_4_4_4_4_4_4_4_5_2_3_4_5_2_3_4_6_6_5_5
5841,17,1330496340,1,9,19,1330539360,43020,22560,626460,603900,19_19_1_19_19_1
5842,89,1330496400,1,9,1,1330498980,2580,695280,1736340,1041060,19_19_19_19_19_1_19_1_19_19_19_19_1
5843,63,1330497000,5,2,18,1330499640,2640,3645540,6232860,2587320,16_16_16_16_16_16_16_16_16_0_0_16_16_0_16_16_0_16_16_0_0_16_16_16_0_0_16_0_0_16_0_16_0_0_0_16_1_1_1_16_16_16_0_1_1_1_16_0_0_16_16_0_16_0_16_0_0_2_2_1_1_0_0_0_0_2_2_2_2_2_2_0_1_0_1_1_0_0_0_1_1_0_0_1_1_1_0_0_0_0_0_2_2_2_2_0_0_0_0_0_0_1_1_1_1_0_0_16_0_16_16_16_16_16_0_0_1_1_2_2_1_1_16_0_2_16_2_2_2_0_1_1_1_1_1_16_16_1_1_1_3_3_18_3_18_3_3_3_3_3_18_18_18_18_3_3_3_3_18_18_18_18_18_18_18_5_5_5_18_5_18_18_18_18_18_5_5_5_18_18_18_5_6_6_5_5_5_5_3_5_18_3_3_3_18_16_18_16_5_18_18_6_3_6_18_3_18_18_5_5
5844,131,1330497000,5,2,5,1330497600,600,4236900,6825900,2589000,16_16_16_16_16_16_16_16_16_16_16_16_16_16_16_16_16_16_16_16_16_16_16_16_16_16_1_1_1_1_2_2_3_3_3_3_18_18_18_18_18_3_3_3_3_18_18_18_18_18_18_18_18_18_18_18_18_18_18_18_18_18_18_18_5_5_5_5_5_5_5_5_5_5_5_5_6_6_5_5_6_6_5_5_5_5_5_5_5_5_5_5_6_6_5
5845,131,1330497600,5,2,34,1330850640,353040,4237500,6825900,2588400,16_16_16_16_16_16_16_16_16_16_16_16_16_16_16_16_16_16_16_16_16_16_16_16_16_16_1_1_1_1_2_2_3_3_3_3_18_18_18_18_18_3_3_3_3_18_18_18_18_18_18_18_18_18_18_18_18_18_18_18_18_18_18_18_5_5_5_5_5_5_5_5_5_5_5_5_6_6_5_5_6_6_5_5_5_5_5_5_5_5_5_5_6_6_5_5
5846,57,1330497600,8,18,8,1330514400,16800,229860,2756640,2526780,26_26_26_26_26_26_26_26_26_26_26_26_26_26_26_26_26_26_26_26_26_26_26_26_26_8_8
5847,196,1330498800,1,18,1,1330507560,8760,698100,3281700,2583600,7_7_7_7_7_7_7_7_7_7_7_7_7_7_7_7_7_7_7_7_1_1_1_1_7_7_1_1_7_7_1_1_7_7_7_1
5848,123,1330498800,5,2,5,1330500600,1800,3544020,3545820,1800,16_16_16_16_16_16_16_16_16_16_16_16_1_1_2_2_3_3_3_14_14_3_3_3_14_14_14_14_14_14_14_14_14_15_14_15_15_15_15_15_3_3_4_4_4_4_5
5849,89,1330498980,1,9,1,1330840200,341220,697860,1736340,1038480,19_19_19_19_19_1_19_1_19_19_19_19_1_1
5850,63,1330499640,18,19,5,1330502400,2760,3648180,6232860,2584680,16_16_16_16_16_16_16_16_16_0_0_16_16_0_16_16_0_16_16_0_0_16_16_16_0_0_16_0_0_16_0_16_0_0_0_16_1_1_1_16_16_16_0_1_1_1_16_0_0_16_16_0_16_0_16_0_0_2_2_1_1_0_0_0_0_2_2_2_2_2_2_0_1_0_1_1_0_0_0_1_1_0_0_1_1_1_0_0_0_0_0_2_2_2_2_0_0_0_0_0_0_1_1_1_1_0_0_16_0_16_16_16_16_16_0_0_1_1_2_2_1_1_16_0_2_16_2_2_2_0_1_1_1_1_1_16_16_1_1_1_3_3_18_3_18_3_3_3_3_3_18_18_18_18_3_3_3_3_18_18_18_18_18_18_18_5_5_5_18_5_18_18_18_18_18_5_5_5_18_18_18_5_6_6_5_5_5_5_3_5_18_3_3_3_18_16_18_16_5_18_18_6_3_6_18_3_18_18_5_5_18
5851,103,1330500000,5,9,5,1330520940,20940,4699020,4719960,20940,19_19_19_19_19_19_19_1_1_19_19_19_19_1_1_19_19_19_19_19_1_1_2_2_9_2_2_9_9_9_9_9_14_14_14_14_13_13_13_13_13_14_13_14_14_14_13_13_13_13_13_13_44_44_44_44_44_13_44_13_13_13_44_44_44_44_44_44_5_5_5_5_6_6_45_45_45_45_5_5_6_6_5
5852,123,1330500600,5,2,99,1330500600,0,3545820,3545820,0,16_16_16_16_16_16_16_16_16_16_16_16_1_1_2_2_3_3_3_14_14_3_3_3_14_14_14_14_14_14_14_14_14_15_14_15_15_15_15_15_3_3_4_4_4_4_5_5
5853,154,1330500600,1,2,1,1330502400,1800,9000,115500,106500,16_1
5854,157,1330500960,9,3,9,1330503240,2280,612780,1993260,1380480,19_19_1_19_1_19_19_19_19_19_19_19_1_1_1_1_9
5855,76,1330501080,4,5,4,1330505760,4680,4959480,7552500,2593020,3_3_3_3_3_3_3_3_3_18_3_18_18_18_18_18_3_3_3_1_1_3_17_17_17_18_17_17_18_18_18_18_18_17_17_18_3_3_18_17_18_18_17_18_18_17_17_17_5_5_5_5_1_1_17_17_17_2_2_17_17_17_5_5_5_5_5_5_17_17_5_5_5_17_5_5_5_5_5_17_17_17_1_1_1_1_1_1_1_1_2_2_34_34_5_5_5_5_6_6_3_3_4_3_3_4_4_4_4_4_3_3_3_3_3_3_4_3_3_3_3_4_4_4_3_4
5856,63,1330502400,5,2,5,1330507800,5400,3650940,6232860,2581920,16_16_16_16_16_16_16_16_16_0_0_16_16_0_16_16_0_16_16_0_0_16_16_16_0_0_16_0_0_16_0_16_0_0_0_16_1_1_1_16_16_16_0_1_1_1_16_0_0_16_16_0_16_0_16_0_0_2_2_1_1_0_0_0_0_2_2_2_2_2_2_0_1_0_1_1_0_0_0_1_1_0_0_1_1_1_0_0_0_0_0_2_2_2_2_0_0_0_0_0_0_1_1_1_1_0_0_16_0_16_16_16_16_16_0_0_1_1_2_2_1_1_16_0_2_16_2_2_2_0_1_1_1_1_1_16_16_1_1_1_3_3_18_3_18_3_3_3_3_3_18_18_18_18_3_3_3_3_18_18_18_18_18_18_18_5_5_5_18_5_18_18_18_18_18_5_5_5_18_18_18_5_6_6_5_5_5_5_3_5_18_3_3_3_18_16_18_16_5_18_18_6_3_6_18_3_18_18_5_5_18_5
5857,154,1330502400,1,2,16,1330511880,9480,10800,115500,104700,16_1_1
5858,210,1330503240,9,3,9,1330505340,2100,516600,1118160,601560,10_10_10_10_10_10_10_10_10_10_1_1_10_10_1_1_2_2_9
5859,157,1330503240,9,3,1,1331190780,687540,615060,1993260,1378200,19_19_1_19_1_19_19_19_19_19_19_19_1_1_1_1_9_9
5860,210,1330505340,9,3,14,1330609620,104280,518700,1118160,599460,10_10_10_10_10_10_10_10_10_10_1_1_10_10_1_1_2_2_9_9
5861,76,1330505760,4,5,4,1330505820,60,4964160,7552500,2588340,3_3_3_3_3_3_3_3_3_18_3_18_18_18_18_18_3_3_3_1_1_3_17_17_17_18_17_17_18_18_18_18_18_17_17_18_3_3_18_17_18_18_17_18_18_17_17_17_5_5_5_5_1_1_17_17_17_2_2_17_17_17_5_5_5_5_5_5_17_17_5_5_5_17_5_5_5_5_5_17_17_17_1_1_1_1_1_1_1_1_2_2_34_34_5_5_5_5_6_6_3_3_4_3_3_4_4_4_4_4_3_3_3_3_3_3_4_3_3_3_3_4_4_4_3_4_4
5862,76,1330505820,4,5,3,1330507740,1920,4964220,7552500,2588280,3_3_3_3_3_3_3_3_3_18_3_18_18_18_18_18_3_3_3_1_1_3_17_17_17_18_17_17_18_18_18_18_18_17_17_18_3_3_18_17_18_18_17_18_18_17_17_17_5_5_5_5_1_1_17_17_17_2_2_17_17_17_5_5_5_5_5_5_17_17_5_5_5_17_5_5_5_5_5_17_17_17_1_1_1_1_1_1_1_1_2_2_34_34_5_5_5_5_6_6_3_3_4_3_3_4_4_4_4_4_3_3_3_3_3_3_4_3_3_3_3_4_4_4_3_4_4_4
5863,4,1330506300,10,16,10,1330506300,0,152700,1326000,1173300,10_10_10_10_10_10_10_1_1_10_10_10_10_10_10_10_10_10
5864,4,1330506300,10,16,1,1330520400,14100,152700,1326000,1173300,10_10_10_10_10_10_10_1_1_10_10_10_10_10_10_10_10_10_10
5865,196,1330507560,1,18,7,1330522020,14460,706860,3281700,2574840,7_7_7_7_7_7_7_7_7_7_7_7_7_7_7_7_7_7_7_7_1_1_1_1_7_7_1_1_7_7_1_1_7_7_7_1_1
5866,169,1330507560,5,18,2,1330507800,240,845820,2190660,1344840,50_50_50_50_50_50_50_50_50_50_50_50_50_50_50_50_50_1_1_50_50_50_50_1_1_50_50_50_50_50_50_50_50_1_1_50_3_3_50_2_50_2_50_50_50_6_6_3_3_50_5
5867,76,1330507740,3,4,4,1330514520,6780,4966140,7552500,2586360,3_3_3_3_3_3_3_3_3_18_3_18_18_18_18_18_3_3_3_1_1_3_17_17_17_18_17_17_18_18_18_18_18_17_17_18_3_3_18_17_18_18_17_18_18_17_17_17_5_5_5_5_1_1_17_17_17_2_2_17_17_17_5_5_5_5_5_5_17_17_5_5_5_17_5_5_5_5_5_17_17_17_1_1_1_1_1_1_1_1_2_2_34_34_5_5_5_5_6_6_3_3_4_3_3_4_4_4_4_4_3_3_3_3_3_3_4_3_3_3_3_4_4_4_3_4_4_4_3
5868,169,1330507800,2,4,2,1330507860,60,846060,2190660,1344600,50_50_50_50_50_50_50_50_50_50_50_50_50_50_50_50_50_1_1_50_50_50_50_1_1_50_50_50_50_50_50_50_50_1_1_50_3_3_50_2_50_2_50_50_50_6_6_3_3_50_5_2
5869,63,1330507800,5,2,5,1330514400,6600,3656340,6232860,2576520,16_16_16_16_16_16_16_16_16_0_0_16_16_0_16_16_0_16_16_0_0_16_16_16_0_0_16_0_0_16_0_16_0_0_0_16_1_1_1_16_16_16_0_1_1_1_16_0_0_16_16_0_16_0_16_0_0_2_2_1_1_0_0_0_0_2_2_2_2_2_2_0_1_0_1_1_0_0_0_1_1_0_0_1_1_1_0_0_0_0_0_2_2_2_2_0_0_0_0_0_0_1_1_1_1_0_0_16_0_16_16_16_16_16_0_0_1_1_2_2_1_1_16_0_2_16_2_2_2_0_1_1_1_1_1_16_16_1_1_1_3_3_18_3_18_3_3_3_3_3_18_18_18_18_3_3_3_3_18_18_18_18_18_18_18_5_5_5_18_5_18_18_18_18_18_5_5_5_18_18_18_5_6_6_5_5_5_5_3_5_18_3_3_3_18_16_18_16_5_18_18_6_3_6_18_3_18_18_5_5_18_5_5
5870,159,1330507800,1,2,1,1330509000,1200,154980,2480580,2325600,16_16_16_16_16_16_16_16_1
5871,169,1330507860,2,4,2,1330512300,4440,846120,2190660,1344540,50_50_50_50_50_50_50_50_50_50_50_50_50_50_50_50_50_1_1_50_50_50_50_1_1_50_50_50_50_50_50_50_50_1_1_50_3_3_50_2_50_2_50_50_50_6_6_3_3_50_5_2_2
5872,159,1330509000,1,2,1,1330512600,3600,156180,2480580,2324400,16_16_16_16_16_16_16_16_1_1
5873,154,1330511880,16,14,16,1330512120,240,20280,115500,95220,16_1_1_16
5874,154,1330512120,16,21,16,1330524000,11880,20520,115500,94980,16_1_1_16_16
5875,169,1330512300,2,4,2,1330512360,60,850560,2190660,1340100,50_50_50_50_50_50_50_50_50_50_50_50_50_50_50_50_50_1_1_50_50_50_50_1_1_50_50_50_50_50_50_50_50_1_1_50_3_3_50_2_50_2_50_50_50_6_6_3_3_50_5_2_2_2
5876,169,1330512360,2,4,5,1330512600,240,850620,2190660,1340040,50_50_50_50_50_50_50_50_50_50_50_50_50_50_50_50_50_1_1_50_50_50_50_1_1_50_50_50_50_50_50_50_50_1_1_50_3_3_50_2_50_2_50_50_50_6_6_3_3_50_5_2_2_2_2
5877,159,1330512600,1,2,1,1330512600,0,159780,2480580,2320800,16_16_16_16_16_16_16_16_1_1_1
5878,159,1330512600,1,2,2,1330521060,8460,159780,2480580,2320800,16_16_16_16_16_16_16_16_1_1_1_1
5879,169,1330512600,5,18,50,1330516920,4320,850860,2190660,1339800,50_50_50_50_50_50_50_50_50_50_50_50_50_50_50_50_50_1_1_50_50_50_50_1_1_50_50_50_50_50_50_50_50_1_1_50_3_3_50_2_50_2_50_50_50_6_6_3_3_50_5_2_2_2_2_5
5880,63,1330514400,5,2,5,1330518000,3600,3662940,6232860,2569920,16_16_16_16_16_16_16_16_16_0_0_16_16_0_16_16_0_16_16_0_0_16_16_16_0_0_16_0_0_16_0_16_0_0_0_16_1_1_1_16_16_16_0_1_1_1_16_0_0_16_16_0_16_0_16_0_0_2_2_1_1_0_0_0_0_2_2_2_2_2_2_0_1_0_1_1_0_0_0_1_1_0_0_1_1_1_0_0_0_0_0_2_2_2_2_0_0_0_0_0_0_1_1_1_1_0_0_16_0_16_16_16_16_16_0_0_1_1_2_2_1_1_16_0_2_16_2_2_2_0_1_1_1_1_1_16_16_1_1_1_3_3_18_3_18_3_3_3_3_3_18_18_18_18_3_3_3_3_18_18_18_18_18_18_18_5_5_5_18_5_18_18_18_18_18_5_5_5_18_18_18_5_6_6_5_5_5_5_3_5_18_3_3_3_18_16_18_16_5_18_18_6_3_6_18_3_18_18_5_5_18_5_5_5
5881,57,1330514400,8,18,8,1330515300,900,246660,2756640,2509980,26_26_26_26_26_26_26_26_26_26_26_26_26_26_26_26_26_26_26_26_26_26_26_26_26_8_8_8
5882,76,1330514520,4,5,4,1330514820,300,4972920,7552500,2579580,3_3_3_3_3_3_3_3_3_18_3_18_18_18_18_18_3_3_3_1_1_3_17_17_17_18_17_17_18_18_18_18_18_17_17_18_3_3_18_17_18_18_17_18_18_17_17_17_5_5_5_5_1_1_17_17_17_2_2_17_17_17_5_5_5_5_5_5_17_17_5_5_5_17_5_5_5_5_5_17_17_17_1_1_1_1_1_1_1_1_2_2_34_34_5_5_5_5_6_6_3_3_4_3_3_4_4_4_4_4_3_3_3_3_3_3_4_3_3_3_3_4_4_4_3_4_4_4_3_4
5883,76,1330514820,4,19,4,1330523580,8760,4973220,7552500,2579280,3_3_3_3_3_3_3_3_3_18_3_18_18_18_18_18_3_3_3_1_1_3_17_17_17_18_17_17_18_18_18_18_18_17_17_18_3_3_18_17_18_18_17_18_18_17_17_17_5_5_5_5_1_1_17_17_17_2_2_17_17_17_5_5_5_5_5_5_17_17_5_5_5_17_5_5_5_5_5_17_17_17_1_1_1_1_1_1_1_1_2_2_34_34_5_5_5_5_6_6_3_3_4_3_3_4_4_4_4_4_3_3_3_3_3_3_4_3_3_3_3_4_4_4_3_4_4_4_3_4_4
5884,57,1330515300,8,18,2,1330515540,240,247560,2756640,2509080,26_26_26_26_26_26_26_26_26_26_26_26_26_26_26_26_26_26_26_26_26_26_26_26_26_8_8_8_8
5885,57,1330515540,2,5,2,1330520520,4980,247800,2756640,2508840,26_26_26_26_26_26_26_26_26_26_26_26_26_26_26_26_26_26_26_26_26_26_26_26_26_8_8_8_8_2
5886,193,1330516800,5,18,5,1330518600,1800,185400,187200,1800,52_52_26_26_5_5_6_6_5
5887,169,1330516920,50,12,50,1330522080,5160,855180,2190660,1335480,50_50_50_50_50_50_50_50_50_50_50_50_50_50_50_50_50_1_1_50_50_50_50_1_1_50_50_50_50_50_50_50_50_1_1_50_3_3_50_2_50_2_50_50_50_6_6_3_3_50_5_2_2_2_2_5_50
5888,63,1330518000,5,2,5,1330520400,2400,3666540,6232860,2566320,16_16_16_16_16_16_16_16_16_0_0_16_16_0_16_16_0_16_16_0_0_16_16_16_0_0_16_0_0_16_0_16_0_0_0_16_1_1_1_16_16_16_0_1_1_1_16_0_0_16_16_0_16_0_16_0_0_2_2_1_1_0_0_0_0_2_2_2_2_2_2_0_1_0_1_1_0_0_0_1_1_0_0_1_1_1_0_0_0_0_0_2_2_2_2_0_0_0_0_0_0_1_1_1_1_0_0_16_0_16_16_16_16_16_0_0_1_1_2_2_1_1_16_0_2_16_2_2_2_0_1_1_1_1_1_16_16_1_1_1_3_3_18_3_18_3_3_3_3_3_18_18_18_18_3_3_3_3_18_18_18_18_18_18_18_5_5_5_18_5_18_18_18_18_18_5_5_5_18_18_18_5_6_6_5_5_5_5_3_5_18_3_3_3_18_16_18_16_5_18_18_6_3_6_18_3_18_18_5_5_18_5_5_5_5_5
5889,63,1330518000,5,2,5,1330518000,0,3666540,6232860,2566320,16_16_16_16_16_16_16_16_16_0_0_16_16_0_16_16_0_16_16_0_0_16_16_16_0_0_16_0_0_16_0_16_0_0_0_16_1_1_1_16_16_16_0_1_1_1_16_0_0_16_16_0_16_0_16_0_0_2_2_1_1_0_0_0_0_2_2_2_2_2_2_0_1_0_1_1_0_0_0_1_1_0_0_1_1_1_0_0_0_0_0_2_2_2_2_0_0_0_0_0_0_1_1_1_1_0_0_16_0_16_16_16_16_16_0_0_1_1_2_2_1_1_16_0_2_16_2_2_2_0_1_1_1_1_1_16_16_1_1_1_3_3_18_3_18_3_3_3_3_3_18_18_18_18_3_3_3_3_18_18_18_18_18_18_18_5_5_5_18_5_18_18_18_18_18_5_5_5_18_18_18_5_6_6_5_5_5_5_3_5_18_3_3_3_18_16_18_16_5_18_18_6_3_6_18_3_18_18_5_5_18_5_5_5_5
5890,193,1330518600,5,18,99,1330518600,0,187200,187200,0,52_52_26_26_5_5_6_6_5_5
5891,63,1330520400,5,2,5,1330523100,2700,3668940,6232860,2563920,16_16_16_16_16_16_16_16_16_0_0_16_16_0_16_16_0_16_16_0_0_16_16_16_0_0_16_0_0_16_0_16_0_0_0_16_1_1_1_16_16_16_0_1_1_1_16_0_0_16_16_0_16_0_16_0_0_2_2_1_1_0_0_0_0_2_2_2_2_2_2_0_1_0_1_1_0_0_0_1_1_0_0_1_1_1_0_0_0_0_0_2_2_2_2_0_0_0_0_0_0_1_1_1_1_0_0_16_0_16_16_16_16_16_0_0_1_1_2_2_1_1_16_0_2_16_2_2_2_0_1_1_1_1_1_16_16_1_1_1_3_3_18_3_18_3_3_3_3_3_18_18_18_18_3_3_3_3_18_18_18_18_18_18_18_5_5_5_18_5_18_18_18_18_18_5_5_5_18_18_18_5_6_6_5_5_5_5_3_5_18_3_3_3_18_16_18_16_5_18_18_6_3_6_18_3_18_18_5_5_18_5_5_5_5_5_5_5
5892,63,1330520400,5,2,5,1330520400,0,3668940,6232860,2563920,16_16_16_16_16_16_16_16_16_0_0_16_16_0_16_16_0_16_16_0_0_16_16_16_0_0_16_0_0_16_0_16_0_0_0_16_1_1_1_16_16_16_0_1_1_1_16_0_0_16_16_0_16_0_16_0_0_2_2_1_1_0_0_0_0_2_2_2_2_2_2_0_1_0_1_1_0_0_0_1_1_0_0_1_1_1_0_0_0_0_0_2_2_2_2_0_0_0_0_0_0_1_1_1_1_0_0_16_0_16_16_16_16_16_0_0_1_1_2_2_1_1_16_0_2_16_2_2_2_0_1_1_1_1_1_16_16_1_1_1_3_3_18_3_18_3_3_3_3_3_18_18_18_18_3_3_3_3_18_18_18_18_18_18_18_5_5_5_18_5_18_18_18_18_18_5_5_5_18_18_18_5_6_6_5_5_5_5_3_5_18_3_3_3_18_16_18_16_5_18_18_6_3_6_18_3_18_18_5_5_18_5_5_5_5_5_5
5893,4,1330520400,1,18,10,1330524000,3600,166800,1326000,1159200,10_10_10_10_10_10_10_1_1_10_10_10_10_10_10_10_10_10_10_1
5894,57,1330520520,2,5,26,1330522800,2280,252780,2756640,2503860,26_26_26_26_26_26_26_26_26_26_26_26_26_26_26_26_26_26_26_26_26_26_26_26_26_8_8_8_8_2_2
5895,103,1330520940,5,9,99,1330520940,0,4719960,4719960,0,19_19_19_19_19_19_19_1_1_19_19_19_19_1_1_19_19_19_19_19_1_1_2_2_9_2_2_9_9_9_9_9_14_14_14_14_13_13_13_13_13_14_13_14_14_14_13_13_13_13_13_13_44_44_44_44_44_13_44_13_13_13_44_44_44_44_44_44_5_5_5_5_6_6_45_45_45_45_5_5_6_6_5_5
5896,159,1330521060,2,5,2,1330521540,480,168240,2480580,2312340,16_16_16_16_16_16_16_16_1_1_1_1_2
5897,159,1330521540,2,5,3,1331532960,1011420,168720,2480580,2311860,16_16_16_16_16_16_16_16_1_1_1_1_2_2
5898,54,1330521780,2,5,2,1330522920,1140,760980,1314000,553020,7_7_7_7_7_7_7_7_7_7_1_1_5_5_1_1_2
5899,196,1330522020,7,12,7,1330524060,2040,721320,3281700,2560380,7_7_7_7_7_7_7_7_7_7_7_7_7_7_7_7_7_7_7_7_1_1_1_1_7_7_1_1_7_7_1_1_7_7_7_1_1_7_7
5900,196,1330522020,7,12,7,1330522020,0,721320,3281700,2560380,7_7_7_7_7_7_7_7_7_7_7_7_7_7_7_7_7_7_7_7_1_1_1_1_7_7_1_1_7_7_1_1_7_7_7_1_1_7
5901,169,1330522080,50,12,1,1330578180,56100,860340,2190660,1330320,50_50_50_50_50_50_50_50_50_50_50_50_50_50_50_50_50_1_1_50_50_50_50_1_1_50_50_50_50_50_50_50_50_1_1_50_3_3_50_2_50_2_50_50_50_6_6_3_3_50_5_2_2_2_2_5_50_50
5902,57,1330522800,26,33,8,1330524420,1620,255060,2756640,2501580,26_26_26_26_26_26_26_26_26_26_26_26_26_26_26_26_26_26_26_26_26_26_26_26_26_8_8_8_8_2_2_26
5903,54,1330522920,2,5,3,1330557360,34440,762120,1314000,551880,7_7_7_7_7_7_7_7_7_7_1_1_5_5_1_1_2_2
5904,63,1330523100,5,2,5,1330523100,0,3671640,6232860,2561220,16_16_16_16_16_16_16_16_16_0_0_16_16_0_16_16_0_16_16_0_0_16_16_16_0_0_16_0_0_16_0_16_0_0_0_16_1_1_1_16_16_16_0_1_1_1_16_0_0_16_16_0_16_0_16_0_0_2_2_1_1_0_0_0_0_2_2_2_2_2_2_0_1_0_1_1_0_0_0_1_1_0_0_1_1_1_0_0_0_0_0_2_2_2_2_0_0_0_0_0_0_1_1_1_1_0_0_16_0_16_16_16_16_16_0_0_1_1_2_2_1_1_16_0_2_16_2_2_2_0_1_1_1_1_1_16_16_1_1_1_3_3_18_3_18_3_3_3_3_3_18_18_18_18_3_3_3_3_18_18_18_18_18_18_18_5_5_5_18_5_18_18_18_18_18_5_5_5_18_18_18_5_6_6_5_5_5_5_3_5_18_3_3_3_18_16_18_16_5_18_18_6_3_6_18_3_18_18_5_5_18_5_5_5_5_5_5_5_5
5905,63,1330523100,5,2,18,1330523580,480,3671640,6232860,2561220,16_16_16_16_16_16_16_16_16_0_0_16_16_0_16_16_0_16_16_0_0_16_16_16_0_0_16_0_0_16_0_16_0_0_0_16_1_1_1_16_16_16_0_1_1_1_16_0_0_16_16_0_16_0_16_0_0_2_2_1_1_0_0_0_0_2_2_2_2_2_2_0_1_0_1_1_0_0_0_1_1_0_0_1_1_1_0_0_0_0_0_2_2_2_2_0_0_0_0_0_0_1_1_1_1_0_0_16_0_16_16_16_16_16_0_0_1_1_2_2_1_1_16_0_2_16_2_2_2_0_1_1_1_1_1_16_16_1_1_1_3_3_18_3_18_3_3_3_3_3_18_18_18_18_3_3_3_3_18_18_18_18_18_18_18_5_5_5_18_5_18_18_18_18_18_5_5_5_18_18_18_5_6_6_5_5_5_5_3_5_18_3_3_3_18_16_18_16_5_18_18_6_3_6_18_3_18_18_5_5_18_5_5_5_5_5_5_5_5_5
5906,63,1330523580,18,19,3,1330524240,660,3672120,6232860,2560740,16_16_16_16_16_16_16_16_16_0_0_16_16_0_16_16_0_16_16_0_0_16_16_16_0_0_16_0_0_16_0_16_0_0_0_16_1_1_1_16_16_16_0_1_1_1_16_0_0_16_16_0_16_0_16_0_0_2_2_1_1_0_0_0_0_2_2_2_2_2_2_0_1_0_1_1_0_0_0_1_1_0_0_1_1_1_0_0_0_0_0_2_2_2_2_0_0_0_0_0_0_1_1_1_1_0_0_16_0_16_16_16_16_16_0_0_1_1_2_2_1_1_16_0_2_16_2_2_2_0_1_1_1_1_1_16_16_1_1_1_3_3_18_3_18_3_3_3_3_3_18_18_18_18_3_3_3_3_18_18_18_18_18_18_18_5_5_5_18_5_18_18_18_18_18_5_5_5_18_18_18_5_6_6_5_5_5_5_3_5_18_3_3_3_18_16_18_16_5_18_18_6_3_6_18_3_18_18_5_5_18_5_5_5_5_5_5_5_5_5_18
5907,76,1330523580,4,19,3,1330525680,2100,4981980,7552500,2570520,3_3_3_3_3_3_3_3_3_18_3_18_18_18_18_18_3_3_3_1_1_3_17_17_17_18_17_17_18_18_18_18_18_17_17_18_3_3_18_17_18_18_17_18_18_17_17_17_5_5_5_5_1_1_17_17_17_2_2_17_17_17_5_5_5_5_5_5_17_17_5_5_5_17_5_5_5_5_5_17_17_17_1_1_1_1_1_1_1_1_2_2_34_34_5_5_5_5_6_6_3_3_4_3_3_4_4_4_4_4_3_3_3_3_3_3_4_3_3_3_3_4_4_4_3_4_4_4_3_4_4_4
5908,4,1330524000,10,16,1,1330524240,240,170400,1326000,1155600,10_10_10_10_10_10_10_1_1_10_10_10_10_10_10_10_10_10_10_1_10_1_10
5909,4,1330524000,10,16,1,1330524000,0,170400,1326000,1155600,10_10_10_10_10_10_10_1_1_10_10_10_10_10_10_10_10_10_10_1_10
5910,4,1330524000,1,18,10,1330524000,0,170400,1326000,1155600,10_10_10_10_10_10_10_1_1_10_10_10_10_10_10_10_10_10_10_1_10_1
5911,154,1330524000,16,21,16,1330525860,1860,32400,115500,83100,16_1_1_16_16_16
5912,196,1330524060,7,12,7,1330524300,240,723360,3281700,2558340,7_7_7_7_7_7_7_7_7_7_7_7_7_7_7_7_7_7_7_7_1_1_1_1_7_7_1_1_7_7_1_1_7_7_7_1_1_7_7_7
5913,4,1330524240,1,18,1,1330526160,1920,170640,1326000,1155360,10_10_10_10_10_10_10_1_1_10_10_10_10_10_10_10_10_10_10_1_10_1_10_1
5914,63,1330524240,3,3,5,1330524720,480,3672780,6232860,2560080,16_16_16_16_16_16_16_16_16_0_0_16_16_0_16_16_0_16_16_0_0_16_16_16_0_0_16_0_0_16_0_16_0_0_0_16_1_1_1_16_16_16_0_1_1_1_16_0_0_16_16_0_16_0_16_0_0_2_2_1_1_0_0_0_0_2_2_2_2_2_2_0_1_0_1_1_0_0_0_1_1_0_0_1_1_1_0_0_0_0_0_2_2_2_2_0_0_0_0_0_0_1_1_1_1_0_0_16_0_16_16_16_16_16_0_0_1_1_2_2_1_1_16_0_2_16_2_2_2_0_1_1_1_1_1_16_16_1_1_1_3_3_18_3_18_3_3_3_3_3_18_18_18_18_3_3_3_3_18_18_18_18_18_18_18_5_5_5_18_5_18_18_18_18_18_5_5_5_18_18_18_5_6_6_5_5_5_5_3_5_18_3_3_3_18_16_18_16_5_18_18_6_3_6_18_3_18_18_5_5_18_5_5_5_5_5_5_5_5_5_18_3
5915,196,1330524300,7,8,7,1330528800,4500,723600,3281700,2558100,7_7_7_7_7_7_7_7_7_7_7_7_7_7_7_7_7_7_7_7_1_1_1_1_7_7_1_1_7_7_1_1_7_7_7_1_1_7_7_7_7
5916,57,1330524420,8,18,8,1330531200,6780,256680,2756640,2499960,26_26_26_26_26_26_26_26_26_26_26_26_26_26_26_26_26_26_26_26_26_26_26_26_26_8_8_8_8_2_2_26_8
5917,220,1330524420,0,21,0,1330538460,14040,180060,2714040,2533980,0_0_0_0_1_0_1_0_0_0_0_0_1_0_0_1_0_0
5918,63,1330524720,5,2,3,1330532040,7320,3673260,6232860,2559600,16_16_16_16_16_16_16_16_16_0_0_16_16_0_16_16_0_16_16_0_0_16_16_16_0_0_16_0_0_16_0_16_0_0_0_16_1_1_1_16_16_16_0_1_1_1_16_0_0_16_16_0_16_0_16_0_0_2_2_1_1_0_0_0_0_2_2_2_2_2_2_0_1_0_1_1_0_0_0_1_1_0_0_1_1_1_0_0_0_0_0_2_2_2_2_0_0_0_0_0_0_1_1_1_1_0_0_16_0_16_16_16_16_16_0_0_1_1_2_2_1_1_16_0_2_16_2_2_2_0_1_1_1_1_1_16_16_1_1_1_3_3_18_3_18_3_3_3_3_3_18_18_18_18_3_3_3_3_18_18_18_18_18_18_18_5_5_5_18_5_18_18_18_18_18_5_5_5_18_18_18_5_6_6_5_5_5_5_3_5_18_3_3_3_18_16_18_16_5_18_18_6_3_6_18_3_18_18_5_5_18_5_5_5_5_5_5_5_5_5_18_3_5
5919,76,1330525680,3,4,3,1330525740,60,4984080,7552500,2568420,3_3_3_3_3_3_3_3_3_18_3_18_18_18_18_18_3_3_3_1_1_3_17_17_17_18_17_17_18_18_18_18_18_17_17_18_3_3_18_17_18_18_17_18_18_17_17_17_5_5_5_5_1_1_17_17_17_2_2_17_17_17_5_5_5_5_5_5_17_17_5_5_5_17_5_5_5_5_5_17_17_17_1_1_1_1_1_1_1_1_2_2_34_34_5_5_5_5_6_6_3_3_4_3_3_4_4_4_4_4_3_3_3_3_3_3_4_3_3_3_3_4_4_4_3_4_4_4_3_4_4_4_3
5920,76,1330525740,3,4,4,1330540560,14820,4984140,7552500,2568360,3_3_3_3_3_3_3_3_3_18_3_18_18_18_18_18_3_3_3_1_1_3_17_17_17_18_17_17_18_18_18_18_18_17_17_18_3_3_18_17_18_18_17_18_18_17_17_17_5_5_5_5_1_1_17_17_17_2_2_17_17_17_5_5_5_5_5_5_17_17_5_5_5_17_5_5_5_5_5_17_17_17_1_1_1_1_1_1_1_1_2_2_34_34_5_5_5_5_6_6_3_3_4_3_3_4_4_4_4_4_3_3_3_3_3_3_4_3_3_3_3_4_4_4_3_4_4_4_3_4_4_4_3_3
5921,154,1330525860,16,20,16,1330533000,7140,34260,115500,81240,16_1_1_16_16_16_16
5922,4,1330526160,1,18,10,1330528740,2580,172560,1326000,1153440,10_10_10_10_10_10_10_1_1_10_10_10_10_10_10_10_10_10_10_1_10_1_10_1_1
5923,4,1330528740,10,16,10,1330528800,60,175140,1326000,1150860,10_10_10_10_10_10_10_1_1_10_10_10_10_10_10_10_10_10_10_1_10_1_10_1_1_10
5924,196,1330528800,7,8,7,1330578000,49200,728100,3281700,2553600,7_7_7_7_7_7_7_7_7_7_7_7_7_7_7_7_7_7_7_7_1_1_1_1_7_7_1_1_7_7_1_1_7_7_7_1_1_7_7_7_7_7
5925,4,1330528800,10,16,10,1330530480,1680,175200,1326000,1150800,10_10_10_10_10_10_10_1_1_10_10_10_10_10_10_10_10_10_10_1_10_1_10_1_1_10_10
5926,4,1330530480,10,16,10,1330547220,16740,176880,1326000,1149120,10_10_10_10_10_10_10_1_1_10_10_10_10_10_10_10_10_10_10_1_10_1_10_1_1_10_10_10
5927,57,1330531200,26,13,26,1330543500,12300,263460,2756640,2493180,26_26_26_26_26_26_26_26_26_26_26_26_26_26_26_26_26_26_26_26_26_26_26_26_26_8_8_8_8_2_2_26_8_8_26
5928,57,1330531200,8,18,26,1330531200,0,263460,2756640,2493180,26_26_26_26_26_26_26_26_26_26_26_26_26_26_26_26_26_26_26_26_26_26_26_26_26_8_8_8_8_2_2_26_8_8
5929,63,1330532040,3,3,18,1330540620,8580,3680580,6232860,2552280,16_16_16_16_16_16_16_16_16_0_0_16_16_0_16_16_0_16_16_0_0_16_16_16_0_0_16_0_0_16_0_16_0_0_0_16_1_1_1_16_16_16_0_1_1_1_16_0_0_16_16_0_16_0_16_0_0_2_2_1_1_0_0_0_0_2_2_2_2_2_2_0_1_0_1_1_0_0_0_1_1_0_0_1_1_1_0_0_0_0_0_2_2_2_2_0_0_0_0_0_0_1_1_1_1_0_0_16_0_16_16_16_16_16_0_0_1_1_2_2_1_1_16_0_2_16_2_2_2_0_1_1_1_1_1_16_16_1_1_1_3_3_18_3_18_3_3_3_3_3_18_18_18_18_3_3_3_3_18_18_18_18_18_18_18_5_5_5_18_5_18_18_18_18_18_5_5_5_18_18_18_5_6_6_5_5_5_5_3_5_18_3_3_3_18_16_18_16_5_18_18_6_3_6_18_3_18_18_5_5_18_5_5_5_5_5_5_5_5_5_18_3_5_3
5930,218,1330532460,13,17,13,1330534800,2340,1432140,1974480,542340,19_19_19_19_19_19_1_1_1_1_1_1_13
5931,154,1330533000,16,20,16,1330578000,45000,41400,115500,74100,16_1_1_16_16_16_16_16
5932,204,1330533060,16,20,16,1330545480,12420,0,2567700,2567700,16
5933,218,1330534800,13,17,2,1330534800,0,1434480,1974480,540000,19_19_19_19_19_19_1_1_1_1_1_1_13_13
5934,218,1330534800,2,17,2,1330534920,120,1434480,1974480,540000,19_19_19_19_19_19_1_1_1_1_1_1_13_13_2
5935,218,1330534920,3,17,13,1330534920,0,1434600,1974480,539880,19_19_19_19_19_19_1_1_1_1_1_1_13_13_2_2_3
5936,218,1330534920,2,17,3,1330534920,0,1434600,1974480,539880,19_19_19_19_19_19_1_1_1_1_1_1_13_13_2_2
5937,218,1330534920,13,17,13,1330537740,2820,1434600,1974480,539880,19_19_19_19_19_19_1_1_1_1_1_1_13_13_2_2_3_13
5938,218,1330537740,13,17,3,1330539420,1680,1437420,1974480,537060,19_19_19_19_19_19_1_1_1_1_1_1_13_13_2_2_3_13_13
5939,220,1330538460,0,0,0,1330576860,38400,194100,2714040,2519940,0_0_0_0_1_0_1_0_0_0_0_0_1_0_0_1_0_0_0
5940,17,1330539360,19,11,19,1330566480,27120,65580,626460,560880,19_19_1_19_19_1_19
5941,218,1330539420,3,17,15,1330939560,400140,1439100,1974480,535380,19_19_19_19_19_19_1_1_1_1_1_1_13_13_2_2_3_13_13_3
5942,76,1330540560,4,23,4,1330541100,540,4998960,7552500,2553540,3_3_3_3_3_3_3_3_3_18_3_18_18_18_18_18_3_3_3_1_1_3_17_17_17_18_17_17_18_18_18_18_18_17_17_18_3_3_18_17_18_18_17_18_18_17_17_17_5_5_5_5_1_1_17_17_17_2_2_17_17_17_5_5_5_5_5_5_17_17_5_5_5_17_5_5_5_5_5_17_17_17_1_1_1_1_1_1_1_1_2_2_34_34_5_5_5_5_6_6_3_3_4_3_3_4_4_4_4_4_3_3_3_3_3_3_4_3_3_3_3_4_4_4_3_4_4_4_3_4_4_4_3_3_4
5943,63,1330540620,18,23,3,1330552800,12180,3689160,6232860,2543700,16_16_16_16_16_16_16_16_16_0_0_16_16_0_16_16_0_16_16_0_0_16_16_16_0_0_16_0_0_16_0_16_0_0_0_16_1_1_1_16_16_16_0_1_1_1_16_0_0_16_16_0_16_0_16_0_0_2_2_1_1_0_0_0_0_2_2_2_2_2_2_0_1_0_1_1_0_0_0_1_1_0_0_1_1_1_0_0_0_0_0_2_2_2_2_0_0_0_0_0_0_1_1_1_1_0_0_16_0_16_16_16_16_16_0_0_1_1_2_2_1_1_16_0_2_16_2_2_2_0_1_1_1_1_1_16_16_1_1_1_3_3_18_3_18_3_3_3_3_3_18_18_18_18_3_3_3_3_18_18_18_18_18_18_18_5_5_5_18_5_18_18_18_18_18_5_5_5_18_18_18_5_6_6_5_5_5_5_3_5_18_3_3_3_18_16_18_16_5_18_18_6_3_6_18_3_18_18_5_5_18_5_5_5_5_5_5_5_5_5_18_3_5_3_18
5944,76,1330541100,4,23,4,1330548300,7200,4999500,7552500,2553000,3_3_3_3_3_3_3_3_3_18_3_18_18_18_18_18_3_3_3_1_1_3_17_17_17_18_17_17_18_18_18_18_18_17_17_18_3_3_18_17_18_18_17_18_18_17_17_17_5_5_5_5_1_1_17_17_17_2_2_17_17_17_5_5_5_5_5_5_17_17_5_5_5_17_5_5_5_5_5_17_17_17_1_1_1_1_1_1_1_1_2_2_34_34_5_5_5_5_6_6_3_3_4_3_3_4_4_4_4_4_3_3_3_3_3_3_4_3_3_3_3_4_4_4_3_4_4_4_3_4_4_4_3_3_4_4
5945,57,1330543500,26,13,26,1330543680,180,275760,2756640,2480880,26_26_26_26_26_26_26_26_26_26_26_26_26_26_26_26_26_26_26_26_26_26_26_26_26_8_8_8_8_2_2_26_8_8_26_26_26
5946,57,1330543500,26,13,26,1330543500,0,275760,2756640,2480880,26_26_26_26_26_26_26_26_26_26_26_26_26_26_26_26_26_26_26_26_26_26_26_26_26_8_8_8_8_2_2_26_8_8_26_26
5947,57,1330543680,26,32,26,1330547220,3540,275940,2756640,2480700,26_26_26_26_26_26_26_26_26_26_26_26_26_26_26_26_26_26_26_26_26_26_26_26_26_8_8_8_8_2_2_26_8_8_26_26_26_26
5948,204,1330545480,16,20,16,1330545540,60,12420,2567700,2555280,16_16
5949,204,1330545540,16,20,16,1330551840,6300,12480,2567700,2555220,16_16_16
5950,10,1330545900,9,22,9,1330549440,3540,247620,979740,732120,0_0_0_1_1_0_0_0_1_1_2_2_9_9_9
5951,57,1330547220,26,13,26,1330553520,6300,279480,2756640,2477160,26_26_26_26_26_26_26_26_26_26_26_26_26_26_26_26_26_26_26_26_26_26_26_26_26_8_8_8_8_2_2_26_8_8_26_26_26_26_26
5952,4,1330547220,10,13,10,1330553460,6240,193620,1326000,1132380,10_10_10_10_10_10_10_1_1_10_10_10_10_10_10_10_10_10_10_1_10_1_10_1_1_10_10_10_10
5953,76,1330548300,4,23,4,1330577220,28920,5006700,7552500,2545800,3_3_3_3_3_3_3_3_3_18_3_18_18_18_18_18_3_3_3_1_1_3_17_17_17_18_17_17_18_18_18_18_18_17_17_18_3_3_18_17_18_18_17_18_18_17_17_17_5_5_5_5_1_1_17_17_17_2_2_17_17_17_5_5_5_5_5_5_17_17_5_5_5_17_5_5_5_5_5_17_17_17_1_1_1_1_1_1_1_1_2_2_34_34_5_5_5_5_6_6_3_3_4_3_3_4_4_4_4_4_3_3_3_3_3_3_4_3_3_3_3_4_4_4_3_4_4_4_3_4_4_4_3_3_4_4_4
5954,10,1330549440,9,22,3,1330562100,12660,251160,979740,728580,0_0_0_1_1_0_0_0_1_1_2_2_9_9_9_9
5955,155,1330549620,9,22,9,1330552560,2940,1959420,3225180,1265760,0_0_0_0_0_0_0_0_1_1_1_1_2_2_9_9_9
5956,204,1330551840,16,20,16,1330553340,1500,18780,2567700,2548920,16_16_16_16
5957,155,1330552560,9,22,9,1330552800,240,1962360,3225180,1262820,0_0_0_0_0_0_0_0_1_1_1_1_2_2_9_9_9_9
5958,63,1330552800,3,4,3,1330557300,4500,3701340,6232860,2531520,16_16_16_16_16_16_16_16_16_0_0_16_16_0_16_16_0_16_16_0_0_16_16_16_0_0_16_0_0_16_0_16_0_0_0_16_1_1_1_16_16_16_0_1_1_1_16_0_0_16_16_0_16_0_16_0_0_2_2_1_1_0_0_0_0_2_2_2_2_2_2_0_1_0_1_1_0_0_0_1_1_0_0_1_1_1_0_0_0_0_0_2_2_2_2_0_0_0_0_0_0_1_1_1_1_0_0_16_0_16_16_16_16_16_0_0_1_1_2_2_1_1_16_0_2_16_2_2_2_0_1_1_1_1_1_16_16_1_1_1_3_3_18_3_18_3_3_3_3_3_18_18_18_18_3_3_3_3_18_18_18_18_18_18_18_5_5_5_18_5_18_18_18_18_18_5_5_5_18_18_18_5_6_6_5_5_5_5_3_5_18_3_3_3_18_16_18_16_5_18_18_6_3_6_18_3_18_18_5_5_18_5_5_5_5_5_5_5_5_5_18_3_5_3_18_3_3
5959,56,1330552800,6,7,6,1330556400,3600,4492800,6361440,1868640,6_6_5_5_8_8_8_8_26_26_5_5_6_6_5_5_5_5_5_5_6
5960,155,1330552800,9,4,9,1330557300,4500,1962600,3225180,1262580,0_0_0_0_0_0_0_0_1_1_1_1_2_2_9_9_9_9_9
5961,63,1330552800,3,4,3,1330552800,0,3701340,6232860,2531520,16_16_16_16_16_16_16_16_16_0_0_16_16_0_16_16_0_16_16_0_0_16_16_16_0_0_16_0_0_16_0_16_0_0_0_16_1_1_1_16_16_16_0_1_1_1_16_0_0_16_16_0_16_0_16_0_0_2_2_1_1_0_0_0_0_2_2_2_2_2_2_0_1_0_1_1_0_0_0_1_1_0_0_1_1_1_0_0_0_0_0_2_2_2_2_0_0_0_0_0_0_1_1_1_1_0_0_16_0_16_16_16_16_16_0_0_1_1_2_2_1_1_16_0_2_16_2_2_2_0_1_1_1_1_1_16_16_1_1_1_3_3_18_3_18_3_3_3_3_3_18_18_18_18_3_3_3_3_18_18_18_18_18_18_18_5_5_5_18_5_18_18_18_18_18_5_5_5_18_18_18_5_6_6_5_5_5_5_3_5_18_3_3_3_18_16_18_16_5_18_18_6_3_6_18_3_18_18_5_5_18_5_5_5_5_5_5_5_5_5_18_3_5_3_18_3
5962,204,1330553340,16,0,16,1330576860,23520,20280,2567700,2547420,16_16_16_16_16
5963,4,1330553460,10,13,1,1330587000,33540,199860,1326000,1126140,10_10_10_10_10_10_10_1_1_10_10_10_10_10_10_10_10_10_10_1_10_1_10_1_1_10_10_10_10_10
5964,57,1330553520,26,13,26,1330557000,3480,285780,2756640,2470860,26_26_26_26_26_26_26_26_26_26_26_26_26_26_26_26_26_26_26_26_26_26_26_26_26_8_8_8_8_2_2_26_8_8_26_26_26_26_26_26
5965,56,1330556400,6,7,5,1330585200,28800,4496400,6361440,1865040,6_6_5_5_8_8_8_8_26_26_5_5_6_6_5_5_5_5_5_5_6_6
5966,57,1330557000,26,32,26,1330557840,840,289260,2756640,2467380,26_26_26_26_26_26_26_26_26_26_26_26_26_26_26_26_26_26_26_26_26_26_26_26_26_8_8_8_8_2_2_26_8_8_26_26_26_26_26_26_26
5967,155,1330557300,9,4,9,1330812000,254700,1967100,3225180,1258080,0_0_0_0_0_0_0_0_1_1_1_1_2_2_9_9_9_9_9_9
5968,63,1330557300,3,4,18,1330567620,10320,3705840,6232860,2527020,16_16_16_16_16_16_16_16_16_0_0_16_16_0_16_16_0_16_16_0_0_16_16_16_0_0_16_0_0_16_0_16_0_0_0_16_1_1_1_16_16_16_0_1_1_1_16_0_0_16_16_0_16_0_16_0_0_2_2_1_1_0_0_0_0_2_2_2_2_2_2_0_1_0_1_1_0_0_0_1_1_0_0_1_1_1_0_0_0_0_0_2_2_2_2_0_0_0_0_0_0_1_1_1_1_0_0_16_0_16_16_16_16_16_0_0_1_1_2_2_1_1_16_0_2_16_2_2_2_0_1_1_1_1_1_16_16_1_1_1_3_3_18_3_18_3_3_3_3_3_18_18_18_18_3_3_3_3_18_18_18_18_18_18_18_5_5_5_18_5_18_18_18_18_18_5_5_5_18_18_18_5_6_6_5_5_5_5_3_5_18_3_3_3_18_16_18_16_5_18_18_6_3_6_18_3_18_18_5_5_18_5_5_5_5_5_5_5_5_5_18_3_5_3_18_3_3_3_3
5969,63,1330557300,3,4,3,1330557300,0,3705840,6232860,2527020,16_16_16_16_16_16_16_16_16_0_0_16_16_0_16_16_0_16_16_0_0_16_16_16_0_0_16_0_0_16_0_16_0_0_0_16_1_1_1_16_16_16_0_1_1_1_16_0_0_16_16_0_16_0_16_0_0_2_2_1_1_0_0_0_0_2_2_2_2_2_2_0_1_0_1_1_0_0_0_1_1_0_0_1_1_1_0_0_0_0_0_2_2_2_2_0_0_0_0_0_0_1_1_1_1_0_0_16_0_16_16_16_16_16_0_0_1_1_2_2_1_1_16_0_2_16_2_2_2_0_1_1_1_1_1_16_16_1_1_1_3_3_18_3_18_3_3_3_3_3_18_18_18_18_3_3_3_3_18_18_18_18_18_18_18_5_5_5_18_5_18_18_18_18_18_5_5_5_18_18_18_5_6_6_5_5_5_5_3_5_18_3_3_3_18_16_18_16_5_18_18_6_3_6_18_3_18_18_5_5_18_5_5_5_5_5_5_5_5_5_18_3_5_3_18_3_3_3
5970,54,1330557360,3,22,3,1330562040,4680,796560,1314000,517440,7_7_7_7_7_7_7_7_7_7_1_1_5_5_1_1_2_2_3
5971,57,1330557840,26,13,8,1330607040,49200,290100,2756640,2466540,26_26_26_26_26_26_26_26_26_26_26_26_26_26_26_26_26_26_26_26_26_26_26_26_26_8_8_8_8_2_2_26_8_8_26_26_26_26_26_26_26_26
5972,54,1330562040,3,22,5,1331033700,471660,801240,1314000,512760,7_7_7_7_7_7_7_7_7_7_1_1_5_5_1_1_2_2_3_3
5973,10,1330562100,3,22,3,1330562160,60,263820,979740,715920,0_0_0_1_1_0_0_0_1_1_2_2_9_9_9_9_3
5974,10,1330562160,3,22,3,1330565280,3120,263880,979740,715860,0_0_0_1_1_0_0_0_1_1_2_2_9_9_9_9_3_3
5975,10,1330565280,3,22,3,1330566600,1320,267000,979740,712740,0_0_0_1_1_0_0_0_1_1_2_2_9_9_9_9_3_3_3
5976,17,1330566480,19,11,1,1330898400,331920,92700,626460,533760,19_19_1_19_19_1_19_19
5977,13,1330566540,19,11,19,1330576500,9960,0,2525940,2525940,19
5978,10,1330566600,3,22,4,1331101800,535200,268320,979740,711420,0_0_0_1_1_0_0_0_1_1_2_2_9_9_9_9_3_3_3_3
5979,63,1330567620,18,23,18,1330568400,780,3716160,6232860,2516700,16_16_16_16_16_16_16_16_16_0_0_16_16_0_16_16_0_16_16_0_0_16_16_16_0_0_16_0_0_16_0_16_0_0_0_16_1_1_1_16_16_16_0_1_1_1_16_0_0_16_16_0_16_0_16_0_0_2_2_1_1_0_0_0_0_2_2_2_2_2_2_0_1_0_1_1_0_0_0_1_1_0_0_1_1_1_0_0_0_0_0_2_2_2_2_0_0_0_0_0_0_1_1_1_1_0_0_16_0_16_16_16_16_16_0_0_1_1_2_2_1_1_16_0_2_16_2_2_2_0_1_1_1_1_1_16_16_1_1_1_3_3_18_3_18_3_3_3_3_3_18_18_18_18_3_3_3_3_18_18_18_18_18_18_18_5_5_5_18_5_18_18_18_18_18_5_5_5_18_18_18_5_6_6_5_5_5_5_3_5_18_3_3_3_18_16_18_16_5_18_18_6_3_6_18_3_18_18_5_5_18_5_5_5_5_5_5_5_5_5_18_3_5_3_18_3_3_3_3_18
5980,63,1330568400,18,22,18,1330577160,8760,3716940,6232860,2515920,16_16_16_16_16_16_16_16_16_0_0_16_16_0_16_16_0_16_16_0_0_16_16_16_0_0_16_0_0_16_0_16_0_0_0_16_1_1_1_16_16_16_0_1_1_1_16_0_0_16_16_0_16_0_16_0_0_2_2_1_1_0_0_0_0_2_2_2_2_2_2_0_1_0_1_1_0_0_0_1_1_0_0_1_1_1_0_0_0_0_0_2_2_2_2_0_0_0_0_0_0_1_1_1_1_0_0_16_0_16_16_16_16_16_0_0_1_1_2_2_1_1_16_0_2_16_2_2_2_0_1_1_1_1_1_16_16_1_1_1_3_3_18_3_18_3_3_3_3_3_18_18_18_18_3_3_3_3_18_18_18_18_18_18_18_5_5_5_18_5_18_18_18_18_18_5_5_5_18_18_18_5_6_6_5_5_5_5_3_5_18_3_3_3_18_16_18_16_5_18_18_6_3_6_18_3_18_18_5_5_18_5_5_5_5_5_5_5_5_5_18_3_5_3_18_3_3_3_3_18_18
5981,13,1330576500,19,11,19,1330577820,1320,9960,2525940,2515980,19_19
5982,204,1330576860,16,0,16,1330577760,900,43800,2567700,2523900,16_16_16_16_16_16
5983,220,1330576860,0,0,0,1330577880,1020,232500,2714040,2481540,0_0_0_0_1_0_1_0_0_0_0_0_1_0_0_1_0_0_0_0
5984,63,1330577160,18,22,18,1330578120,960,3725700,6232860,2507160,16_16_16_16_16_16_16_16_16_0_0_16_16_0_16_16_0_16_16_0_0_16_16_16_0_0_16_0_0_16_0_16_0_0_0_16_1_1_1_16_16_16_0_1_1_1_16_0_0_16_16_0_16_0_16_0_0_2_2_1_1_0_0_0_0_2_2_2_2_2_2_0_1_0_1_1_0_0_0_1_1_0_0_1_1_1_0_0_0_0_0_2_2_2_2_0_0_0_0_0_0_1_1_1_1_0_0_16_0_16_16_16_16_16_0_0_1_1_2_2_1_1_16_0_2_16_2_2_2_0_1_1_1_1_1_16_16_1_1_1_3_3_18_3_18_3_3_3_3_3_18_18_18_18_3_3_3_3_18_18_18_18_18_18_18_5_5_5_18_5_18_18_18_18_18_5_5_5_18_18_18_5_6_6_5_5_5_5_3_5_18_3_3_3_18_16_18_16_5_18_18_6_3_6_18_3_18_18_5_5_18_5_5_5_5_5_5_5_5_5_18_3_5_3_18_3_3_3_3_18_18_18
5985,76,1330577220,4,23,5,1330578000,780,5035620,7552500,2516880,3_3_3_3_3_3_3_3_3_18_3_18_18_18_18_18_3_3_3_1_1_3_17_17_17_18_17_17_18_18_18_18_18_17_17_18_3_3_18_17_18_18_17_18_18_17_17_17_5_5_5_5_1_1_17_17_17_2_2_17_17_17_5_5_5_5_5_5_17_17_5_5_5_17_5_5_5_5_5_17_17_17_1_1_1_1_1_1_1_1_2_2_34_34_5_5_5_5_6_6_3_3_4_3_3_4_4_4_4_4_3_3_3_3_3_3_4_3_3_3_3_4_4_4_3_4_4_4_3_4_4_4_3_3_4_4_4_4
5986,204,1330577760,16,14,16,1330609620,31860,44700,2567700,2523000,16_16_16_16_16_16_16
5987,13,1330577820,19,14,1,1330588800,10980,11280,2525940,2514660,19_19_19
5988,220,1330577880,0,1,0,1330610760,32880,233520,2714040,2480520,0_0_0_0_1_0_1_0_0_0_0_0_1_0_0_1_0_0_0_0_0
5989,196,1330578000,7,12,7,1330578060,60,777300,3281700,2504400,7_7_7_7_7_7_7_7_7_7_7_7_7_7_7_7_7_7_7_7_1_1_1_1_7_7_1_1_7_7_1_1_7_7_7_1_1_7_7_7_7_7_7
5990,154,1330578000,16,1,1,1330604700,26700,86400,115500,29100,16_1_1_16_16_16_16_16_16
5991,76,1330578000,5,2,3,1330580040,2040,5036400,7552500,2516100,3_3_3_3_3_3_3_3_3_18_3_18_18_18_18_18_3_3_3_1_1_3_17_17_17_18_17_17_18_18_18_18_18_17_17_18_3_3_18_17_18_18_17_18_18_17_17_17_5_5_5_5_1_1_17_17_17_2_2_17_17_17_5_5_5_5_5_5_17_17_5_5_5_17_5_5_5_5_5_17_17_17_1_1_1_1_1_1_1_1_2_2_34_34_5_5_5_5_6_6_3_3_4_3_3_4_4_4_4_4_3_3_3_3_3_3_4_3_3_3_3_4_4_4_3_4_4_4_3_4_4_4_3_3_4_4_4_4_5
5992,196,1330578060,7,12,7,1330591620,13560,777360,3281700,2504340,7_7_7_7_7_7_7_7_7_7_7_7_7_7_7_7_7_7_7_7_1_1_1_1_7_7_1_1_7_7_1_1_7_7_7_1_1_7_7_7_7_7_7_7
5993,63,1330578120,18,19,3,1330586640,8520,3726660,6232860,2506200,16_16_16_16_16_16_16_16_16_0_0_16_16_0_16_16_0_16_16_0_0_16_16_16_0_0_16_0_0_16_0_16_0_0_0_16_1_1_1_16_16_16_0_1_1_1_16_0_0_16_16_0_16_0_16_0_0_2_2_1_1_0_0_0_0_2_2_2_2_2_2_0_1_0_1_1_0_0_0_1_1_0_0_1_1_1_0_0_0_0_0_2_2_2_2_0_0_0_0_0_0_1_1_1_1_0_0_16_0_16_16_16_16_16_0_0_1_1_2_2_1_1_16_0_2_16_2_2_2_0_1_1_1_1_1_16_16_1_1_1_3_3_18_3_18_3_3_3_3_3_18_18_18_18_3_3_3_3_18_18_18_18_18_18_18_5_5_5_18_5_18_18_18_18_18_5_5_5_18_18_18_5_6_6_5_5_5_5_3_5_18_3_3_3_18_16_18_16_5_18_18_6_3_6_18_3_18_18_5_5_18_5_5_5_5_5_5_5_5_5_18_3_5_3_18_3_3_3_3_18_18_18_18
5994,169,1330578180,1,18,1,1330584000,5820,916440,2190660,1274220,50_50_50_50_50_50_50_50_50_50_50_50_50_50_50_50_50_1_1_50_50_50_50_1_1_50_50_50_50_50_50_50_50_1_1_50_3_3_50_2_50_2_50_50_50_6_6_3_3_50_5_2_2_2_2_5_50_50_1
5995,174,1330579140,10,16,1,1330607100,27960,0,1300440,1300440,10
5996,76,1330580040,3,4,3,1330583820,3780,5038440,7552500,2514060,3_3_3_3_3_3_3_3_3_18_3_18_18_18_18_18_3_3_3_1_1_3_17_17_17_18_17_17_18_18_18_18_18_17_17_18_3_3_18_17_18_18_17_18_18_17_17_17_5_5_5_5_1_1_17_17_17_2_2_17_17_17_5_5_5_5_5_5_17_17_5_5_5_17_5_5_5_5_5_17_17_17_1_1_1_1_1_1_1_1_2_2_34_34_5_5_5_5_6_6_3_3_4_3_3_4_4_4_4_4_3_3_3_3_3_3_4_3_3_3_3_4_4_4_3_4_4_4_3_4_4_4_3_3_4_4_4_4_5_3
5997,76,1330583820,3,4,5,1330584000,180,5042220,7552500,2510280,3_3_3_3_3_3_3_3_3_18_3_18_18_18_18_18_3_3_3_1_1_3_17_17_17_18_17_17_18_18_18_18_18_17_17_18_3_3_18_17_18_18_17_18_18_17_17_17_5_5_5_5_1_1_17_17_17_2_2_17_17_17_5_5_5_5_5_5_17_17_5_5_5_17_5_5_5_5_5_17_17_17_1_1_1_1_1_1_1_1_2_2_34_34_5_5_5_5_6_6_3_3_4_3_3_4_4_4_4_4_3_3_3_3_3_3_4_3_3_3_3_4_4_4_3_4_4_4_3_4_4_4_3_3_4_4_4_4_5_3_3
5998,76,1330584000,5,2,5,1330585200,1200,5042400,7552500,2510100,3_3_3_3_3_3_3_3_3_18_3_18_18_18_18_18_3_3_3_1_1_3_17_17_17_18_17_17_18_18_18_18_18_17_17_18_3_3_18_17_18_18_17_18_18_17_17_17_5_5_5_5_1_1_17_17_17_2_2_17_17_17_5_5_5_5_5_5_17_17_5_5_5_17_5_5_5_5_5_17_17_17_1_1_1_1_1_1_1_1_2_2_34_34_5_5_5_5_6_6_3_3_4_3_3_4_4_4_4_4_3_3_3_3_3_3_4_3_3_3_3_4_4_4_3_4_4_4_3_4_4_4_3_3_4_4_4_4_5_3_3_5
5999,169,1330584000,1,18,2,1330854240,270240,922260,2190660,1268400,50_50_50_50_50_50_50_50_50_50_50_50_50_50_50_50_50_1_1_50_50_50_50_1_1_50_50_50_50_50_50_50_50_1_1_50_3_3_50_2_50_2_50_50_50_6_6_3_3_50_5_2_2_2_2_5_50_50_1_1
6000,76,1330585200,5,2,5,1330588800,3600,5043600,7552500,2508900,3_3_3_3_3_3_3_3_3_18_3_18_18_18_18_18_3_3_3_1_1_3_17_17_17_18_17_17_18_18_18_18_18_17_17_18_3_3_18_17_18_18_17_18_18_17_17_17_5_5_5_5_1_1_17_17_17_2_2_17_17_17_5_5_5_5_5_5_17_17_5_5_5_17_5_5_5_5_5_17_17_17_1_1_1_1_1_1_1_1_2_2_34_34_5_5_5_5_6_6_3_3_4_3_3_4_4_4_4_4_3_3_3_3_3_3_4_3_3_3_3_4_4_4_3_4_4_4_3_4_4_4_3_3_4_4_4_4_5_3_3_5_5
6001,56,1330585200,5,18,5,1330587000,1800,4525200,6361440,1836240,6_6_5_5_8_8_8_8_26_26_5_5_6_6_5_5_5_5_5_5_6_6_5
6002,63,1330586640,3,3,5,1330600800,14160,3735180,6232860,2497680,16_16_16_16_16_16_16_16_16_0_0_16_16_0_16_16_0_16_16_0_0_16_16_16_0_0_16_0_0_16_0_16_0_0_0_16_1_1_1_16_16_16_0_1_1_1_16_0_0_16_16_0_16_0_16_0_0_2_2_1_1_0_0_0_0_2_2_2_2_2_2_0_1_0_1_1_0_0_0_1_1_0_0_1_1_1_0_0_0_0_0_2_2_2_2_0_0_0_0_0_0_1_1_1_1_0_0_16_0_16_16_16_16_16_0_0_1_1_2_2_1_1_16_0_2_16_2_2_2_0_1_1_1_1_1_16_16_1_1_1_3_3_18_3_18_3_3_3_3_3_18_18_18_18_3_3_3_3_18_18_18_18_18_18_18_5_5_5_18_5_18_18_18_18_18_5_5_5_18_18_18_5_6_6_5_5_5_5_3_5_18_3_3_3_18_16_18_16_5_18_18_6_3_6_18_3_18_18_5_5_18_5_5_5_5_5_5_5_5_5_18_3_5_3_18_3_3_3_3_18_18_18_18_3
6003,4,1330587000,1,18,1,1330591740,4740,233400,1326000,1092600,10_10_10_10_10_10_10_1_1_10_10_10_10_10_10_10_10_10_10_1_10_1_10_1_1_10_10_10_10_10_1
6004,56,1330587000,5,18,5,1332419400,1832400,4527000,6361440,1834440,6_6_5_5_8_8_8_8_26_26_5_5_6_6_5_5_5_5_5_5_6_6_5_5
6005,13,1330588800,1,2,1,1330592400,3600,22260,2525940,2503680,19_19_19_1
6006,76,1330588800,5,2,5,1330592400,3600,5047200,7552500,2505300,3_3_3_3_3_3_3_3_3_18_3_18_18_18_18_18_3_3_3_1_1_3_17_17_17_18_17_17_18_18_18_18_18_17_17_18_3_3_18_17_18_18_17_18_18_17_17_17_5_5_5_5_1_1_17_17_17_2_2_17_17_17_5_5_5_5_5_5_17_17_5_5_5_17_5_5_5_5_5_17_17_17_1_1_1_1_1_1_1_1_2_2_34_34_5_5_5_5_6_6_3_3_4_3_3_4_4_4_4_4_3_3_3_3_3_3_4_3_3_3_3_4_4_4_3_4_4_4_3_4_4_4_3_3_4_4_4_4_5_3_3_5_5_5
6007,196,1330591620,7,12,7,1330609440,17820,790920,3281700,2490780,7_7_7_7_7_7_7_7_7_7_7_7_7_7_7_7_7_7_7_7_1_1_1_1_7_7_1_1_7_7_1_1_7_7_7_1_1_7_7_7_7_7_7_7_7
6008,4,1330591740,1,18,1,1330984800,393060,238140,1326000,1087860,10_10_10_10_10_10_10_1_1_10_10_10_10_10_10_10_10_10_10_1_10_1_10_1_1_10_10_10_10_10_1_1
6009,107,1330591860,1,18,1,1330606800,14940,2665260,4991760,2326500,8_8_8_8_28_28_28_28_28_28_8_8_8_8_16_16_16_16_16_1_16_16_16_1_16_16_16_16_1_16_1_16_16_16_16_16_16_16_1_16_1_16_16_16_16_16_1_1_16_16_16_1_1_16_16_16_16_16_16_16_16_16_1_1_1
6010,13,1330592400,1,2,19,1330598160,5760,25860,2525940,2500080,19_19_19_1_1
6011,76,1330592400,5,2,5,1330599000,6600,5050800,7552500,2501700,3_3_3_3_3_3_3_3_3_18_3_18_18_18_18_18_3_3_3_1_1_3_17_17_17_18_17_17_18_18_18_18_18_17_17_18_3_3_18_17_18_18_17_18_18_17_17_17_5_5_5_5_1_1_17_17_17_2_2_17_17_17_5_5_5_5_5_5_17_17_5_5_5_17_5_5_5_5_5_17_17_17_1_1_1_1_1_1_1_1_2_2_34_34_5_5_5_5_6_6_3_3_4_3_3_4_4_4_4_4_3_3_3_3_3_3_4_3_3_3_3_4_4_4_3_4_4_4_3_4_4_4_3_3_4_4_4_4_5_3_3_5_5_5_5
6012,191,1330595460,3,3,3,1330603080,7620,955980,1811280,855300,26_26_26_26_8_8_9_9_3
6013,13,1330598160,19,14,19,1330598220,60,31620,2525940,2494320,19_19_19_1_1_19
6014,13,1330598220,19,14,19,1330609560,11340,31680,2525940,2494260,19_19_19_1_1_19_19
6015,76,1330599000,5,2,4,1330607940,8940,5057400,7552500,2495100,3_3_3_3_3_3_3_3_3_18_3_18_18_18_18_18_3_3_3_1_1_3_17_17_17_18_17_17_18_18_18_18_18_17_17_18_3_3_18_17_18_18_17_18_18_17_17_17_5_5_5_5_1_1_17_17_17_2_2_17_17_17_5_5_5_5_5_5_17_17_5_5_5_17_5_5_5_5_5_17_17_17_1_1_1_1_1_1_1_1_2_2_34_34_5_5_5_5_6_6_3_3_4_3_3_4_4_4_4_4_3_3_3_3_3_3_4_3_3_3_3_4_4_4_3_4_4_4_3_4_4_4_3_3_4_4_4_4_5_3_3_5_5_5_5_5
6016,63,1330600800,5,2,5,1330604700,3900,3749340,6232860,2483520,16_16_16_16_16_16_16_16_16_0_0_16_16_0_16_16_0_16_16_0_0_16_16_16_0_0_16_0_0_16_0_16_0_0_0_16_1_1_1_16_16_16_0_1_1_1_16_0_0_16_16_0_16_0_16_0_0_2_2_1_1_0_0_0_0_2_2_2_2_2_2_0_1_0_1_1_0_0_0_1_1_0_0_1_1_1_0_0_0_0_0_2_2_2_2_0_0_0_0_0_0_1_1_1_1_0_0_16_0_16_16_16_16_16_0_0_1_1_2_2_1_1_16_0_2_16_2_2_2_0_1_1_1_1_1_16_16_1_1_1_3_3_18_3_18_3_3_3_3_3_18_18_18_18_3_3_3_3_18_18_18_18_18_18_18_5_5_5_18_5_18_18_18_18_18_5_5_5_18_18_18_5_6_6_5_5_5_5_3_5_18_3_3_3_18_16_18_16_5_18_18_6_3_6_18_3_18_18_5_5_18_5_5_5_5_5_5_5_5_5_18_3_5_3_18_3_3_3_3_18_18_18_18_3_5
6017,191,1330603080,3,3,28,1331173800,570720,963600,1811280,847680,26_26_26_26_8_8_9_9_3_3
6018,46,1330603080,3,3,3,1330605780,2700,1184040,2027040,843000,26_26_26_26_26_26_26_26_8_8_9_9_3
6019,63,1330604700,5,2,18,1330610220,5520,3753240,6232860,2479620,16_16_16_16_16_16_16_16_16_0_0_16_16_0_16_16_0_16_16_0_0_16_16_16_0_0_16_0_0_16_0_16_0_0_0_16_1_1_1_16_16_16_0_1_1_1_16_0_0_16_16_0_16_0_16_0_0_2_2_1_1_0_0_0_0_2_2_2_2_2_2_0_1_0_1_1_0_0_0_1_1_0_0_1_1_1_0_0_0_0_0_2_2_2_2_0_0_0_0_0_0_1_1_1_1_0_0_16_0_16_16_16_16_16_0_0_1_1_2_2_1_1_16_0_2_16_2_2_2_0_1_1_1_1_1_16_16_1_1_1_3_3_18_3_18_3_3_3_3_3_18_18_18_18_3_3_3_3_18_18_18_18_18_18_18_5_5_5_18_5_18_18_18_18_18_5_5_5_18_18_18_5_6_6_5_5_5_5_3_5_18_3_3_3_18_16_18_16_5_18_18_6_3_6_18_3_18_18_5_5_18_5_5_5_5_5_5_5_5_5_18_3_5_3_18_3_3_3_3_18_18_18_18_3_5_5
6020,154,1330604700,1,2,16,1330605900,1200,113100,115500,2400,16_1_1_16_16_16_16_16_16_1
6021,46,1330605780,3,3,5,1330845900,240120,1186740,2027040,840300,26_26_26_26_26_26_26_26_8_8_9_9_3_3
6022,154,1330605900,16,1,1,1330607100,1200,114300,115500,1200,16_1_1_16_16_16_16_16_16_1_16
6023,107,1330606800,1,18,1,1330837200,230400,2680200,4991760,2311560,8_8_8_8_28_28_28_28_28_28_8_8_8_8_16_16_16_16_16_1_16_16_16_1_16_16_16_16_1_16_1_16_16_16_16_16_16_16_1_16_1_16_16_16_16_16_1_1_16_16_16_1_1_16_16_16_16_16_16_16_16_16_1_1_1_1
6024,57,1330607040,8,18,8,1330610460,3420,339300,2756640,2417340,26_26_26_26_26_26_26_26_26_26_26_26_26_26_26_26_26_26_26_26_26_26_26_26_26_8_8_8_8_2_2_26_8_8_26_26_26_26_26_26_26_26_8
6025,174,1330607100,1,2,10,1330610400,3300,27960,1300440,1272480,10_1
6026,154,1330607100,1,2,99,1330607100,0,115500,115500,0,16_1_1_16_16_16_16_16_16_1_16_1
6027,76,1330607940,4,19,5,1330611000,3060,5066340,7552500,2486160,3_3_3_3_3_3_3_3_3_18_3_18_18_18_18_18_3_3_3_1_1_3_17_17_17_18_17_17_18_18_18_18_18_17_17_18_3_3_18_17_18_18_17_18_18_17_17_17_5_5_5_5_1_1_17_17_17_2_2_17_17_17_5_5_5_5_5_5_17_17_5_5_5_17_5_5_5_5_5_17_17_17_1_1_1_1_1_1_1_1_2_2_34_34_5_5_5_5_6_6_3_3_4_3_3_4_4_4_4_4_3_3_3_3_3_3_4_3_3_3_3_4_4_4_3_4_4_4_3_4_4_4_3_3_4_4_4_4_5_3_3_5_5_5_5_5_4
6028,196,1330609440,7,12,1,1330844400,234960,808740,3281700,2472960,7_7_7_7_7_7_7_7_7_7_7_7_7_7_7_7_7_7_7_7_1_1_1_1_7_7_1_1_7_7_1_1_7_7_7_1_1_7_7_7_7_7_7_7_7_7
6029,13,1330609560,19,14,19,1330625760,16200,43020,2525940,2482920,19_19_19_1_1_19_19_19
6030,204,1330609620,16,14,16,1330611300,1680,76560,2567700,2491140,16_16_16_16_16_16_16_16
6031,210,1330609620,14,17,14,1330620240,10620,622980,1118160,495180,10_10_10_10_10_10_10_10_10_10_1_1_10_10_1_1_2_2_9_9_14
6032,63,1330610220,18,19,3,1330613160,2940,3758760,6232860,2474100,16_16_16_16_16_16_16_16_16_0_0_16_16_0_16_16_0_16_16_0_0_16_16_16_0_0_16_0_0_16_0_16_0_0_0_16_1_1_1_16_16_16_0_1_1_1_16_0_0_16_16_0_16_0_16_0_0_2_2_1_1_0_0_0_0_2_2_2_2_2_2_0_1_0_1_1_0_0_0_1_1_0_0_1_1_1_0_0_0_0_0_2_2_2_2_0_0_0_0_0_0_1_1_1_1_0_0_16_0_16_16_16_16_16_0_0_1_1_2_2_1_1_16_0_2_16_2_2_2_0_1_1_1_1_1_16_16_1_1_1_3_3_18_3_18_3_3_3_3_3_18_18_18_18_3_3_3_3_18_18_18_18_18_18_18_5_5_5_18_5_18_18_18_18_18_5_5_5_18_18_18_5_6_6_5_5_5_5_3_5_18_3_3_3_18_16_18_16_5_18_18_6_3_6_18_3_18_18_5_5_18_5_5_5_5_5_5_5_5_5_18_3_5_3_18_3_3_3_3_18_18_18_18_3_5_5_18
6033,174,1330610400,10,16,1,1330611000,600,31260,1300440,1269180,10_1_10
6034,57,1330610460,8,18,26,1330644240,33780,342720,2756640,2413920,26_26_26_26_26_26_26_26_26_26_26_26_26_26_26_26_26_26_26_26_26_26_26_26_26_8_8_8_8_2_2_26_8_8_26_26_26_26_26_26_26_26_8_8
6035,220,1330610760,0,1,0,1330625940,15180,266400,2714040,2447640,0_0_0_0_1_0_1_0_0_0_0_0_1_0_0_1_0_0_0_0_0_0
6036,174,1330611000,1,2,10,1330669920,58920,31860,1300440,1268580,10_1_10_1
6037,76,1330611000,5,2,4,1330611060,60,5069400,7552500,2483100,3_3_3_3_3_3_3_3_3_18_3_18_18_18_18_18_3_3_3_1_1_3_17_17_17_18_17_17_18_18_18_18_18_17_17_18_3_3_18_17_18_18_17_18_18_17_17_17_5_5_5_5_1_1_17_17_17_2_2_17_17_17_5_5_5_5_5_5_17_17_5_5_5_17_5_5_5_5_5_17_17_17_1_1_1_1_1_1_1_1_2_2_34_34_5_5_5_5_6_6_3_3_4_3_3_4_4_4_4_4_3_3_3_3_3_3_4_3_3_3_3_4_4_4_3_4_4_4_3_4_4_4_3_3_4_4_4_4_5_3_3_5_5_5_5_5_4_5
6038,76,1330611060,4,19,5,1330617780,6720,5069460,7552500,2483040,3_3_3_3_3_3_3_3_3_18_3_18_18_18_18_18_3_3_3_1_1_3_17_17_17_18_17_17_18_18_18_18_18_17_17_18_3_3_18_17_18_18_17_18_18_17_17_17_5_5_5_5_1_1_17_17_17_2_2_17_17_17_5_5_5_5_5_5_17_17_5_5_5_17_5_5_5_5_5_17_17_17_1_1_1_1_1_1_1_1_2_2_34_34_5_5_5_5_6_6_3_3_4_3_3_4_4_4_4_4_3_3_3_3_3_3_4_3_3_3_3_4_4_4_3_4_4_4_3_4_4_4_3_3_4_4_4_4_5_3_3_5_5_5_5_5_4_5_4
6039,204,1330611300,16,20,16,1330622400,11100,78240,2567700,2489460,16_16_16_16_16_16_16_16_16
6040,63,1330613160,3,3,18,1330627860,14700,3761700,6232860,2471160,16_16_16_16_16_16_16_16_16_0_0_16_16_0_16_16_0_16_16_0_0_16_16_16_0_0_16_0_0_16_0_16_0_0_0_16_1_1_1_16_16_16_0_1_1_1_16_0_0_16_16_0_16_0_16_0_0_2_2_1_1_0_0_0_0_2_2_2_2_2_2_0_1_0_1_1_0_0_0_1_1_0_0_1_1_1_0_0_0_0_0_2_2_2_2_0_0_0_0_0_0_1_1_1_1_0_0_16_0_16_16_16_16_16_0_0_1_1_2_2_1_1_16_0_2_16_2_2_2_0_1_1_1_1_1_16_16_1_1_1_3_3_18_3_18_3_3_3_3_3_18_18_18_18_3_3_3_3_18_18_18_18_18_18_18_5_5_5_18_5_18_18_18_18_18_5_5_5_18_18_18_5_6_6_5_5_5_5_3_5_18_3_3_3_18_16_18_16_5_18_18_6_3_6_18_3_18_18_5_5_18_5_5_5_5_5_5_5_5_5_18_3_5_3_18_3_3_3_3_18_18_18_18_3_5_5_18_3
6041,76,1330617780,5,2,4,1330627800,10020,5076180,7552500,2476320,3_3_3_3_3_3_3_3_3_18_3_18_18_18_18_18_3_3_3_1_1_3_17_17_17_18_17_17_18_18_18_18_18_17_17_18_3_3_18_17_18_18_17_18_18_17_17_17_5_5_5_5_1_1_17_17_17_2_2_17_17_17_5_5_5_5_5_5_17_17_5_5_5_17_5_5_5_5_5_17_17_17_1_1_1_1_1_1_1_1_2_2_34_34_5_5_5_5_6_6_3_3_4_3_3_4_4_4_4_4_3_3_3_3_3_3_4_3_3_3_3_4_4_4_3_4_4_4_3_4_4_4_3_3_4_4_4_4_5_3_3_5_5_5_5_5_4_5_4_5
6042,210,1330620240,14,17,14,1330636860,16620,633600,1118160,484560,10_10_10_10_10_10_10_10_10_10_1_1_10_10_1_1_2_2_9_9_14_14_14
6043,210,1330620240,14,17,14,1330620240,0,633600,1118160,484560,10_10_10_10_10_10_10_10_10_10_1_1_10_10_1_1_2_2_9_9_14_14
6044,204,1330622400,16,20,16,1330626120,3720,89340,2567700,2478360,16_16_16_16_16_16_16_16_16_16
6045,13,1330625760,19,11,19,1330662420,36660,59220,2525940,2466720,19_19_19_1_1_19_19_19_19
6046,220,1330625940,0,0,0,1330663440,37500,281580,2714040,2432460,0_0_0_0_1_0_1_0_0_0_0_0_1_0_0_1_0_0_0_0_0_0_0
6047,204,1330626120,16,20,16,1330637760,11640,93060,2567700,2474640,16_16_16_16_16_16_16_16_16_16_16
6048,76,1330627800,4,23,3,1330639200,11400,5086200,7552500,2466300,3_3_3_3_3_3_3_3_3_18_3_18_18_18_18_18_3_3_3_1_1_3_17_17_17_18_17_17_18_18_18_18_18_17_17_18_3_3_18_17_18_18_17_18_18_17_17_17_5_5_5_5_1_1_17_17_17_2_2_17_17_17_5_5_5_5_5_5_17_17_5_5_5_17_5_5_5_5_5_17_17_17_1_1_1_1_1_1_1_1_2_2_34_34_5_5_5_5_6_6_3_3_4_3_3_4_4_4_4_4_3_3_3_3_3_3_4_3_3_3_3_4_4_4_3_4_4_4_3_4_4_4_3_3_4_4_4_4_5_3_3_5_5_5_5_5_4_5_4_5_4
6049,63,1330627860,18,23,6,1330639200,11340,3776400,6232860,2456460,16_16_16_16_16_16_16_16_16_0_0_16_16_0_16_16_0_16_16_0_0_16_16_16_0_0_16_0_0_16_0_16_0_0_0_16_1_1_1_16_16_16_0_1_1_1_16_0_0_16_16_0_16_0_16_0_0_2_2_1_1_0_0_0_0_2_2_2_2_2_2_0_1_0_1_1_0_0_0_1_1_0_0_1_1_1_0_0_0_0_0_2_2_2_2_0_0_0_0_0_0_1_1_1_1_0_0_16_0_16_16_16_16_16_0_0_1_1_2_2_1_1_16_0_2_16_2_2_2_0_1_1_1_1_1_16_16_1_1_1_3_3_18_3_18_3_3_3_3_3_18_18_18_18_3_3_3_3_18_18_18_18_18_18_18_5_5_5_18_5_18_18_18_18_18_5_5_5_18_18_18_5_6_6_5_5_5_5_3_5_18_3_3_3_18_16_18_16_5_18_18_6_3_6_18_3_18_18_5_5_18_5_5_5_5_5_5_5_5_5_18_3_5_3_18_3_3_3_3_18_18_18_18_3_5_5_18_3_18
6050,210,1330636860,14,17,5,1330853880,217020,650220,1118160,467940,10_10_10_10_10_10_10_10_10_10_1_1_10_10_1_1_2_2_9_9_14_14_14_14
6051,204,1330637760,16,20,16,1330639800,2040,104700,2567700,2463000,16_16_16_16_16_16_16_16_16_16_16_16
6052,63,1330639200,3,4,6,1330642800,3600,3787740,6232860,2445120,16_16_16_16_16_16_16_16_16_0_0_16_16_0_16_16_0_16_16_0_0_16_16_16_0_0_16_0_0_16_0_16_0_0_0_16_1_1_1_16_16_16_0_1_1_1_16_0_0_16_16_0_16_0_16_0_0_2_2_1_1_0_0_0_0_2_2_2_2_2_2_0_1_0_1_1_0_0_0_1_1_0_0_1_1_1_0_0_0_0_0_2_2_2_2_0_0_0_0_0_0_1_1_1_1_0_0_16_0_16_16_16_16_16_0_0_1_1_2_2_1_1_16_0_2_16_2_2_2_0_1_1_1_1_1_16_16_1_1_1_3_3_18_3_18_3_3_3_3_3_18_18_18_18_3_3_3_3_18_18_18_18_18_18_18_5_5_5_18_5_18_18_18_18_18_5_5_5_18_18_18_5_6_6_5_5_5_5_3_5_18_3_3_3_18_16_18_16_5_18_18_6_3_6_18_3_18_18_5_5_18_5_5_5_5_5_5_5_5_5_18_3_5_3_18_3_3_3_3_18_18_18_18_3_5_5_18_3_18_6_3
6053,76,1330639200,3,4,3,1330643700,4500,5097600,7552500,2454900,3_3_3_3_3_3_3_3_3_18_3_18_18_18_18_18_3_3_3_1_1_3_17_17_17_18_17_17_18_18_18_18_18_17_17_18_3_3_18_17_18_18_17_18_18_17_17_17_5_5_5_5_1_1_17_17_17_2_2_17_17_17_5_5_5_5_5_5_17_17_5_5_5_17_5_5_5_5_5_17_17_17_1_1_1_1_1_1_1_1_2_2_34_34_5_5_5_5_6_6_3_3_4_3_3_4_4_4_4_4_3_3_3_3_3_3_4_3_3_3_3_4_4_4_3_4_4_4_3_4_4_4_3_3_4_4_4_4_5_3_3_5_5_5_5_5_4_5_4_5_4_3_3
6054,76,1330639200,3,4,3,1330639200,0,5097600,7552500,2454900,3_3_3_3_3_3_3_3_3_18_3_18_18_18_18_18_3_3_3_1_1_3_17_17_17_18_17_17_18_18_18_18_18_17_17_18_3_3_18_17_18_18_17_18_18_17_17_17_5_5_5_5_1_1_17_17_17_2_2_17_17_17_5_5_5_5_5_5_17_17_5_5_5_17_5_5_5_5_5_17_17_17_1_1_1_1_1_1_1_1_2_2_34_34_5_5_5_5_6_6_3_3_4_3_3_4_4_4_4_4_3_3_3_3_3_3_4_3_3_3_3_4_4_4_3_4_4_4_3_4_4_4_3_3_4_4_4_4_5_3_3_5_5_5_5_5_4_5_4_5_4_3
6055,63,1330639200,6,7,3,1330639200,0,3787740,6232860,2445120,16_16_16_16_16_16_16_16_16_0_0_16_16_0_16_16_0_16_16_0_0_16_16_16_0_0_16_0_0_16_0_16_0_0_0_16_1_1_1_16_16_16_0_1_1_1_16_0_0_16_16_0_16_0_16_0_0_2_2_1_1_0_0_0_0_2_2_2_2_2_2_0_1_0_1_1_0_0_0_1_1_0_0_1_1_1_0_0_0_0_0_2_2_2_2_0_0_0_0_0_0_1_1_1_1_0_0_16_0_16_16_16_16_16_0_0_1_1_2_2_1_1_16_0_2_16_2_2_2_0_1_1_1_1_1_16_16_1_1_1_3_3_18_3_18_3_3_3_3_3_18_18_18_18_3_3_3_3_18_18_18_18_18_18_18_5_5_5_18_5_18_18_18_18_18_5_5_5_18_18_18_5_6_6_5_5_5_5_3_5_18_3_3_3_18_16_18_16_5_18_18_6_3_6_18_3_18_18_5_5_18_5_5_5_5_5_5_5_5_5_18_3_5_3_18_3_3_3_3_18_18_18_18_3_5_5_18_3_18_6
6056,204,1330639800,16,11,16,1330653480,13680,106740,2567700,2460960,16_16_16_16_16_16_16_16_16_16_16_16_16
6057,63,1330642800,6,7,3,1330643700,900,3791340,6232860,2441520,16_16_16_16_16_16_16_16_16_0_0_16_16_0_16_16_0_16_16_0_0_16_16_16_0_0_16_0_0_16_0_16_0_0_0_16_1_1_1_16_16_16_0_1_1_1_16_0_0_16_16_0_16_0_16_0_0_2_2_1_1_0_0_0_0_2_2_2_2_2_2_0_1_0_1_1_0_0_0_1_1_0_0_1_1_1_0_0_0_0_0_2_2_2_2_0_0_0_0_0_0_1_1_1_1_0_0_16_0_16_16_16_16_16_0_0_1_1_2_2_1_1_16_0_2_16_2_2_2_0_1_1_1_1_1_16_16_1_1_1_3_3_18_3_18_3_3_3_3_3_18_18_18_18_3_3_3_3_18_18_18_18_18_18_18_5_5_5_18_5_18_18_18_18_18_5_5_5_18_18_18_5_6_6_5_5_5_5_3_5_18_3_3_3_18_16_18_16_5_18_18_6_3_6_18_3_18_18_5_5_18_5_5_5_5_5_5_5_5_5_18_3_5_3_18_3_3_3_3_18_18_18_18_3_5_5_18_3_18_6_3_6
6058,76,1330643700,3,4,4,1330662840,19140,5102100,7552500,2450400,3_3_3_3_3_3_3_3_3_18_3_18_18_18_18_18_3_3_3_1_1_3_17_17_17_18_17_17_18_18_18_18_18_17_17_18_3_3_18_17_18_18_17_18_18_17_17_17_5_5_5_5_1_1_17_17_17_2_2_17_17_17_5_5_5_5_5_5_17_17_5_5_5_17_5_5_5_5_5_17_17_17_1_1_1_1_1_1_1_1_2_2_34_34_5_5_5_5_6_6_3_3_4_3_3_4_4_4_4_4_3_3_3_3_3_3_4_3_3_3_3_4_4_4_3_4_4_4_3_4_4_4_3_3_4_4_4_4_5_3_3_5_5_5_5_5_4_5_4_5_4_3_3_3_3
6059,76,1330643700,3,4,3,1330643700,0,5102100,7552500,2450400,3_3_3_3_3_3_3_3_3_18_3_18_18_18_18_18_3_3_3_1_1_3_17_17_17_18_17_17_18_18_18_18_18_17_17_18_3_3_18_17_18_18_17_18_18_17_17_17_5_5_5_5_1_1_17_17_17_2_2_17_17_17_5_5_5_5_5_5_17_17_5_5_5_17_5_5_5_5_5_17_17_17_1_1_1_1_1_1_1_1_2_2_34_34_5_5_5_5_6_6_3_3_4_3_3_4_4_4_4_4_3_3_3_3_3_3_4_3_3_3_3_4_4_4_3_4_4_4_3_4_4_4_3_3_4_4_4_4_5_3_3_5_5_5_5_5_4_5_4_5_4_3_3_3
6060,63,1330643700,3,4,18,1330662780,19080,3792240,6232860,2440620,16_16_16_16_16_16_16_16_16_0_0_16_16_0_16_16_0_16_16_0_0_16_16_16_0_0_16_0_0_16_0_16_0_0_0_16_1_1_1_16_16_16_0_1_1_1_16_0_0_16_16_0_16_0_16_0_0_2_2_1_1_0_0_0_0_2_2_2_2_2_2_0_1_0_1_1_0_0_0_1_1_0_0_1_1_1_0_0_0_0_0_2_2_2_2_0_0_0_0_0_0_1_1_1_1_0_0_16_0_16_16_16_16_16_0_0_1_1_2_2_1_1_16_0_2_16_2_2_2_0_1_1_1_1_1_16_16_1_1_1_3_3_18_3_18_3_3_3_3_3_18_18_18_18_3_3_3_3_18_18_18_18_18_18_18_5_5_5_18_5_18_18_18_18_18_5_5_5_18_18_18_5_6_6_5_5_5_5_3_5_18_3_3_3_18_16_18_16_5_18_18_6_3_6_18_3_18_18_5_5_18_5_5_5_5_5_5_5_5_5_18_3_5_3_18_3_3_3_3_18_18_18_18_3_5_5_18_3_18_6_3_6_3
6061,57,1330644240,26,32,26,1330644300,60,376500,2756640,2380140,26_26_26_26_26_26_26_26_26_26_26_26_26_26_26_26_26_26_26_26_26_26_26_26_26_8_8_8_8_2_2_26_8_8_26_26_26_26_26_26_26_26_8_8_26
6062,57,1330644300,26,13,26,1330646340,2040,376560,2756640,2380080,26_26_26_26_26_26_26_26_26_26_26_26_26_26_26_26_26_26_26_26_26_26_26_26_26_8_8_8_8_2_2_26_8_8_26_26_26_26_26_26_26_26_8_8_26_26
6063,57,1330646340,26,13,26,1330664400,18060,378600,2756640,2378040,26_26_26_26_26_26_26_26_26_26_26_26_26_26_26_26_26_26_26_26_26_26_26_26_26_8_8_8_8_2_2_26_8_8_26_26_26_26_26_26_26_26_8_8_26_26_26
6064,204,1330653480,16,11,16,1330653540,60,120420,2567700,2447280,16_16_16_16_16_16_16_16_16_16_16_16_16_16
6065,204,1330653540,16,11,16,1330662360,8820,120480,2567700,2447220,16_16_16_16_16_16_16_16_16_16_16_16_16_16_16
6066,204,1330662360,16,11,16,1330685040,22680,129300,2567700,2438400,16_16_16_16_16_16_16_16_16_16_16_16_16_16_16_16
6067,13,1330662420,19,11,19,1330663500,1080,95880,2525940,2430060,19_19_19_1_1_19_19_19_19_19
6068,63,1330662780,18,23,3,1330679700,16920,3811320,6232860,2421540,16_16_16_16_16_16_16_16_16_0_0_16_16_0_16_16_0_16_16_0_0_16_16_16_0_0_16_0_0_16_0_16_0_0_0_16_1_1_1_16_16_16_0_1_1_1_16_0_0_16_16_0_16_0_16_0_0_2_2_1_1_0_0_0_0_2_2_2_2_2_2_0_1_0_1_1_0_0_0_1_1_0_0_1_1_1_0_0_0_0_0_2_2_2_2_0_0_0_0_0_0_1_1_1_1_0_0_16_0_16_16_16_16_16_0_0_1_1_2_2_1_1_16_0_2_16_2_2_2_0_1_1_1_1_1_16_16_1_1_1_3_3_18_3_18_3_3_3_3_3_18_18_18_18_3_3_3_3_18_18_18_18_18_18_18_5_5_5_18_5_18_18_18_18_18_5_5_5_18_18_18_5_6_6_5_5_5_5_3_5_18_3_3_3_18_16_18_16_5_18_18_6_3_6_18_3_18_18_5_5_18_5_5_5_5_5_5_5_5_5_18_3_5_3_18_3_3_3_3_18_18_18_18_3_5_5_18_3_18_6_3_6_3_18
6069,76,1330662840,4,23,3,1330679760,16920,5121240,7552500,2431260,3_3_3_3_3_3_3_3_3_18_3_18_18_18_18_18_3_3_3_1_1_3_17_17_17_18_17_17_18_18_18_18_18_17_17_18_3_3_18_17_18_18_17_18_18_17_17_17_5_5_5_5_1_1_17_17_17_2_2_17_17_17_5_5_5_5_5_5_17_17_5_5_5_17_5_5_5_5_5_17_17_17_1_1_1_1_1_1_1_1_2_2_34_34_5_5_5_5_6_6_3_3_4_3_3_4_4_4_4_4_3_3_3_3_3_3_4_3_3_3_3_4_4_4_3_4_4_4_3_4_4_4_3_3_4_4_4_4_5_3_3_5_5_5_5_5_4_5_4_5_4_3_3_3_3_4
6070,220,1330663440,0,0,0,1330663440,0,319080,2714040,2394960,0_0_0_0_1_0_1_0_0_0_0_0_1_0_0_1_0_0_0_0_0_0_0_0
6071,220,1330663440,0,1,0,1330685100,21660,319080,2714040,2394960,0_0_0_0_1_0_1_0_0_0_0_0_1_0_0_1_0_0_0_0_0_0_0_0_0
6072,13,1330663500,19,1,19,1330685220,21720,96960,2525940,2428980,19_19_19_1_1_19_19_19_19_19_19
6073,57,1330664400,26,32,26,1330932660,268260,396660,2756640,2359980,26_26_26_26_26_26_26_26_26_26_26_26_26_26_26_26_26_26_26_26_26_26_26_26_26_8_8_8_8_2_2_26_8_8_26_26_26_26_26_26_26_26_8_8_26_26_26_26
6074,174,1330669920,10,16,10,1330680900,10980,90780,1300440,1209660,10_1_10_1_10
6075,63,1330679700,3,3,3,1330684200,4500,3828240,6232860,2404620,16_16_16_16_16_16_16_16_16_0_0_16_16_0_16_16_0_16_16_0_0_16_16_16_0_0_16_0_0_16_0_16_0_0_0_16_1_1_1_16_16_16_0_1_1_1_16_0_0_16_16_0_16_0_16_0_0_2_2_1_1_0_0_0_0_2_2_2_2_2_2_0_1_0_1_1_0_0_0_1_1_0_0_1_1_1_0_0_0_0_0_2_2_2_2_0_0_0_0_0_0_1_1_1_1_0_0_16_0_16_16_16_16_16_0_0_1_1_2_2_1_1_16_0_2_16_2_2_2_0_1_1_1_1_1_16_16_1_1_1_3_3_18_3_18_3_3_3_3_3_18_18_18_18_3_3_3_3_18_18_18_18_18_18_18_5_5_5_18_5_18_18_18_18_18_5_5_5_18_18_18_5_6_6_5_5_5_5_3_5_18_3_3_3_18_16_18_16_5_18_18_6_3_6_18_3_18_18_5_5_18_5_5_5_5_5_5_5_5_5_18_3_5_3_18_3_3_3_3_18_18_18_18_3_5_5_18_3_18_6_3_6_3_18_3
6076,76,1330679760,3,3,3,1330684140,4380,5138160,7552500,2414340,3_3_3_3_3_3_3_3_3_18_3_18_18_18_18_18_3_3_3_1_1_3_17_17_17_18_17_17_18_18_18_18_18_17_17_18_3_3_18_17_18_18_17_18_18_17_17_17_5_5_5_5_1_1_17_17_17_2_2_17_17_17_5_5_5_5_5_5_17_17_5_5_5_17_5_5_5_5_5_17_17_17_1_1_1_1_1_1_1_1_2_2_34_34_5_5_5_5_6_6_3_3_4_3_3_4_4_4_4_4_3_3_3_3_3_3_4_3_3_3_3_4_4_4_3_4_4_4_3_4_4_4_3_3_4_4_4_4_5_3_3_5_5_5_5_5_4_5_4_5_4_3_3_3_3_4_3
6077,176,1330680900,19,16,19,1330680960,60,0,1462860,1462860,19
6078,174,1330680900,10,16,19,1330812000,131100,101760,1300440,1198680,10_1_10_1_10_10
6079,176,1330680960,19,16,19,1330680960,0,60,1462860,1462800,19_19
6080,176,1330680960,19,16,19,1330684140,3180,60,1462860,1462800,19_19_19
6081,76,1330684140,3,3,4,1330805460,121320,5142540,7552500,2409960,3_3_3_3_3_3_3_3_3_18_3_18_18_18_18_18_3_3_3_1_1_3_17_17_17_18_17_17_18_18_18_18_18_17_17_18_3_3_18_17_18_18_17_18_18_17_17_17_5_5_5_5_1_1_17_17_17_2_2_17_17_17_5_5_5_5_5_5_17_17_5_5_5_17_5_5_5_5_5_17_17_17_1_1_1_1_1_1_1_1_2_2_34_34_5_5_5_5_6_6_3_3_4_3_3_4_4_4_4_4_3_3_3_3_3_3_4_3_3_3_3_4_4_4_3_4_4_4_3_4_4_4_3_3_4_4_4_4_5_3_3_5_5_5_5_5_4_5_4_5_4_3_3_3_3_4_3_3
6082,176,1330684140,19,16,19,1330885200,201060,3240,1462860,1459620,19_19_19_19
6083,63,1330684200,3,3,18,1330805520,121320,3832740,6232860,2400120,16_16_16_16_16_16_16_16_16_0_0_16_16_0_16_16_0_16_16_0_0_16_16_16_0_0_16_0_0_16_0_16_0_0_0_16_1_1_1_16_16_16_0_1_1_1_16_0_0_16_16_0_16_0_16_0_0_2_2_1_1_0_0_0_0_2_2_2_2_2_2_0_1_0_1_1_0_0_0_1_1_0_0_1_1_1_0_0_0_0_0_2_2_2_2_0_0_0_0_0_0_1_1_1_1_0_0_16_0_16_16_16_16_16_0_0_1_1_2_2_1_1_16_0_2_16_2_2_2_0_1_1_1_1_1_16_16_1_1_1_3_3_18_3_18_3_3_3_3_3_18_18_18_18_3_3_3_3_18_18_18_18_18_18_18_5_5_5_18_5_18_18_18_18_18_5_5_5_18_18_18_5_6_6_5_5_5_5_3_5_18_3_3_3_18_16_18_16_5_18_18_6_3_6_18_3_18_18_5_5_18_5_5_5_5_5_5_5_5_5_18_3_5_3_18_3_3_3_3_18_18_18_18_3_5_5_18_3_18_6_3_6_3_18_3_3
6084,204,1330685040,16,1,16,1330685160,120,151980,2567700,2415720,16_16_16_16_16_16_16_16_16_16_16_16_16_16_16_16_16
6085,220,1330685100,0,1,0,1330772220,87120,340740,2714040,2373300,0_0_0_0_1_0_1_0_0_0_0_0_1_0_0_1_0_0_0_0_0_0_0_0_0_0
6086,204,1330685160,16,1,16,1330772400,87240,152100,2567700,2415600,16_16_16_16_16_16_16_16_16_16_16_16_16_16_16_16_16_16
6087,13,1330685220,19,1,19,1330772400,87180,118680,2525940,2407260,19_19_19_1_1_19_19_19_19_19_19_19
6088,220,1330772220,0,14,0,1330797420,25200,427860,2714040,2286180,0_0_0_0_1_0_1_0_0_0_0_0_1_0_0_1_0_0_0_0_0_0_0_0_0_0_0
6089,204,1330772400,16,14,16,1330776000,3600,239340,2567700,2328360,16_16_16_16_16_16_16_16_16_16_16_16_16_16_16_16_16_16_16
6090,13,1330772400,19,14,19,1330810560,38160,205860,2525940,2320080,19_19_19_1_1_19_19_19_19_19_19_19_19
6091,204,1330776000,16,14,16,1330812720,36720,242940,2567700,2324760,16_16_16_16_16_16_16_16_16_16_16_16_16_16_16_16_16_16_16_16
6092,220,1330797420,0,14,0,1330806180,8760,453060,2714040,2260980,0_0_0_0_1_0_1_0_0_0_0_0_1_0_0_1_0_0_0_0_0_0_0_0_0_0_0_0
6093,76,1330805460,4,5,4,1330836300,30840,5263860,7552500,2288640,3_3_3_3_3_3_3_3_3_18_3_18_18_18_18_18_3_3_3_1_1_3_17_17_17_18_17_17_18_18_18_18_18_17_17_18_3_3_18_17_18_18_17_18_18_17_17_17_5_5_5_5_1_1_17_17_17_2_2_17_17_17_5_5_5_5_5_5_17_17_5_5_5_17_5_5_5_5_5_17_17_17_1_1_1_1_1_1_1_1_2_2_34_34_5_5_5_5_6_6_3_3_4_3_3_4_4_4_4_4_3_3_3_3_3_3_4_3_3_3_3_4_4_4_3_4_4_4_3_4_4_4_3_3_4_4_4_4_5_3_3_5_5_5_5_5_4_5_4_5_4_3_3_3_3_4_3_3_4
6094,63,1330805520,18,5,18,1330836360,30840,3954060,6232860,2278800,16_16_16_16_16_16_16_16_16_0_0_16_16_0_16_16_0_16_16_0_0_16_16_16_0_0_16_0_0_16_0_16_0_0_0_16_1_1_1_16_16_16_0_1_1_1_16_0_0_16_16_0_16_0_16_0_0_2_2_1_1_0_0_0_0_2_2_2_2_2_2_0_1_0_1_1_0_0_0_1_1_0_0_1_1_1_0_0_0_0_0_2_2_2_2_0_0_0_0_0_0_1_1_1_1_0_0_16_0_16_16_16_16_16_0_0_1_1_2_2_1_1_16_0_2_16_2_2_2_0_1_1_1_1_1_16_16_1_1_1_3_3_18_3_18_3_3_3_3_3_18_18_18_18_3_3_3_3_18_18_18_18_18_18_18_5_5_5_18_5_18_18_18_18_18_5_5_5_18_18_18_5_6_6_5_5_5_5_3_5_18_3_3_3_18_16_18_16_5_18_18_6_3_6_18_3_18_18_5_5_18_5_5_5_5_5_5_5_5_5_18_3_5_3_18_3_3_3_3_18_18_18_18_3_5_5_18_3_18_6_3_6_3_18_3_3_18
6095,220,1330806180,0,12,0,1330836420,30240,461820,2714040,2252220,0_0_0_0_1_0_1_0_0_0_0_0_1_0_0_1_0_0_0_0_0_0_0_0_0_0_0_0_0
6096,13,1330810560,19,12,19,1330813560,3000,244020,2525940,2281920,19_19_19_1_1_19_19_19_19_19_19_19_19_19
6097,174,1330812000,19,25,19,1330816500,4500,232860,1300440,1067580,10_1_10_1_10_10_19
6098,162,1330812000,3,4,3,1330816500,4500,2723460,4836120,2112660,0_0_16_16_0_0_0_0_0_0_0_0_16_0_0_16_0_0_16_16_0_0_1_1_2_2_3
6099,155,1330812000,9,4,9,1330812000,0,2221800,3225180,1003380,0_0_0_0_0_0_0_0_1_1_1_1_2_2_9_9_9_9_9_9_9
6100,155,1330812000,9,4,9,1330816500,4500,2221800,3225180,1003380,0_0_0_0_0_0_0_0_1_1_1_1_2_2_9_9_9_9_9_9_9_9
6101,204,1330812720,16,12,16,1330815420,2700,279660,2567700,2288040,16_16_16_16_16_16_16_16_16_16_16_16_16_16_16_16_16_16_16_16_16
6102,13,1330813560,19,14,19,1330836360,22800,247020,2525940,2278920,19_19_19_1_1_19_19_19_19_19_19_19_19_19_19
6103,204,1330815420,16,12,1,1330869360,53940,282360,2567700,2285340,16_16_16_16_16_16_16_16_16_16_16_16_16_16_16_16_16_16_16_16_16_16
6104,155,1330816500,9,4,9,1330849620,33120,2226300,3225180,998880,0_0_0_0_0_0_0_0_1_1_1_1_2_2_9_9_9_9_9_9_9_9_9_9
6105,174,1330816500,19,25,1,1330847160,30660,237360,1300440,1063080,10_1_10_1_10_10_19_19
6106,155,1330816500,9,4,9,1330816500,0,2226300,3225180,998880,0_0_0_0_0_0_0_0_1_1_1_1_2_2_9_9_9_9_9_9_9_9_9
6107,162,1330816500,3,4,3,1330853640,37140,2727960,4836120,2108160,0_0_16_16_0_0_0_0_0_0_0_0_16_0_0_16_0_0_16_16_0_0_1_1_2_2_3_3
6108,76,1330836300,4,5,5,1330839000,2700,5294700,7552500,2257800,3_3_3_3_3_3_3_3_3_18_3_18_18_18_18_18_3_3_3_1_1_3_17_17_17_18_17_17_18_18_18_18_18_17_17_18_3_3_18_17_18_18_17_18_18_17_17_17_5_5_5_5_1_1_17_17_17_2_2_17_17_17_5_5_5_5_5_5_17_17_5_5_5_17_5_5_5_5_5_17_17_17_1_1_1_1_1_1_1_1_2_2_34_34_5_5_5_5_6_6_3_3_4_3_3_4_4_4_4_4_3_3_3_3_3_3_4_3_3_3_3_4_4_4_3_4_4_4_3_4_4_4_3_3_4_4_4_4_5_3_3_5_5_5_5_5_4_5_4_5_4_3_3_3_3_4_3_3_4_4
6109,63,1330836360,18,5,5,1330837200,840,3984900,6232860,2247960,16_16_16_16_16_16_16_16_16_0_0_16_16_0_16_16_0_16_16_0_0_16_16_16_0_0_16_0_0_16_0_16_0_0_0_16_1_1_1_16_16_16_0_1_1_1_16_0_0_16_16_0_16_0_16_0_0_2_2_1_1_0_0_0_0_2_2_2_2_2_2_0_1_0_1_1_0_0_0_1_1_0_0_1_1_1_0_0_0_0_0_2_2_2_2_0_0_0_0_0_0_1_1_1_1_0_0_16_0_16_16_16_16_16_0_0_1_1_2_2_1_1_16_0_2_16_2_2_2_0_1_1_1_1_1_16_16_1_1_1_3_3_18_3_18_3_3_3_3_3_18_18_18_18_3_3_3_3_18_18_18_18_18_18_18_5_5_5_18_5_18_18_18_18_18_5_5_5_18_18_18_5_6_6_5_5_5_5_3_5_18_3_3_3_18_16_18_16_5_18_18_6_3_6_18_3_18_18_5_5_18_5_5_5_5_5_5_5_5_5_18_3_5_3_18_3_3_3_3_18_18_18_18_3_5_5_18_3_18_6_3_6_3_18_3_3_18_18
6110,13,1330836360,19,12,1,1330838400,2040,269820,2525940,2256120,19_19_19_1_1_19_19_19_19_19_19_19_19_19_19_19
6111,220,1330836420,0,12,0,1330836960,540,492060,2714040,2221980,0_0_0_0_1_0_1_0_0_0_0_0_1_0_0_1_0_0_0_0_0_0_0_0_0_0_0_0_0_0
6112,220,1330836960,0,0,1,1330838160,1200,492600,2714040,2221440,0_0_0_0_1_0_1_0_0_0_0_0_1_0_0_1_0_0_0_0_0_0_0_0_0_0_0_0_0_0_0
6113,107,1330837200,1,18,1,1330843200,6000,2910600,4991760,2081160,8_8_8_8_28_28_28_28_28_28_8_8_8_8_16_16_16_16_16_1_16_16_16_1_16_16_16_16_1_16_1_16_16_16_16_16_16_16_1_16_1_16_16_16_16_16_1_1_16_16_16_1_1_16_16_16_16_16_16_16_16_16_1_1_1_1_1
6114,63,1330837200,5,2,5,1330839000,1800,3985740,6232860,2247120,16_16_16_16_16_16_16_16_16_0_0_16_16_0_16_16_0_16_16_0_0_16_16_16_0_0_16_0_0_16_0_16_0_0_0_16_1_1_1_16_16_16_0_1_1_1_16_0_0_16_16_0_16_0_16_0_0_2_2_1_1_0_0_0_0_2_2_2_2_2_2_0_1_0_1_1_0_0_0_1_1_0_0_1_1_1_0_0_0_0_0_2_2_2_2_0_0_0_0_0_0_1_1_1_1_0_0_16_0_16_16_16_16_16_0_0_1_1_2_2_1_1_16_0_2_16_2_2_2_0_1_1_1_1_1_16_16_1_1_1_3_3_18_3_18_3_3_3_3_3_18_18_18_18_3_3_3_3_18_18_18_18_18_18_18_5_5_5_18_5_18_18_18_18_18_5_5_5_18_18_18_5_6_6_5_5_5_5_3_5_18_3_3_3_18_16_18_16_5_18_18_6_3_6_18_3_18_18_5_5_18_5_5_5_5_5_5_5_5_5_18_3_5_3_18_3_3_3_3_18_18_18_18_3_5_5_18_3_18_6_3_6_3_18_3_3_18_18_5
6115,220,1330838160,1,9,1,1330845780,7620,493800,2714040,2220240,0_0_0_0_1_0_1_0_0_0_0_0_1_0_0_1_0_0_0_0_0_0_0_0_0_0_0_0_0_0_0_1
6116,13,1330838400,1,9,1,1330840260,1860,271860,2525940,2254080,19_19_19_1_1_19_19_19_19_19_19_19_19_19_19_19_1
6117,76,1330839000,5,2,5,1330843200,4200,5297400,7552500,2255100,3_3_3_3_3_3_3_3_3_18_3_18_18_18_18_18_3_3_3_1_1_3_17_17_17_18_17_17_18_18_18_18_18_17_17_18_3_3_18_17_18_18_17_18_18_17_17_17_5_5_5_5_1_1_17_17_17_2_2_17_17_17_5_5_5_5_5_5_17_17_5_5_5_17_5_5_5_5_5_17_17_17_1_1_1_1_1_1_1_1_2_2_34_34_5_5_5_5_6_6_3_3_4_3_3_4_4_4_4_4_3_3_3_3_3_3_4_3_3_3_3_4_4_4_3_4_4_4_3_4_4_4_3_3_4_4_4_4_5_3_3_5_5_5_5_5_4_5_4_5_4_3_3_3_3_4_3_3_4_4_5
6118,63,1330839000,5,2,3,1330842180,3180,3987540,6232860,2245320,16_16_16_16_16_16_16_16_16_0_0_16_16_0_16_16_0_16_16_0_0_16_16_16_0_0_16_0_0_16_0_16_0_0_0_16_1_1_1_16_16_16_0_1_1_1_16_0_0_16_16_0_16_0_16_0_0_2_2_1_1_0_0_0_0_2_2_2_2_2_2_0_1_0_1_1_0_0_0_1_1_0_0_1_1_1_0_0_0_0_0_2_2_2_2_0_0_0_0_0_0_1_1_1_1_0_0_16_0_16_16_16_16_16_0_0_1_1_2_2_1_1_16_0_2_16_2_2_2_0_1_1_1_1_1_16_16_1_1_1_3_3_18_3_18_3_3_3_3_3_18_18_18_18_3_3_3_3_18_18_18_18_18_18_18_5_5_5_18_5_18_18_18_18_18_5_5_5_18_18_18_5_6_6_5_5_5_5_3_5_18_3_3_3_18_16_18_16_5_18_18_6_3_6_18_3_18_18_5_5_18_5_5_5_5_5_5_5_5_5_18_3_5_3_18_3_3_3_3_18_18_18_18_3_5_5_18_3_18_6_3_6_3_18_3_3_18_18_5_5
6119,89,1330840200,1,9,1,1330840260,60,1039080,1736340,697260,19_19_19_19_19_1_19_1_19_19_19_19_1_1_1
6120,13,1330840260,1,9,1,1331011320,171060,273720,2525940,2252220,19_19_19_1_1_19_19_19_19_19_19_19_19_19_19_19_1_1
6121,89,1330840260,1,9,2,1331195220,354960,1039140,1736340,697200,19_19_19_19_19_1_19_1_19_19_19_19_1_1_1_1
6122,63,1330842180,3,3,18,1330849680,7500,3990720,6232860,2242140,16_16_16_16_16_16_16_16_16_0_0_16_16_0_16_16_0_16_16_0_0_16_16_16_0_0_16_0_0_16_0_16_0_0_0_16_1_1_1_16_16_16_0_1_1_1_16_0_0_16_16_0_16_0_16_0_0_2_2_1_1_0_0_0_0_2_2_2_2_2_2_0_1_0_1_1_0_0_0_1_1_0_0_1_1_1_0_0_0_0_0_2_2_2_2_0_0_0_0_0_0_1_1_1_1_0_0_16_0_16_16_16_16_16_0_0_1_1_2_2_1_1_16_0_2_16_2_2_2_0_1_1_1_1_1_16_16_1_1_1_3_3_18_3_18_3_3_3_3_3_18_18_18_18_3_3_3_3_18_18_18_18_18_18_18_5_5_5_18_5_18_18_18_18_18_5_5_5_18_18_18_5_6_6_5_5_5_5_3_5_18_3_3_3_18_16_18_16_5_18_18_6_3_6_18_3_18_18_5_5_18_5_5_5_5_5_5_5_5_5_18_3_5_3_18_3_3_3_3_18_18_18_18_3_5_5_18_3_18_6_3_6_3_18_3_3_18_18_5_5_3
6123,107,1330843200,1,18,1,1331017200,174000,2916600,4991760,2075160,8_8_8_8_28_28_28_28_28_28_8_8_8_8_16_16_16_16_16_1_16_16_16_1_16_16_16_16_1_16_1_16_16_16_16_16_16_16_1_16_1_16_16_16_16_16_1_1_16_16_16_1_1_16_16_16_16_16_16_16_16_16_1_1_1_1_1_1
6124,76,1330843200,5,2,5,1330844400,1200,5301600,7552500,2250900,3_3_3_3_3_3_3_3_3_18_3_18_18_18_18_18_3_3_3_1_1_3_17_17_17_18_17_17_18_18_18_18_18_17_17_18_3_3_18_17_18_18_17_18_18_17_17_17_5_5_5_5_1_1_17_17_17_2_2_17_17_17_5_5_5_5_5_5_17_17_5_5_5_17_5_5_5_5_5_17_17_17_1_1_1_1_1_1_1_1_2_2_34_34_5_5_5_5_6_6_3_3_4_3_3_4_4_4_4_4_3_3_3_3_3_3_4_3_3_3_3_4_4_4_3_4_4_4_3_4_4_4_3_3_4_4_4_4_5_3_3_5_5_5_5_5_4_5_4_5_4_3_3_3_3_4_3_3_4_4_5_5
6125,196,1330844400,1,18,1,1330869000,24600,1043700,3281700,2238000,7_7_7_7_7_7_7_7_7_7_7_7_7_7_7_7_7_7_7_7_1_1_1_1_7_7_1_1_7_7_1_1_7_7_7_1_1_7_7_7_7_7_7_7_7_7_1
6126,76,1330844400,5,2,4,1330856460,12060,5302800,7552500,2249700,3_3_3_3_3_3_3_3_3_18_3_18_18_18_18_18_3_3_3_1_1_3_17_17_17_18_17_17_18_18_18_18_18_17_17_18_3_3_18_17_18_18_17_18_18_17_17_17_5_5_5_5_1_1_17_17_17_2_2_17_17_17_5_5_5_5_5_5_17_17_5_5_5_17_5_5_5_5_5_17_17_17_1_1_1_1_1_1_1_1_2_2_34_34_5_5_5_5_6_6_3_3_4_3_3_4_4_4_4_4_3_3_3_3_3_3_4_3_3_3_3_4_4_4_3_4_4_4_3_4_4_4_3_3_4_4_4_4_5_3_3_5_5_5_5_5_4_5_4_5_4_3_3_3_3_4_3_3_4_4_5_5_5
6127,220,1330845780,1,9,0,1330852260,6480,501420,2714040,2212620,0_0_0_0_1_0_1_0_0_0_0_0_1_0_0_1_0_0_0_0_0_0_0_0_0_0_0_0_0_0_0_1_1
6128,46,1330845900,5,9,5,1330847100,1200,1426860,2027040,600180,26_26_26_26_26_26_26_26_8_8_9_9_3_3_5
6129,31,1330846020,19,11,19,1330866840,20820,0,1374660,1374660,19
6130,46,1330847100,5,9,27,1331114400,267300,1428060,2027040,598980,26_26_26_26_26_26_26_26_8_8_9_9_3_3_5_5
6131,174,1330847160,1,9,1,1330853820,6660,268020,1300440,1032420,10_1_10_1_10_10_19_19_1
6132,26,1330848840,16,20,16,1330858620,9780,0,2036760,2036760,16
6133,155,1330849620,9,4,9,1330851120,1500,2259420,3225180,965760,0_0_0_0_0_0_0_0_1_1_1_1_2_2_9_9_9_9_9_9_9_9_9_9_9
6134,63,1330849680,18,22,3,1330853640,3960,3998220,6232860,2234640,16_16_16_16_16_16_16_16_16_0_0_16_16_0_16_16_0_16_16_0_0_16_16_16_0_0_16_0_0_16_0_16_0_0_0_16_1_1_1_16_16_16_0_1_1_1_16_0_0_16_16_0_16_0_16_0_0_2_2_1_1_0_0_0_0_2_2_2_2_2_2_0_1_0_1_1_0_0_0_1_1_0_0_1_1_1_0_0_0_0_0_2_2_2_2_0_0_0_0_0_0_1_1_1_1_0_0_16_0_16_16_16_16_16_0_0_1_1_2_2_1_1_16_0_2_16_2_2_2_0_1_1_1_1_1_16_16_1_1_1_3_3_18_3_18_3_3_3_3_3_18_18_18_18_3_3_3_3_18_18_18_18_18_18_18_5_5_5_18_5_18_18_18_18_18_5_5_5_18_18_18_5_6_6_5_5_5_5_3_5_18_3_3_3_18_16_18_16_5_18_18_6_3_6_18_3_18_18_5_5_18_5_5_5_5_5_5_5_5_5_18_3_5_3_18_3_3_3_3_18_18_18_18_3_5_5_18_3_18_6_3_6_3_18_3_3_18_18_5_5_3_18
6135,131,1330850640,34,17,34,1330863420,12780,4590540,6825900,2235360,16_16_16_16_16_16_16_16_16_16_16_16_16_16_16_16_16_16_16_16_16_16_16_16_16_16_1_1_1_1_2_2_3_3_3_3_18_18_18_18_18_3_3_3_3_18_18_18_18_18_18_18_18_18_18_18_18_18_18_18_18_18_18_18_5_5_5_5_5_5_5_5_5_5_5_5_6_6_5_5_6_6_5_5_5_5_5_5_5_5_5_5_6_6_5_5_34
6136,155,1330851120,9,4,4,1330869360,18240,2260920,3225180,964260,0_0_0_0_0_0_0_0_1_1_1_1_2_2_9_9_9_9_9_9_9_9_9_9_9_9
6137,220,1330852260,0,0,1,1330925880,73620,507900,2714040,2206140,0_0_0_0_1_0_1_0_0_0_0_0_1_0_0_1_0_0_0_0_0_0_0_0_0_0_0_0_0_0_0_1_1_0
6138,11,1330852440,0,0,0,1330876320,23880,0,1777560,1777560,0
6139,63,1330853640,3,3,5,1330863600,9960,4002180,6232860,2230680,16_16_16_16_16_16_16_16_16_0_0_16_16_0_16_16_0_16_16_0_0_16_16_16_0_0_16_0_0_16_0_16_0_0_0_16_1_1_1_16_16_16_0_1_1_1_16_0_0_16_16_0_16_0_16_0_0_2_2_1_1_0_0_0_0_2_2_2_2_2_2_0_1_0_1_1_0_0_0_1_1_0_0_1_1_1_0_0_0_0_0_2_2_2_2_0_0_0_0_0_0_1_1_1_1_0_0_16_0_16_16_16_16_16_0_0_1_1_2_2_1_1_16_0_2_16_2_2_2_0_1_1_1_1_1_16_16_1_1_1_3_3_18_3_18_3_3_3_3_3_18_18_18_18_3_3_3_3_18_18_18_18_18_18_18_5_5_5_18_5_18_18_18_18_18_5_5_5_18_18_18_5_6_6_5_5_5_5_3_5_18_3_3_3_18_16_18_16_5_18_18_6_3_6_18_3_18_18_5_5_18_5_5_5_5_5_5_5_5_5_18_3_5_3_18_3_3_3_3_18_18_18_18_3_5_5_18_3_18_6_3_6_3_18_3_3_18_18_5_5_3_18_3
6140,162,1330853640,3,3,4,1330871040,17400,2765100,4836120,2071020,0_0_16_16_0_0_0_0_0_0_0_0_16_0_0_16_0_0_16_16_0_0_1_1_2_2_3_3_3
6141,174,1330853820,1,9,9,1331240100,386280,274680,1300440,1025760,10_1_10_1_10_10_19_19_1_1
6142,210,1330853880,5,9,5,1330876500,22620,867240,1118160,250920,10_10_10_10_10_10_10_10_10_10_1_1_10_10_1_1_2_2_9_9_14_14_14_14_5
6143,169,1330854240,2,4,2,1330858200,3960,1192500,2190660,998160,50_50_50_50_50_50_50_50_50_50_50_50_50_50_50_50_50_1_1_50_50_50_50_1_1_50_50_50_50_50_50_50_50_1_1_50_3_3_50_2_50_2_50_50_50_6_6_3_3_50_5_2_2_2_2_5_50_50_1_1_2
6144,76,1330856460,4,23,5,1330858200,1740,5314860,7552500,2237640,3_3_3_3_3_3_3_3_3_18_3_18_18_18_18_18_3_3_3_1_1_3_17_17_17_18_17_17_18_18_18_18_18_17_17_18_3_3_18_17_18_18_17_18_18_17_17_17_5_5_5_5_1_1_17_17_17_2_2_17_17_17_5_5_5_5_5_5_17_17_5_5_5_17_5_5_5_5_5_17_17_17_1_1_1_1_1_1_1_1_2_2_34_34_5_5_5_5_6_6_3_3_4_3_3_4_4_4_4_4_3_3_3_3_3_3_4_3_3_3_3_4_4_4_3_4_4_4_3_4_4_4_3_3_4_4_4_4_5_3_3_5_5_5_5_5_4_5_4_5_4_3_3_3_3_4_3_3_4_4_5_5_5_4
6145,169,1330858200,2,4,3,1330984800,126600,1196460,2190660,994200,50_50_50_50_50_50_50_50_50_50_50_50_50_50_50_50_50_1_1_50_50_50_50_1_1_50_50_50_50_50_50_50_50_1_1_50_3_3_50_2_50_2_50_50_50_6_6_3_3_50_5_2_2_2_2_5_50_50_1_1_2_2
6146,76,1330858200,5,2,5,1330860000,1800,5316600,7552500,2235900,3_3_3_3_3_3_3_3_3_18_3_18_18_18_18_18_3_3_3_1_1_3_17_17_17_18_17_17_18_18_18_18_18_17_17_18_3_3_18_17_18_18_17_18_18_17_17_17_5_5_5_5_1_1_17_17_17_2_2_17_17_17_5_5_5_5_5_5_17_17_5_5_5_17_5_5_5_5_5_17_17_17_1_1_1_1_1_1_1_1_2_2_34_34_5_5_5_5_6_6_3_3_4_3_3_4_4_4_4_4_3_3_3_3_3_3_4_3_3_3_3_4_4_4_3_4_4_4_3_4_4_4_3_3_4_4_4_4_5_3_3_5_5_5_5_5_4_5_4_5_4_3_3_3_3_4_3_3_4_4_5_5_5_4_5
6147,26,1330858620,16,20,16,1330858680,60,9780,2036760,2026980,16_16
6148,26,1330858680,16,20,16,1330876740,18060,9840,2036760,2026920,16_16_16
6149,76,1330860000,5,2,5,1330863600,3600,5318400,7552500,2234100,3_3_3_3_3_3_3_3_3_18_3_18_18_18_18_18_3_3_3_1_1_3_17_17_17_18_17_17_18_18_18_18_18_17_17_18_3_3_18_17_18_18_17_18_18_17_17_17_5_5_5_5_1_1_17_17_17_2_2_17_17_17_5_5_5_5_5_5_17_17_5_5_5_17_5_5_5_5_5_17_17_17_1_1_1_1_1_1_1_1_2_2_34_34_5_5_5_5_6_6_3_3_4_3_3_4_4_4_4_4_3_3_3_3_3_3_4_3_3_3_3_4_4_4_3_4_4_4_3_4_4_4_3_3_4_4_4_4_5_3_3_5_5_5_5_5_4_5_4_5_4_3_3_3_3_4_3_3_4_4_5_5_5_4_5_5
6150,131,1330863420,34,17,34,1330867260,3840,4603320,6825900,2222580,16_16_16_16_16_16_16_16_16_16_16_16_16_16_16_16_16_16_16_16_16_16_16_16_16_16_1_1_1_1_2_2_3_3_3_3_18_18_18_18_18_3_3_3_3_18_18_18_18_18_18_18_18_18_18_18_18_18_18_18_18_18_18_18_5_5_5_5_5_5_5_5_5_5_5_5_6_6_5_5_6_6_5_5_5_5_5_5_5_5_5_5_6_6_5_5_34_34
6151,76,1330863600,5,2,4,1330869180,5580,5322000,7552500,2230500,3_3_3_3_3_3_3_3_3_18_3_18_18_18_18_18_3_3_3_1_1_3_17_17_17_18_17_17_18_18_18_18_18_17_17_18_3_3_18_17_18_18_17_18_18_17_17_17_5_5_5_5_1_1_17_17_17_2_2_17_17_17_5_5_5_5_5_5_17_17_5_5_5_17_5_5_5_5_5_17_17_17_1_1_1_1_1_1_1_1_2_2_34_34_5_5_5_5_6_6_3_3_4_3_3_4_4_4_4_4_3_3_3_3_3_3_4_3_3_3_3_4_4_4_3_4_4_4_3_4_4_4_3_3_4_4_4_4_5_3_3_5_5_5_5_5_4_5_4_5_4_3_3_3_3_4_3_3_4_4_5_5_5_4_5_5_5
6152,63,1330863600,5,2,34,1330872960,9360,4012140,6232860,2220720,16_16_16_16_16_16_16_16_16_0_0_16_16_0_16_16_0_16_16_0_0_16_16_16_0_0_16_0_0_16_0_16_0_0_0_16_1_1_1_16_16_16_0_1_1_1_16_0_0_16_16_0_16_0_16_0_0_2_2_1_1_0_0_0_0_2_2_2_2_2_2_0_1_0_1_1_0_0_0_1_1_0_0_1_1_1_0_0_0_0_0_2_2_2_2_0_0_0_0_0_0_1_1_1_1_0_0_16_0_16_16_16_16_16_0_0_1_1_2_2_1_1_16_0_2_16_2_2_2_0_1_1_1_1_1_16_16_1_1_1_3_3_18_3_18_3_3_3_3_3_18_18_18_18_3_3_3_3_18_18_18_18_18_18_18_5_5_5_18_5_18_18_18_18_18_5_5_5_18_18_18_5_6_6_5_5_5_5_3_5_18_3_3_3_18_16_18_16_5_18_18_6_3_6_18_3_18_18_5_5_18_5_5_5_5_5_5_5_5_5_18_3_5_3_18_3_3_3_3_18_18_18_18_3_5_5_18_3_18_6_3_6_3_18_3_3_18_18_5_5_3_18_3_5
6153,98,1330863660,34,17,34,1330867260,3600,5124240,7319880,2195640,34_34_2_2_35_35_34_34_2_2_3_3_3_3_3_3_18_18_3_3_3_18_3_3_3_18_18_18_18_3_3_18_18_18_18_18_18_18_18_3_3_18_39_3_3_39_3_3_3_3_4_4_5_5_5_5_5_5_4_4_4_5_3_5_5_3_5_4_4_4_5_5_5_5_6_6_6_6_5_5_5_5_5_5_5_5_5_5_5_5_6_6_5_5_34_34_6_6_5_5_5_5_5_5_5_5_5_5_5_5_2_2_5_18_5_18_18_18_6_6_5_5_5_5_5_5_6_6_34
6154,31,1330866840,19,11,19,1330869540,2700,20820,1374660,1353840,19_19_19
6155,31,1330866840,19,11,19,1330866840,0,20820,1374660,1353840,19_19
6156,131,1330867260,34,17,34,1330871160,3900,4607160,6825900,2218740,16_16_16_16_16_16_16_16_16_16_16_16_16_16_16_16_16_16_16_16_16_16_16_16_16_16_1_1_1_1_2_2_3_3_3_3_18_18_18_18_18_3_3_3_3_18_18_18_18_18_18_18_18_18_18_18_18_18_18_18_18_18_18_18_5_5_5_5_5_5_5_5_5_5_5_5_6_6_5_5_6_6_5_5_5_5_5_5_5_5_5_5_6_6_5_5_34_34_34
6157,98,1330867260,34,17,34,1330871220,3960,5127840,7319880,2192040,34_34_2_2_35_35_34_34_2_2_3_3_3_3_3_3_18_18_3_3_3_18_3_3_3_18_18_18_18_3_3_18_18_18_18_18_18_18_18_3_3_18_39_3_3_39_3_3_3_3_4_4_5_5_5_5_5_5_4_4_4_5_3_5_5_3_5_4_4_4_5_5_5_5_6_6_6_6_5_5_5_5_5_5_5_5_5_5_5_5_6_6_5_5_34_34_6_6_5_5_5_5_5_5_5_5_5_5_5_5_2_2_5_18_5_18_18_18_6_6_5_5_5_5_5_5_6_6_34_34
6158,196,1330869000,1,18,7,1330886940,17940,1068300,3281700,2213400,7_7_7_7_7_7_7_7_7_7_7_7_7_7_7_7_7_7_7_7_1_1_1_1_7_7_1_1_7_7_1_1_7_7_7_1_1_7_7_7_7_7_7_7_7_7_1_1
6159,76,1330869180,4,23,6,1330898400,29220,5327580,7552500,2224920,3_3_3_3_3_3_3_3_3_18_3_18_18_18_18_18_3_3_3_1_1_3_17_17_17_18_17_17_18_18_18_18_18_17_17_18_3_3_18_17_18_18_17_18_18_17_17_17_5_5_5_5_1_1_17_17_17_2_2_17_17_17_5_5_5_5_5_5_17_17_5_5_5_17_5_5_5_5_5_17_17_17_1_1_1_1_1_1_1_1_2_2_34_34_5_5_5_5_6_6_3_3_4_3_3_4_4_4_4_4_3_3_3_3_3_3_4_3_3_3_3_4_4_4_3_4_4_4_3_4_4_4_3_3_4_4_4_4_5_3_3_5_5_5_5_5_4_5_4_5_4_3_3_3_3_4_3_3_4_4_5_5_5_4_5_5_5_4
6160,204,1330869360,1,6,1,1330873860,4500,336300,2567700,2231400,16_16_16_16_16_16_16_16_16_16_16_16_16_16_16_16_16_16_16_16_16_16_1
6161,155,1330869360,4,23,4,1330870980,1620,2279160,3225180,946020,0_0_0_0_0_0_0_0_1_1_1_1_2_2_9_9_9_9_9_9_9_9_9_9_9_9_4
6162,31,1330869540,19,11,19,1330877520,7980,23520,1374660,1351140,19_19_19_19
6163,155,1330870980,4,23,4,1330970580,99600,2280780,3225180,944400,0_0_0_0_0_0_0_0_1_1_1_1_2_2_9_9_9_9_9_9_9_9_9_9_9_9_4_4
6164,162,1330871040,4,23,3,1330872960,1920,2782500,4836120,2053620,0_0_16_16_0_0_0_0_0_0_0_0_16_0_0_16_0_0_16_16_0_0_1_1_2_2_3_3_3_4
6165,131,1330871160,34,17,3,1330940400,69240,4611060,6825900,2214840,16_16_16_16_16_16_16_16_16_16_16_16_16_16_16_16_16_16_16_16_16_16_16_16_16_16_1_1_1_1_2_2_3_3_3_3_18_18_18_18_18_3_3_3_3_18_18_18_18_18_18_18_18_18_18_18_18_18_18_18_18_18_18_18_5_5_5_5_5_5_5_5_5_5_5_5_6_6_5_5_6_6_5_5_5_5_5_5_5_5_5_5_6_6_5_5_34_34_34_34
6166,98,1330871220,34,17,34,1330872900,1680,5131800,7319880,2188080,34_34_2_2_35_35_34_34_2_2_3_3_3_3_3_3_18_18_3_3_3_18_3_3_3_18_18_18_18_3_3_18_18_18_18_18_18_18_18_3_3_18_39_3_3_39_3_3_3_3_4_4_5_5_5_5_5_5_4_4_4_5_3_5_5_3_5_4_4_4_5_5_5_5_6_6_6_6_5_5_5_5_5_5_5_5_5_5_5_5_6_6_5_5_34_34_6_6_5_5_5_5_5_5_5_5_5_5_5_5_2_2_5_18_5_18_18_18_6_6_5_5_5_5_5_5_6_6_34_34_34
6167,98,1330872900,34,17,35,1331201580,328680,5133480,7319880,2186400,34_34_2_2_35_35_34_34_2_2_3_3_3_3_3_3_18_18_3_3_3_18_3_3_3_18_18_18_18_3_3_18_18_18_18_18_18_18_18_3_3_18_39_3_3_39_3_3_3_3_4_4_5_5_5_5_5_5_4_4_4_5_3_5_5_3_5_4_4_4_5_5_5_5_6_6_6_6_5_5_5_5_5_5_5_5_5_5_5_5_6_6_5_5_34_34_6_6_5_5_5_5_5_5_5_5_5_5_5_5_2_2_5_18_5_18_18_18_6_6_5_5_5_5_5_5_6_6_34_34_34_34
6168,162,1330872960,3,3,4,1330876560,3600,2784420,4836120,2051700,0_0_16_16_0_0_0_0_0_0_0_0_16_0_0_16_0_0_16_16_0_0_1_1_2_2_3_3_3_4_3
6169,63,1330872960,34,17,34,1330875780,2820,4021500,6232860,2211360,16_16_16_16_16_16_16_16_16_0_0_16_16_0_16_16_0_16_16_0_0_16_16_16_0_0_16_0_0_16_0_16_0_0_0_16_1_1_1_16_16_16_0_1_1_1_16_0_0_16_16_0_16_0_16_0_0_2_2_1_1_0_0_0_0_2_2_2_2_2_2_0_1_0_1_1_0_0_0_1_1_0_0_1_1_1_0_0_0_0_0_2_2_2_2_0_0_0_0_0_0_1_1_1_1_0_0_16_0_16_16_16_16_16_0_0_1_1_2_2_1_1_16_0_2_16_2_2_2_0_1_1_1_1_1_16_16_1_1_1_3_3_18_3_18_3_3_3_3_3_18_18_18_18_3_3_3_3_18_18_18_18_18_18_18_5_5_5_18_5_18_18_18_18_18_5_5_5_18_18_18_5_6_6_5_5_5_5_3_5_18_3_3_3_18_16_18_16_5_18_18_6_3_6_18_3_18_18_5_5_18_5_5_5_5_5_5_5_5_5_18_3_5_3_18_3_3_3_3_18_18_18_18_3_5_5_18_3_18_6_3_6_3_18_3_3_18_18_5_5_3_18_3_5_34
6170,204,1330873860,1,6,1,1330939200,65340,340800,2567700,2226900,16_16_16_16_16_16_16_16_16_16_16_16_16_16_16_16_16_16_16_16_16_16_1_1
6171,63,1330875780,34,17,3,1330875780,0,4024320,6232860,2208540,16_16_16_16_16_16_16_16_16_0_0_16_16_0_16_16_0_16_16_0_0_16_16_16_0_0_16_0_0_16_0_16_0_0_0_16_1_1_1_16_16_16_0_1_1_1_16_0_0_16_16_0_16_0_16_0_0_2_2_1_1_0_0_0_0_2_2_2_2_2_2_0_1_0_1_1_0_0_0_1_1_0_0_1_1_1_0_0_0_0_0_2_2_2_2_0_0_0_0_0_0_1_1_1_1_0_0_16_0_16_16_16_16_16_0_0_1_1_2_2_1_1_16_0_2_16_2_2_2_0_1_1_1_1_1_16_16_1_1_1_3_3_18_3_18_3_3_3_3_3_18_18_18_18_3_3_3_3_18_18_18_18_18_18_18_5_5_5_18_5_18_18_18_18_18_5_5_5_18_18_18_5_6_6_5_5_5_5_3_5_18_3_3_3_18_16_18_16_5_18_18_6_3_6_18_3_18_18_5_5_18_5_5_5_5_5_5_5_5_5_18_3_5_3_18_3_3_3_3_18_18_18_18_3_5_5_18_3_18_6_3_6_3_18_3_3_18_18_5_5_3_18_3_5_34_34
6172,63,1330875780,3,3,3,1330875840,60,4024320,6232860,2208540,16_16_16_16_16_16_16_16_16_0_0_16_16_0_16_16_0_16_16_0_0_16_16_16_0_0_16_0_0_16_0_16_0_0_0_16_1_1_1_16_16_16_0_1_1_1_16_0_0_16_16_0_16_0_16_0_0_2_2_1_1_0_0_0_0_2_2_2_2_2_2_0_1_0_1_1_0_0_0_1_1_0_0_1_1_1_0_0_0_0_0_2_2_2_2_0_0_0_0_0_0_1_1_1_1_0_0_16_0_16_16_16_16_16_0_0_1_1_2_2_1_1_16_0_2_16_2_2_2_0_1_1_1_1_1_16_16_1_1_1_3_3_18_3_18_3_3_3_3_3_18_18_18_18_3_3_3_3_18_18_18_18_18_18_18_5_5_5_18_5_18_18_18_18_18_5_5_5_18_18_18_5_6_6_5_5_5_5_3_5_18_3_3_3_18_16_18_16_5_18_18_6_3_6_18_3_18_18_5_5_18_5_5_5_5_5_5_5_5_5_18_3_5_3_18_3_3_3_3_18_18_18_18_3_5_5_18_3_18_6_3_6_3_18_3_3_18_18_5_5_3_18_3_5_34_34_3
6173,63,1330875840,3,3,18,1330876080,240,4024380,6232860,2208480,16_16_16_16_16_16_16_16_16_0_0_16_16_0_16_16_0_16_16_0_0_16_16_16_0_0_16_0_0_16_0_16_0_0_0_16_1_1_1_16_16_16_0_1_1_1_16_0_0_16_16_0_16_0_16_0_0_2_2_1_1_0_0_0_0_2_2_2_2_2_2_0_1_0_1_1_0_0_0_1_1_0_0_1_1_1_0_0_0_0_0_2_2_2_2_0_0_0_0_0_0_1_1_1_1_0_0_16_0_16_16_16_16_16_0_0_1_1_2_2_1_1_16_0_2_16_2_2_2_0_1_1_1_1_1_16_16_1_1_1_3_3_18_3_18_3_3_3_3_3_18_18_18_18_3_3_3_3_18_18_18_18_18_18_18_5_5_5_18_5_18_18_18_18_18_5_5_5_18_18_18_5_6_6_5_5_5_5_3_5_18_3_3_3_18_16_18_16_5_18_18_6_3_6_18_3_18_18_5_5_18_5_5_5_5_5_5_5_5_5_18_3_5_3_18_3_3_3_3_18_18_18_18_3_5_5_18_3_18_6_3_6_3_18_3_3_18_18_5_5_3_18_3_5_34_34_3_3
6174,63,1330876080,18,22,5,1330876800,720,4024620,6232860,2208240,16_16_16_16_16_16_16_16_16_0_0_16_16_0_16_16_0_16_16_0_0_16_16_16_0_0_16_0_0_16_0_16_0_0_0_16_1_1_1_16_16_16_0_1_1_1_16_0_0_16_16_0_16_0_16_0_0_2_2_1_1_0_0_0_0_2_2_2_2_2_2_0_1_0_1_1_0_0_0_1_1_0_0_1_1_1_0_0_0_0_0_2_2_2_2_0_0_0_0_0_0_1_1_1_1_0_0_16_0_16_16_16_16_16_0_0_1_1_2_2_1_1_16_0_2_16_2_2_2_0_1_1_1_1_1_16_16_1_1_1_3_3_18_3_18_3_3_3_3_3_18_18_18_18_3_3_3_3_18_18_18_18_18_18_18_5_5_5_18_5_18_18_18_18_18_5_5_5_18_18_18_5_6_6_5_5_5_5_3_5_18_3_3_3_18_16_18_16_5_18_18_6_3_6_18_3_18_18_5_5_18_5_5_5_5_5_5_5_5_5_18_3_5_3_18_3_3_3_3_18_18_18_18_3_5_5_18_3_18_6_3_6_3_18_3_3_18_18_5_5_3_18_3_5_34_34_3_3_18
6175,11,1330876320,0,1,0,1330876860,540,23880,1777560,1753680,0_0
6176,210,1330876500,5,9,6,1330898400,21900,889860,1118160,228300,10_10_10_10_10_10_10_10_10_10_1_1_10_10_1_1_2_2_9_9_14_14_14_14_5_5
6177,162,1330876560,4,23,4,1330885560,9000,2788020,4836120,2048100,0_0_16_16_0_0_0_0_0_0_0_0_16_0_0_16_0_0_16_16_0_0_1_1_2_2_3_3_3_4_3_4
6178,26,1330876740,16,20,16,1330923180,46440,27900,2036760,2008860,16_16_16_16
6179,63,1330876800,5,2,18,1330884540,7740,4025340,6232860,2207520,16_16_16_16_16_16_16_16_16_0_0_16_16_0_16_16_0_16_16_0_0_16_16_16_0_0_16_0_0_16_0_16_0_0_0_16_1_1_1_16_16_16_0_1_1_1_16_0_0_16_16_0_16_0_16_0_0_2_2_1_1_0_0_0_0_2_2_2_2_2_2_0_1_0_1_1_0_0_0_1_1_0_0_1_1_1_0_0_0_0_0_2_2_2_2_0_0_0_0_0_0_1_1_1_1_0_0_16_0_16_16_16_16_16_0_0_1_1_2_2_1_1_16_0_2_16_2_2_2_0_1_1_1_1_1_16_16_1_1_1_3_3_18_3_18_3_3_3_3_3_18_18_18_18_3_3_3_3_18_18_18_18_18_18_18_5_5_5_18_5_18_18_18_18_18_5_5_5_18_18_18_5_6_6_5_5_5_5_3_5_18_3_3_3_18_16_18_16_5_18_18_6_3_6_18_3_18_18_5_5_18_5_5_5_5_5_5_5_5_5_18_3_5_3_18_3_3_3_3_18_18_18_18_3_5_5_18_3_18_6_3_6_3_18_3_3_18_18_5_5_3_18_3_5_34_34_3_3_18_5
6180,11,1330876860,0,0,0,1330897980,21120,24420,1777560,1753140,0_0_0
6181,31,1330877520,19,1,19,1330884480,6960,31500,1374660,1343160,19_19_19_19_19
6182,31,1330884480,19,1,19,1330884540,60,38460,1374660,1336200,19_19_19_19_19_19
6183,31,1330884540,19,14,19,1330922580,38040,38520,1374660,1336140,19_19_19_19_19_19_19
6184,63,1330884540,18,19,3,1330898400,13860,4033080,6232860,2199780,16_16_16_16_16_16_16_16_16_0_0_16_16_0_16_16_0_16_16_0_0_16_16_16_0_0_16_0_0_16_0_16_0_0_0_16_1_1_1_16_16_16_0_1_1_1_16_0_0_16_16_0_16_0_16_0_0_2_2_1_1_0_0_0_0_2_2_2_2_2_2_0_1_0_1_1_0_0_0_1_1_0_0_1_1_1_0_0_0_0_0_2_2_2_2_0_0_0_0_0_0_1_1_1_1_0_0_16_0_16_16_16_16_16_0_0_1_1_2_2_1_1_16_0_2_16_2_2_2_0_1_1_1_1_1_16_16_1_1_1_3_3_18_3_18_3_3_3_3_3_18_18_18_18_3_3_3_3_18_18_18_18_18_18_18_5_5_5_18_5_18_18_18_18_18_5_5_5_18_18_18_5_6_6_5_5_5_5_3_5_18_3_3_3_18_16_18_16_5_18_18_6_3_6_18_3_18_18_5_5_18_5_5_5_5_5_5_5_5_5_18_3_5_3_18_3_3_3_3_18_18_18_18_3_5_5_18_3_18_6_3_6_3_18_3_3_18_18_5_5_3_18_3_5_34_34_3_3_18_5_18
6185,176,1330885200,19,16,19,1330906080,20880,204300,1462860,1258560,19_19_19_19_19
6186,162,1330885560,4,5,4,1330924200,38640,2797020,4836120,2039100,0_0_16_16_0_0_0_0_0_0_0_0_16_0_0_16_0_0_16_16_0_0_1_1_2_2_3_3_3_4_3_4_4
6187,196,1330886940,7,12,7,1330897020,10080,1086240,3281700,2195460,7_7_7_7_7_7_7_7_7_7_7_7_7_7_7_7_7_7_7_7_1_1_1_1_7_7_1_1_7_7_1_1_7_7_7_1_1_7_7_7_7_7_7_7_7_7_1_1_7
6188,196,1330897020,7,12,7,1330897080,60,1096320,3281700,2185380,7_7_7_7_7_7_7_7_7_7_7_7_7_7_7_7_7_7_7_7_1_1_1_1_7_7_1_1_7_7_1_1_7_7_7_1_1_7_7_7_7_7_7_7_7_7_1_1_7_7
6189,196,1330897080,7,12,30,1330898340,1260,1096380,3281700,2185320,7_7_7_7_7_7_7_7_7_7_7_7_7_7_7_7_7_7_7_7_1_1_1_1_7_7_1_1_7_7_1_1_7_7_7_1_1_7_7_7_7_7_7_7_7_7_1_1_7_7_7
6190,11,1330897980,0,1,1,1330898400,420,45540,1777560,1732020,0_0_0_0
6191,196,1330898340,30,27,30,1330905600,7260,1097640,3281700,2184060,7_7_7_7_7_7_7_7_7_7_7_7_7_7_7_7_7_7_7_7_1_1_1_1_7_7_1_1_7_7_1_1_7_7_7_1_1_7_7_7_7_7_7_7_7_7_1_1_7_7_7_30
6192,17,1330898400,1,9,1,1330902900,4500,424620,626460,201840,19_19_1_19_19_1_19_19_1
6193,63,1330898400,3,4,2,1330898400,0,4046940,6232860,2185920,16_16_16_16_16_16_16_16_16_0_0_16_16_0_16_16_0_16_16_0_0_16_16_16_0_0_16_0_0_16_0_16_0_0_0_16_1_1_1_16_16_16_0_1_1_1_16_0_0_16_16_0_16_0_16_0_0_2_2_1_1_0_0_0_0_2_2_2_2_2_2_0_1_0_1_1_0_0_0_1_1_0_0_1_1_1_0_0_0_0_0_2_2_2_2_0_0_0_0_0_0_1_1_1_1_0_0_16_0_16_16_16_16_16_0_0_1_1_2_2_1_1_16_0_2_16_2_2_2_0_1_1_1_1_1_16_16_1_1_1_3_3_18_3_18_3_3_3_3_3_18_18_18_18_3_3_3_3_18_18_18_18_18_18_18_5_5_5_18_5_18_18_18_18_18_5_5_5_18_18_18_5_6_6_5_5_5_5_3_5_18_3_3_3_18_16_18_16_5_18_18_6_3_6_18_3_18_18_5_5_18_5_5_5_5_5_5_5_5_5_18_3_5_3_18_3_3_3_3_18_18_18_18_3_5_5_18_3_18_6_3_6_3_18_3_3_18_18_5_5_3_18_3_5_34_34_3_3_18_5_18_3
6194,146,1330898400,6,7,6,1330902000,3600,5371200,6670800,1299600,16_16_16_16_16_16_16_1_16_1_16_1_1_16_1_16_16_2_1_1_16_1_2_16_2_2_3_3_3_3_21_21_3_3_3_3_3_21_3_21_3_3_3_3_21_3_21_3_18_18_18_18_18_18_3_3_3_3_4_4_4_4_4_4_4_4_4_4_4_4_4_4_4_4_4_4_18_18_4_4_4_4_4_3_3_4_4_4_5_5_6_6_5_5_6
6195,63,1330898400,2,4,3,1330902900,4500,4046940,6232860,2185920,16_16_16_16_16_16_16_16_16_0_0_16_16_0_16_16_0_16_16_0_0_16_16_16_0_0_16_0_0_16_0_16_0_0_0_16_1_1_1_16_16_16_0_1_1_1_16_0_0_16_16_0_16_0_16_0_0_2_2_1_1_0_0_0_0_2_2_2_2_2_2_0_1_0_1_1_0_0_0_1_1_0_0_1_1_1_0_0_0_0_0_2_2_2_2_0_0_0_0_0_0_1_1_1_1_0_0_16_0_16_16_16_16_16_0_0_1_1_2_2_1_1_16_0_2_16_2_2_2_0_1_1_1_1_1_16_16_1_1_1_3_3_18_3_18_3_3_3_3_3_18_18_18_18_3_3_3_3_18_18_18_18_18_18_18_5_5_5_18_5_18_18_18_18_18_5_5_5_18_18_18_5_6_6_5_5_5_5_3_5_18_3_3_3_18_16_18_16_5_18_18_6_3_6_18_3_18_18_5_5_18_5_5_5_5_5_5_5_5_5_18_3_5_3_18_3_3_3_3_18_18_18_18_3_5_5_18_3_18_6_3_6_3_18_3_3_18_18_5_5_3_18_3_5_34_34_3_3_18_5_18_3_2
6196,76,1330898400,6,7,6,1330902000,3600,5356800,7552500,2195700,3_3_3_3_3_3_3_3_3_18_3_18_18_18_18_18_3_3_3_1_1_3_17_17_17_18_17_17_18_18_18_18_18_17_17_18_3_3_18_17_18_18_17_18_18_17_17_17_5_5_5_5_1_1_17_17_17_2_2_17_17_17_5_5_5_5_5_5_17_17_5_5_5_17_5_5_5_5_5_17_17_17_1_1_1_1_1_1_1_1_2_2_34_34_5_5_5_5_6_6_3_3_4_3_3_4_4_4_4_4_3_3_3_3_3_3_4_3_3_3_3_4_4_4_3_4_4_4_3_4_4_4_3_3_4_4_4_4_5_3_3_5_5_5_5_5_4_5_4_5_4_3_3_3_3_4_3_3_4_4_5_5_5_4_5_5_5_4_6
6197,11,1330898400,1,9,0,1330898580,180,45960,1777560,1731600,0_0_0_0_1
6198,210,1330898400,6,7,6,1330902000,3600,911760,1118160,206400,10_10_10_10_10_10_10_10_10_10_1_1_10_10_1_1_2_2_9_9_14_14_14_14_5_5_6
6199,11,1330898580,0,14,0,1330902480,3900,46140,1777560,1731420,0_0_0_0_1_0
6200,210,1330902000,6,7,5,1330932540,30540,915360,1118160,202800,10_10_10_10_10_10_10_10_10_10_1_1_10_10_1_1_2_2_9_9_14_14_14_14_5_5_6_6
6201,76,1330902000,6,7,34,1331018580,116580,5360400,7552500,2192100,3_3_3_3_3_3_3_3_3_18_3_18_18_18_18_18_3_3_3_1_1_3_17_17_17_18_17_17_18_18_18_18_18_17_17_18_3_3_18_17_18_18_17_18_18_17_17_17_5_5_5_5_1_1_17_17_17_2_2_17_17_17_5_5_5_5_5_5_17_17_5_5_5_17_5_5_5_5_5_17_17_17_1_1_1_1_1_1_1_1_2_2_34_34_5_5_5_5_6_6_3_3_4_3_3_4_4_4_4_4_3_3_3_3_3_3_4_3_3_3_3_4_4_4_3_4_4_4_3_4_4_4_3_3_4_4_4_4_5_3_3_5_5_5_5_5_4_5_4_5_4_3_3_3_3_4_3_3_4_4_5_5_5_4_5_5_5_4_6_6
6202,146,1330902000,6,7,5,1330923540,21540,5374800,6670800,1296000,16_16_16_16_16_16_16_1_16_1_16_1_1_16_1_16_16_2_1_1_16_1_2_16_2_2_3_3_3_3_21_21_3_3_3_3_3_21_3_21_3_3_3_3_21_3_21_3_18_18_18_18_18_18_3_3_3_3_4_4_4_4_4_4_4_4_4_4_4_4_4_4_4_4_4_4_18_18_4_4_4_4_4_3_3_4_4_4_5_5_6_6_5_5_6_6
6203,11,1330902480,0,14,0,1330902540,60,50040,1777560,1727520,0_0_0_0_1_0_0
6204,11,1330902540,0,14,1,1330902900,360,50100,1777560,1727460,0_0_0_0_1_0_0_0
6205,63,1330902900,3,4,2,1330902900,0,4051440,6232860,2181420,16_16_16_16_16_16_16_16_16_0_0_16_16_0_16_16_0_16_16_0_0_16_16_16_0_0_16_0_0_16_0_16_0_0_0_16_1_1_1_16_16_16_0_1_1_1_16_0_0_16_16_0_16_0_16_0_0_2_2_1_1_0_0_0_0_2_2_2_2_2_2_0_1_0_1_1_0_0_0_1_1_0_0_1_1_1_0_0_0_0_0_2_2_2_2_0_0_0_0_0_0_1_1_1_1_0_0_16_0_16_16_16_16_16_0_0_1_1_2_2_1_1_16_0_2_16_2_2_2_0_1_1_1_1_1_16_16_1_1_1_3_3_18_3_18_3_3_3_3_3_18_18_18_18_3_3_3_3_18_18_18_18_18_18_18_5_5_5_18_5_18_18_18_18_18_5_5_5_18_18_18_5_6_6_5_5_5_5_3_5_18_3_3_3_18_16_18_16_5_18_18_6_3_6_18_3_18_18_5_5_18_5_5_5_5_5_5_5_5_5_18_3_5_3_18_3_3_3_3_18_18_18_18_3_5_5_18_3_18_6_3_6_3_18_3_3_18_18_5_5_3_18_3_5_34_34_3_3_18_5_18_3_2_3
6206,11,1330902900,1,9,0,1330922580,19680,50460,1777560,1727100,0_0_0_0_1_0_0_0_1
6207,17,1330902900,1,9,1,1330962000,59100,429120,626460,197340,19_19_1_19_19_1_19_19_1_1
6208,63,1330902900,2,4,18,1330922940,20040,4051440,6232860,2181420,16_16_16_16_16_16_16_16_16_0_0_16_16_0_16_16_0_16_16_0_0_16_16_16_0_0_16_0_0_16_0_16_0_0_0_16_1_1_1_16_16_16_0_1_1_1_16_0_0_16_16_0_16_0_16_0_0_2_2_1_1_0_0_0_0_2_2_2_2_2_2_0_1_0_1_1_0_0_0_1_1_0_0_1_1_1_0_0_0_0_0_2_2_2_2_0_0_0_0_0_0_1_1_1_1_0_0_16_0_16_16_16_16_16_0_0_1_1_2_2_1_1_16_0_2_16_2_2_2_0_1_1_1_1_1_16_16_1_1_1_3_3_18_3_18_3_3_3_3_3_18_18_18_18_3_3_3_3_18_18_18_18_18_18_18_5_5_5_18_5_18_18_18_18_18_5_5_5_18_18_18_5_6_6_5_5_5_5_3_5_18_3_3_3_18_16_18_16_5_18_18_6_3_6_18_3_18_18_5_5_18_5_5_5_5_5_5_5_5_5_18_3_5_3_18_3_3_3_3_18_18_18_18_3_5_5_18_3_18_6_3_6_3_18_3_3_18_18_5_5_3_18_3_5_34_34_3_3_18_5_18_3_2_3_2
6209,196,1330905600,30,27,7,1330923300,17700,1104900,3281700,2176800,7_7_7_7_7_7_7_7_7_7_7_7_7_7_7_7_7_7_7_7_1_1_1_1_7_7_1_1_7_7_1_1_7_7_7_1_1_7_7_7_7_7_7_7_7_7_1_1_7_7_7_30_30
6210,176,1330906080,19,16,19,1330906140,60,225180,1462860,1237680,19_19_19_19_19_19
6211,176,1330906140,19,16,19,1330914900,8760,225240,1462860,1237620,19_19_19_19_19_19_19
6212,176,1330914900,19,16,1,1330928460,13560,234000,1462860,1228860,19_19_19_19_19_19_19_19
6213,213,1330918140,0,20,1,1330925220,7080,1881720,3206820,1325100,0_0_0_0_0_1_0_1_0_0_0_0_0_0_0_0_1_1_0_0_0_0_0_0_0_1_1_0_0_0_0_0_0_0_0_0_0_0_0_0_0_1_1_1_0_1_0_0_0_0_0_0_0_0_0_0_1_0_1_0_0_0_0_0_0_0_0_0_0_0_0_0_0_0_0_0_0_0_0_1_1_0_0_0_0_0_0_0_0_0_0_0_0_0_1_1_0_0_2_2_3_3_4_3_3_4_2_2_4_4_4_4_4_4_4_4_5_2_3_4_5_2_3_4_6_6_5_5_0
6214,31,1330922580,19,14,1,1330923360,780,76560,1374660,1298100,19_19_19_19_19_19_19_19
6215,11,1330922580,0,14,0,1330922940,360,70140,1777560,1707420,0_0_0_0_1_0_0_0_1_0
6216,11,1330922940,0,0,1,1330923600,660,70500,1777560,1707060,0_0_0_0_1_0_0_0_1_0_0
6217,63,1330922940,18,19,5,1330923600,660,4071480,6232860,2161380,16_16_16_16_16_16_16_16_16_0_0_16_16_0_16_16_0_16_16_0_0_16_16_16_0_0_16_0_0_16_0_16_0_0_0_16_1_1_1_16_16_16_0_1_1_1_16_0_0_16_16_0_16_0_16_0_0_2_2_1_1_0_0_0_0_2_2_2_2_2_2_0_1_0_1_1_0_0_0_1_1_0_0_1_1_1_0_0_0_0_0_2_2_2_2_0_0_0_0_0_0_1_1_1_1_0_0_16_0_16_16_16_16_16_0_0_1_1_2_2_1_1_16_0_2_16_2_2_2_0_1_1_1_1_1_16_16_1_1_1_3_3_18_3_18_3_3_3_3_3_18_18_18_18_3_3_3_3_18_18_18_18_18_18_18_5_5_5_18_5_18_18_18_18_18_5_5_5_18_18_18_5_6_6_5_5_5_5_3_5_18_3_3_3_18_16_18_16_5_18_18_6_3_6_18_3_18_18_5_5_18_5_5_5_5_5_5_5_5_5_18_3_5_3_18_3_3_3_3_18_18_18_18_3_5_5_18_3_18_6_3_6_3_18_3_3_18_18_5_5_3_18_3_5_34_34_3_3_18_5_18_3_2_3_2_18
6218,26,1330923180,16,20,16,1330942440,19260,74340,2036760,1962420,16_16_16_16_16
6219,196,1330923300,7,12,1,1330923960,660,1122600,3281700,2159100,7_7_7_7_7_7_7_7_7_7_7_7_7_7_7_7_7_7_7_7_1_1_1_1_7_7_1_1_7_7_1_1_7_7_7_1_1_7_7_7_7_7_7_7_7_7_1_1_7_7_7_30_30_7
6220,31,1330923360,1,9,1,1330927200,3840,77340,1374660,1297320,19_19_19_19_19_19_19_19_1
6221,146,1330923540,5,6,5,1330938060,14520,5396340,6670800,1274460,16_16_16_16_16_16_16_1_16_1_16_1_1_16_1_16_16_2_1_1_16_1_2_16_2_2_3_3_3_3_21_21_3_3_3_3_3_21_3_21_3_3_3_3_21_3_21_3_18_18_18_18_18_18_3_3_3_3_4_4_4_4_4_4_4_4_4_4_4_4_4_4_4_4_4_4_18_18_4_4_4_4_4_3_3_4_4_4_5_5_6_6_5_5_6_6_5
6222,11,1330923600,1,9,1,1330928460,4860,71160,1777560,1706400,0_0_0_0_1_0_0_0_1_0_0_1
6223,63,1330923600,5,2,34,1330923660,60,4072140,6232860,2160720,16_16_16_16_16_16_16_16_16_0_0_16_16_0_16_16_0_16_16_0_0_16_16_16_0_0_16_0_0_16_0_16_0_0_0_16_1_1_1_16_16_16_0_1_1_1_16_0_0_16_16_0_16_0_16_0_0_2_2_1_1_0_0_0_0_2_2_2_2_2_2_0_1_0_1_1_0_0_0_1_1_0_0_1_1_1_0_0_0_0_0_2_2_2_2_0_0_0_0_0_0_1_1_1_1_0_0_16_0_16_16_16_16_16_0_0_1_1_2_2_1_1_16_0_2_16_2_2_2_0_1_1_1_1_1_16_16_1_1_1_3_3_18_3_18_3_3_3_3_3_18_18_18_18_3_3_3_3_18_18_18_18_18_18_18_5_5_5_18_5_18_18_18_18_18_5_5_5_18_18_18_5_6_6_5_5_5_5_3_5_18_3_3_3_18_16_18_16_5_18_18_6_3_6_18_3_18_18_5_5_18_5_5_5_5_5_5_5_5_5_18_3_5_3_18_3_3_3_3_18_18_18_18_3_5_5_18_3_18_6_3_6_3_18_3_3_18_18_5_5_3_18_3_5_34_34_3_3_18_5_18_3_2_3_2_18_5
6224,63,1330923660,34,17,18,1330924620,960,4072200,6232860,2160660,16_16_16_16_16_16_16_16_16_0_0_16_16_0_16_16_0_16_16_0_0_16_16_16_0_0_16_0_0_16_0_16_0_0_0_16_1_1_1_16_16_16_0_1_1_1_16_0_0_16_16_0_16_0_16_0_0_2_2_1_1_0_0_0_0_2_2_2_2_2_2_0_1_0_1_1_0_0_0_1_1_0_0_1_1_1_0_0_0_0_0_2_2_2_2_0_0_0_0_0_0_1_1_1_1_0_0_16_0_16_16_16_16_16_0_0_1_1_2_2_1_1_16_0_2_16_2_2_2_0_1_1_1_1_1_16_16_1_1_1_3_3_18_3_18_3_3_3_3_3_18_18_18_18_3_3_3_3_18_18_18_18_18_18_18_5_5_5_18_5_18_18_18_18_18_5_5_5_18_18_18_5_6_6_5_5_5_5_3_5_18_3_3_3_18_16_18_16_5_18_18_6_3_6_18_3_18_18_5_5_18_5_5_5_5_5_5_5_5_5_18_3_5_3_18_3_3_3_3_18_18_18_18_3_5_5_18_3_18_6_3_6_3_18_3_3_18_18_5_5_3_18_3_5_34_34_3_3_18_5_18_3_2_3_2_18_5_34
6225,196,1330923960,1,18,7,1330926540,2580,1123260,3281700,2158440,7_7_7_7_7_7_7_7_7_7_7_7_7_7_7_7_7_7_7_7_1_1_1_1_7_7_1_1_7_7_1_1_7_7_7_1_1_7_7_7_7_7_7_7_7_7_1_1_7_7_7_30_30_7_1
6226,162,1330924200,4,23,4,1330924260,60,2835660,4836120,2000460,0_0_16_16_0_0_0_0_0_0_0_0_16_0_0_16_0_0_16_16_0_0_1_1_2_2_3_3_3_4_3_4_4_4
6227,162,1330924260,4,5,4,1330955100,30840,2835720,4836120,2000400,0_0_16_16_0_0_0_0_0_0_0_0_16_0_0_16_0_0_16_16_0_0_1_1_2_2_3_3_3_4_3_4_4_4_4
6228,63,1330924620,18,22,3,1330927860,3240,4073160,6232860,2159700,16_16_16_16_16_16_16_16_16_0_0_16_16_0_16_16_0_16_16_0_0_16_16_16_0_0_16_0_0_16_0_16_0_0_0_16_1_1_1_16_16_16_0_1_1_1_16_0_0_16_16_0_16_0_16_0_0_2_2_1_1_0_0_0_0_2_2_2_2_2_2_0_1_0_1_1_0_0_0_1_1_0_0_1_1_1_0_0_0_0_0_2_2_2_2_0_0_0_0_0_0_1_1_1_1_0_0_16_0_16_16_16_16_16_0_0_1_1_2_2_1_1_16_0_2_16_2_2_2_0_1_1_1_1_1_16_16_1_1_1_3_3_18_3_18_3_3_3_3_3_18_18_18_18_3_3_3_3_18_18_18_18_18_18_18_5_5_5_18_5_18_18_18_18_18_5_5_5_18_18_18_5_6_6_5_5_5_5_3_5_18_3_3_3_18_16_18_16_5_18_18_6_3_6_18_3_18_18_5_5_18_5_5_5_5_5_5_5_5_5_18_3_5_3_18_3_3_3_3_18_18_18_18_3_5_5_18_3_18_6_3_6_3_18_3_3_18_18_5_5_3_18_3_5_34_34_3_3_18_5_18_3_2_3_2_18_5_34_18
6229,213,1330925220,1,9,0,1330925340,120,1888800,3206820,1318020,0_0_0_0_0_1_0_1_0_0_0_0_0_0_0_0_1_1_0_0_0_0_0_0_0_1_1_0_0_0_0_0_0_0_0_0_0_0_0_0_0_1_1_1_0_1_0_0_0_0_0_0_0_0_0_0_1_0_1_0_0_0_0_0_0_0_0_0_0_0_0_0_0_0_0_0_0_0_0_1_1_0_0_0_0_0_0_0_0_0_0_0_0_0_1_1_0_0_2_2_3_3_4_3_3_4_2_2_4_4_4_4_4_4_4_4_5_2_3_4_5_2_3_4_6_6_5_5_0_1
6230,213,1330925340,0,20,1,1330925460,120,1888920,3206820,1317900,0_0_0_0_0_1_0_1_0_0_0_0_0_0_0_0_1_1_0_0_0_0_0_0_0_1_1_0_0_0_0_0_0_0_0_0_0_0_0_0_0_1_1_1_0_1_0_0_0_0_0_0_0_0_0_0_1_0_1_0_0_0_0_0_0_0_0_0_0_0_0_0_0_0_0_0_0_0_0_1_1_0_0_0_0_0_0_0_0_0_0_0_0_0_1_1_0_0_2_2_3_3_4_3_3_4_2_2_4_4_4_4_4_4_4_4_5_2_3_4_5_2_3_4_6_6_5_5_0_1_0
6231,213,1330925460,1,9,2,1331442120,516660,1889040,3206820,1317780,0_0_0_0_0_1_0_1_0_0_0_0_0_0_0_0_1_1_0_0_0_0_0_0_0_1_1_0_0_0_0_0_0_0_0_0_0_0_0_0_0_1_1_1_0_1_0_0_0_0_0_0_0_0_0_0_1_0_1_0_0_0_0_0_0_0_0_0_0_0_0_0_0_0_0_0_0_0_0_1_1_0_0_0_0_0_0_0_0_0_0_0_0_0_1_1_0_0_2_2_3_3_4_3_3_4_2_2_4_4_4_4_4_4_4_4_5_2_3_4_5_2_3_4_6_6_5_5_0_1_0_1
6232,220,1330925880,1,9,1,1330925940,60,581520,2714040,2132520,0_0_0_0_1_0_1_0_0_0_0_0_1_0_0_1_0_0_0_0_0_0_0_0_0_0_0_0_0_0_0_1_1_0_1
6233,220,1330925940,1,9,1,1331009760,83820,581580,2714040,2132460,0_0_0_0_1_0_1_0_0_0_0_0_1_0_0_1_0_0_0_0_0_0_0_0_0_0_0_0_0_0_0_1_1_0_1_1
6234,196,1330926540,7,10,7,1330955700,29160,1125840,3281700,2155860,7_7_7_7_7_7_7_7_7_7_7_7_7_7_7_7_7_7_7_7_1_1_1_1_7_7_1_1_7_7_1_1_7_7_7_1_1_7_7_7_7_7_7_7_7_7_1_1_7_7_7_30_30_7_1_7
6235,172,1330926840,10,13,10,1330946940,20100,0,1443960,1443960,10
6236,31,1330927200,1,9,19,1330927440,240,81180,1374660,1293480,19_19_19_19_19_19_19_19_1_1
6237,31,1330927440,19,11,19,1330956060,28620,81420,1374660,1293240,19_19_19_19_19_19_19_19_1_1_19
6238,63,1330927860,3,3,5,1330929600,1740,4076400,6232860,2156460,16_16_16_16_16_16_16_16_16_0_0_16_16_0_16_16_0_16_16_0_0_16_16_16_0_0_16_0_0_16_0_16_0_0_0_16_1_1_1_16_16_16_0_1_1_1_16_0_0_16_16_0_16_0_16_0_0_2_2_1_1_0_0_0_0_2_2_2_2_2_2_0_1_0_1_1_0_0_0_1_1_0_0_1_1_1_0_0_0_0_0_2_2_2_2_0_0_0_0_0_0_1_1_1_1_0_0_16_0_16_16_16_16_16_0_0_1_1_2_2_1_1_16_0_2_16_2_2_2_0_1_1_1_1_1_16_16_1_1_1_3_3_18_3_18_3_3_3_3_3_18_18_18_18_3_3_3_3_18_18_18_18_18_18_18_5_5_5_18_5_18_18_18_18_18_5_5_5_18_18_18_5_6_6_5_5_5_5_3_5_18_3_3_3_18_16_18_16_5_18_18_6_3_6_18_3_18_18_5_5_18_5_5_5_5_5_5_5_5_5_18_3_5_3_18_3_3_3_3_18_18_18_18_3_5_5_18_3_18_6_3_6_3_18_3_3_18_18_5_5_3_18_3_5_34_34_3_3_18_5_18_3_2_3_2_18_5_34_18_3
6239,11,1330928460,1,9,0,1330933260,4800,76020,1777560,1701540,0_0_0_0_1_0_0_0_1_0_0_1_1
6240,176,1330928460,1,9,1,1330938540,10080,247560,1462860,1215300,19_19_19_19_19_19_19_19_1
6241,63,1330929600,5,2,5,1330930800,1200,4078140,6232860,2154720,16_16_16_16_16_16_16_16_16_0_0_16_16_0_16_16_0_16_16_0_0_16_16_16_0_0_16_0_0_16_0_16_0_0_0_16_1_1_1_16_16_16_0_1_1_1_16_0_0_16_16_0_16_0_16_0_0_2_2_1_1_0_0_0_0_2_2_2_2_2_2_0_1_0_1_1_0_0_0_1_1_0_0_1_1_1_0_0_0_0_0_2_2_2_2_0_0_0_0_0_0_1_1_1_1_0_0_16_0_16_16_16_16_16_0_0_1_1_2_2_1_1_16_0_2_16_2_2_2_0_1_1_1_1_1_16_16_1_1_1_3_3_18_3_18_3_3_3_3_3_18_18_18_18_3_3_3_3_18_18_18_18_18_18_18_5_5_5_18_5_18_18_18_18_18_5_5_5_18_18_18_5_6_6_5_5_5_5_3_5_18_3_3_3_18_16_18_16_5_18_18_6_3_6_18_3_18_18_5_5_18_5_5_5_5_5_5_5_5_5_18_3_5_3_18_3_3_3_3_18_18_18_18_3_5_5_18_3_18_6_3_6_3_18_3_3_18_18_5_5_3_18_3_5_34_34_3_3_18_5_18_3_2_3_2_18_5_34_18_3_5
6242,63,1330930800,5,2,3,1330940340,9540,4079340,6232860,2153520,16_16_16_16_16_16_16_16_16_0_0_16_16_0_16_16_0_16_16_0_0_16_16_16_0_0_16_0_0_16_0_16_0_0_0_16_1_1_1_16_16_16_0_1_1_1_16_0_0_16_16_0_16_0_16_0_0_2_2_1_1_0_0_0_0_2_2_2_2_2_2_0_1_0_1_1_0_0_0_1_1_0_0_1_1_1_0_0_0_0_0_2_2_2_2_0_0_0_0_0_0_1_1_1_1_0_0_16_0_16_16_16_16_16_0_0_1_1_2_2_1_1_16_0_2_16_2_2_2_0_1_1_1_1_1_16_16_1_1_1_3_3_18_3_18_3_3_3_3_3_18_18_18_18_3_3_3_3_18_18_18_18_18_18_18_5_5_5_18_5_18_18_18_18_18_5_5_5_18_18_18_5_6_6_5_5_5_5_3_5_18_3_3_3_18_16_18_16_5_18_18_6_3_6_18_3_18_18_5_5_18_5_5_5_5_5_5_5_5_5_18_3_5_3_18_3_3_3_3_18_18_18_18_3_5_5_18_3_18_6_3_6_3_18_3_3_18_18_5_5_3_18_3_5_34_34_3_3_18_5_18_3_2_3_2_18_5_34_18_3_5_5
6243,210,1330932540,5,9,5,1330932600,60,945900,1118160,172260,10_10_10_10_10_10_10_10_10_10_1_1_10_10_1_1_2_2_9_9_14_14_14_14_5_5_6_6_5
6244,210,1330932600,5,9,5,1331023740,91140,945960,1118160,172200,10_10_10_10_10_10_10_10_10_10_1_1_10_10_1_1_2_2_9_9_14_14_14_14_5_5_6_6_5_5
6245,57,1330932660,26,32,26,1330958220,25560,664920,2756640,2091720,26_26_26_26_26_26_26_26_26_26_26_26_26_26_26_26_26_26_26_26_26_26_26_26_26_8_8_8_8_2_2_26_8_8_26_26_26_26_26_26_26_26_8_8_26_26_26_26_26
6246,18,1330933260,0,0,0,1330956060,22800,0,1779540,1779540,0
6247,11,1330933260,0,0,1,1330935480,2220,80820,1777560,1696740,0_0_0_0_1_0_0_0_1_0_0_1_1_0
6248,11,1330935480,1,9,1,1330935780,300,83040,1777560,1694520,0_0_0_0_1_0_0_0_1_0_0_1_1_0_1
6249,11,1330935780,1,9,2,1331802300,866520,83340,1777560,1694220,0_0_0_0_1_0_0_0_1_0_0_1_1_0_1_1
6250,146,1330938060,5,6,34,1330960200,22140,5410860,6670800,1259940,16_16_16_16_16_16_16_1_16_1_16_1_1_16_1_16_16_2_1_1_16_1_2_16_2_2_3_3_3_3_21_21_3_3_3_3_3_21_3_21_3_3_3_3_21_3_21_3_18_18_18_18_18_18_3_3_3_3_4_4_4_4_4_4_4_4_4_4_4_4_4_4_4_4_4_4_18_18_4_4_4_4_4_3_3_4_4_4_5_5_6_6_5_5_6_6_5_5
6251,176,1330938540,1,9,2,1331882640,944100,257640,1462860,1205220,19_19_19_19_19_19_19_19_1_1
6252,204,1330939200,1,6,1,1330942140,2940,406140,2567700,2161560,16_16_16_16_16_16_16_16_16_16_16_16_16_16_16_16_16_16_16_16_16_16_1_1_1
6253,218,1330939560,15,9,15,1330963080,23520,1839240,1974480,135240,19_19_19_19_19_19_1_1_1_1_1_1_13_13_2_2_3_13_13_3_15
6254,63,1330940340,3,3,5,1330944600,4260,4088880,6232860,2143980,16_16_16_16_16_16_16_16_16_0_0_16_16_0_16_16_0_16_16_0_0_16_16_16_0_0_16_0_0_16_0_16_0_0_0_16_1_1_1_16_16_16_0_1_1_1_16_0_0_16_16_0_16_0_16_0_0_2_2_1_1_0_0_0_0_2_2_2_2_2_2_0_1_0_1_1_0_0_0_1_1_0_0_1_1_1_0_0_0_0_0_2_2_2_2_0_0_0_0_0_0_1_1_1_1_0_0_16_0_16_16_16_16_16_0_0_1_1_2_2_1_1_16_0_2_16_2_2_2_0_1_1_1_1_1_16_16_1_1_1_3_3_18_3_18_3_3_3_3_3_18_18_18_18_3_3_3_3_18_18_18_18_18_18_18_5_5_5_18_5_18_18_18_18_18_5_5_5_18_18_18_5_6_6_5_5_5_5_3_5_18_3_3_3_18_16_18_16_5_18_18_6_3_6_18_3_18_18_5_5_18_5_5_5_5_5_5_5_5_5_18_3_5_3_18_3_3_3_3_18_18_18_18_3_5_5_18_3_18_6_3_6_3_18_3_3_18_18_5_5_3_18_3_5_34_34_3_3_18_5_18_3_2_3_2_18_5_34_18_3_5_5_3
6255,131,1330940400,3,3,3,1330961100,20700,4680300,6825900,2145600,16_16_16_16_16_16_16_16_16_16_16_16_16_16_16_16_16_16_16_16_16_16_16_16_16_16_1_1_1_1_2_2_3_3_3_3_18_18_18_18_18_3_3_3_3_18_18_18_18_18_18_18_18_18_18_18_18_18_18_18_18_18_18_18_5_5_5_5_5_5_5_5_5_5_5_5_6_6_5_5_6_6_5_5_5_5_5_5_5_5_5_5_6_6_5_5_34_34_34_34_3
6256,204,1330942140,1,6,1,1331182800,240660,409080,2567700,2158620,16_16_16_16_16_16_16_16_16_16_16_16_16_16_16_16_16_16_16_16_16_16_1_1_1_1
6257,151,1330942380,47,9,47,1330942440,60,2820180,3643800,823620,19_19_19_19_19_1_1_19_1_1_19_19_19_19_1_19_1_19_19_19_19_19_19_19_19_19_1_19_19_1_1_1_1_1_19_19_19_19_19_19_1_1_19_19_1_1_19_1_1_19_19_19_19_19_19_19_19_19_19_19_19_19_19_19_1_1_47
6258,26,1330942440,16,20,16,1330942500,60,93600,2036760,1943160,16_16_16_16_16_16
6259,151,1330942440,47,9,3,1330984800,42360,2820240,3643800,823560,19_19_19_19_19_1_1_19_1_1_19_19_19_19_1_19_1_19_19_19_19_19_19_19_19_19_1_19_19_1_1_1_1_1_19_19_19_19_19_19_1_1_19_19_1_1_19_1_1_19_19_19_19_19_19_19_19_19_19_19_19_19_19_19_1_1_47_47
6260,26,1330942500,16,20,1,1330946400,3900,93660,2036760,1943100,16_16_16_16_16_16_16
6261,63,1330944600,5,2,3,1330946520,1920,4093140,6232860,2139720,16_16_16_16_16_16_16_16_16_0_0_16_16_0_16_16_0_16_16_0_0_16_16_16_0_0_16_0_0_16_0_16_0_0_0_16_1_1_1_16_16_16_0_1_1_1_16_0_0_16_16_0_16_0_16_0_0_2_2_1_1_0_0_0_0_2_2_2_2_2_2_0_1_0_1_1_0_0_0_1_1_0_0_1_1_1_0_0_0_0_0_2_2_2_2_0_0_0_0_0_0_1_1_1_1_0_0_16_0_16_16_16_16_16_0_0_1_1_2_2_1_1_16_0_2_16_2_2_2_0_1_1_1_1_1_16_16_1_1_1_3_3_18_3_18_3_3_3_3_3_18_18_18_18_3_3_3_3_18_18_18_18_18_18_18_5_5_5_18_5_18_18_18_18_18_5_5_5_18_18_18_5_6_6_5_5_5_5_3_5_18_3_3_3_18_16_18_16_5_18_18_6_3_6_18_3_18_18_5_5_18_5_5_5_5_5_5_5_5_5_18_3_5_3_18_3_3_3_3_18_18_18_18_3_5_5_18_3_18_6_3_6_3_18_3_3_18_18_5_5_3_18_3_5_34_34_3_3_18_5_18_3_2_3_2_18_5_34_18_3_5_5_3_5
6262,26,1330946400,1,2,1,1330951800,5400,97560,2036760,1939200,16_16_16_16_16_16_16_1
6263,63,1330946520,3,4,3,1330951620,5100,4095060,6232860,2137800,16_16_16_16_16_16_16_16_16_0_0_16_16_0_16_16_0_16_16_0_0_16_16_16_0_0_16_0_0_16_0_16_0_0_0_16_1_1_1_16_16_16_0_1_1_1_16_0_0_16_16_0_16_0_16_0_0_2_2_1_1_0_0_0_0_2_2_2_2_2_2_0_1_0_1_1_0_0_0_1_1_0_0_1_1_1_0_0_0_0_0_2_2_2_2_0_0_0_0_0_0_1_1_1_1_0_0_16_0_16_16_16_16_16_0_0_1_1_2_2_1_1_16_0_2_16_2_2_2_0_1_1_1_1_1_16_16_1_1_1_3_3_18_3_18_3_3_3_3_3_18_18_18_18_3_3_3_3_18_18_18_18_18_18_18_5_5_5_18_5_18_18_18_18_18_5_5_5_18_18_18_5_6_6_5_5_5_5_3_5_18_3_3_3_18_16_18_16_5_18_18_6_3_6_18_3_18_18_5_5_18_5_5_5_5_5_5_5_5_5_18_3_5_3_18_3_3_3_3_18_18_18_18_3_5_5_18_3_18_6_3_6_3_18_3_3_18_18_5_5_3_18_3_5_34_34_3_3_18_5_18_3_2_3_2_18_5_34_18_3_5_5_3_5_3
6264,172,1330946940,10,13,10,1330947000,60,20100,1443960,1423860,10_10
6265,172,1330947000,10,13,1,1330950600,3600,20160,1443960,1423800,10_10_10
6266,172,1330950600,1,9,10,1330951320,720,23760,1443960,1420200,10_10_10_1
6267,172,1330951320,10,13,10,1330951320,0,24480,1443960,1419480,10_10_10_1_10
6268,172,1330951320,10,13,1,1330951800,480,24480,1443960,1419480,10_10_10_1_10_10
6269,63,1330951620,3,4,5,1330951800,180,4100160,6232860,2132700,16_16_16_16_16_16_16_16_16_0_0_16_16_0_16_16_0_16_16_0_0_16_16_16_0_0_16_0_0_16_0_16_0_0_0_16_1_1_1_16_16_16_0_1_1_1_16_0_0_16_16_0_16_0_16_0_0_2_2_1_1_0_0_0_0_2_2_2_2_2_2_0_1_0_1_1_0_0_0_1_1_0_0_1_1_1_0_0_0_0_0_2_2_2_2_0_0_0_0_0_0_1_1_1_1_0_0_16_0_16_16_16_16_16_0_0_1_1_2_2_1_1_16_0_2_16_2_2_2_0_1_1_1_1_1_16_16_1_1_1_3_3_18_3_18_3_3_3_3_3_18_18_18_18_3_3_3_3_18_18_18_18_18_18_18_5_5_5_18_5_18_18_18_18_18_5_5_5_18_18_18_5_6_6_5_5_5_5_3_5_18_3_3_3_18_16_18_16_5_18_18_6_3_6_18_3_18_18_5_5_18_5_5_5_5_5_5_5_5_5_18_3_5_3_18_3_3_3_3_18_18_18_18_3_5_5_18_3_18_6_3_6_3_18_3_3_18_18_5_5_3_18_3_5_34_34_3_3_18_5_18_3_2_3_2_18_5_34_18_3_5_5_3_5_3_3
6270,172,1330951800,1,9,10,1330958640,6840,24960,1443960,1419000,10_10_10_1_10_10_1
6271,63,1330951800,5,2,18,1330955580,3780,4100340,6232860,2132520,16_16_16_16_16_16_16_16_16_0_0_16_16_0_16_16_0_16_16_0_0_16_16_16_0_0_16_0_0_16_0_16_0_0_0_16_1_1_1_16_16_16_0_1_1_1_16_0_0_16_16_0_16_0_16_0_0_2_2_1_1_0_0_0_0_2_2_2_2_2_2_0_1_0_1_1_0_0_0_1_1_0_0_1_1_1_0_0_0_0_0_2_2_2_2_0_0_0_0_0_0_1_1_1_1_0_0_16_0_16_16_16_16_16_0_0_1_1_2_2_1_1_16_0_2_16_2_2_2_0_1_1_1_1_1_16_16_1_1_1_3_3_18_3_18_3_3_3_3_3_18_18_18_18_3_3_3_3_18_18_18_18_18_18_18_5_5_5_18_5_18_18_18_18_18_5_5_5_18_18_18_5_6_6_5_5_5_5_3_5_18_3_3_3_18_16_18_16_5_18_18_6_3_6_18_3_18_18_5_5_18_5_5_5_5_5_5_5_5_5_18_3_5_3_18_3_3_3_3_18_18_18_18_3_5_5_18_3_18_6_3_6_3_18_3_3_18_18_5_5_3_18_3_5_34_34_3_3_18_5_18_3_2_3_2_18_5_34_18_3_5_5_3_5_3_3_5
6272,26,1330951800,1,2,16,1330955760,3960,102960,2036760,1933800,16_16_16_16_16_16_16_1_1
6273,162,1330955100,4,23,5,1331270700,315600,2866560,4836120,1969560,0_0_16_16_0_0_0_0_0_0_0_0_16_0_0_16_0_0_16_16_0_0_1_1_2_2_3_3_3_4_3_4_4_4_4_4
6274,63,1330955580,18,22,3,1330955820,240,4104120,6232860,2128740,16_16_16_16_16_16_16_16_16_0_0_16_16_0_16_16_0_16_16_0_0_16_16_16_0_0_16_0_0_16_0_16_0_0_0_16_1_1_1_16_16_16_0_1_1_1_16_0_0_16_16_0_16_0_16_0_0_2_2_1_1_0_0_0_0_2_2_2_2_2_2_0_1_0_1_1_0_0_0_1_1_0_0_1_1_1_0_0_0_0_0_2_2_2_2_0_0_0_0_0_0_1_1_1_1_0_0_16_0_16_16_16_16_16_0_0_1_1_2_2_1_1_16_0_2_16_2_2_2_0_1_1_1_1_1_16_16_1_1_1_3_3_18_3_18_3_3_3_3_3_18_18_18_18_3_3_3_3_18_18_18_18_18_18_18_5_5_5_18_5_18_18_18_18_18_5_5_5_18_18_18_5_6_6_5_5_5_5_3_5_18_3_3_3_18_16_18_16_5_18_18_6_3_6_18_3_18_18_5_5_18_5_5_5_5_5_5_5_5_5_18_3_5_3_18_3_3_3_3_18_18_18_18_3_5_5_18_3_18_6_3_6_3_18_3_3_18_18_5_5_3_18_3_5_34_34_3_3_18_5_18_3_2_3_2_18_5_34_18_3_5_5_3_5_3_3_5_18
6275,196,1330955700,7,10,1,1330956300,600,1155000,3281700,2126700,7_7_7_7_7_7_7_7_7_7_7_7_7_7_7_7_7_7_7_7_1_1_1_1_7_7_1_1_7_7_1_1_7_7_7_1_1_7_7_7_7_7_7_7_7_7_1_1_7_7_7_30_30_7_1_7_7
6276,26,1330955760,16,20,1,1331098740,142980,106920,2036760,1929840,16_16_16_16_16_16_16_1_1_16
6277,63,1330955820,3,4,34,1330960320,4500,4104360,6232860,2128500,16_16_16_16_16_16_16_16_16_0_0_16_16_0_16_16_0_16_16_0_0_16_16_16_0_0_16_0_0_16_0_16_0_0_0_16_1_1_1_16_16_16_0_1_1_1_16_0_0_16_16_0_16_0_16_0_0_2_2_1_1_0_0_0_0_2_2_2_2_2_2_0_1_0_1_1_0_0_0_1_1_0_0_1_1_1_0_0_0_0_0_2_2_2_2_0_0_0_0_0_0_1_1_1_1_0_0_16_0_16_16_16_16_16_0_0_1_1_2_2_1_1_16_0_2_16_2_2_2_0_1_1_1_1_1_16_16_1_1_1_3_3_18_3_18_3_3_3_3_3_18_18_18_18_3_3_3_3_18_18_18_18_18_18_18_5_5_5_18_5_18_18_18_18_18_5_5_5_18_18_18_5_6_6_5_5_5_5_3_5_18_3_3_3_18_16_18_16_5_18_18_6_3_6_18_3_18_18_5_5_18_5_5_5_5_5_5_5_5_5_18_3_5_3_18_3_3_3_3_18_18_18_18_3_5_5_18_3_18_6_3_6_3_18_3_3_18_18_5_5_3_18_3_5_34_34_3_3_18_5_18_3_2_3_2_18_5_34_18_3_5_5_3_5_3_3_5_18_3
6278,31,1330956060,19,11,19,1330971120,15060,110040,1374660,1264620,19_19_19_19_19_19_19_19_1_1_19_19
6279,18,1330956060,0,0,0,1330985100,29040,22800,1779540,1756740,0_0
6280,90,1330956300,2,15,2,1330962660,6360,1241640,1532940,291300,19_19_19_19_19_19_19_19_1_1_19_19_19_19_19_19_19_19_1_1_1_1_9_9_9_9_2
6281,196,1330956300,1,18,7,1330972440,16140,1155600,3281700,2126100,7_7_7_7_7_7_7_7_7_7_7_7_7_7_7_7_7_7_7_7_1_1_1_1_7_7_1_1_7_7_1_1_7_7_7_1_1_7_7_7_7_7_7_7_7_7_1_1_7_7_7_30_30_7_1_7_7_1
6282,57,1330958220,26,32,8,1331098200,139980,690480,2756640,2066160,26_26_26_26_26_26_26_26_26_26_26_26_26_26_26_26_26_26_26_26_26_26_26_26_26_8_8_8_8_2_2_26_8_8_26_26_26_26_26_26_26_26_8_8_26_26_26_26_26_26
6283,172,1330958640,10,13,10,1330981200,22560,31800,1443960,1412160,10_10_10_1_10_10_1_10
6284,146,1330960200,34,17,34,1330962300,2100,5433000,6670800,1237800,16_16_16_16_16_16_16_1_16_1_16_1_1_16_1_16_16_2_1_1_16_1_2_16_2_2_3_3_3_3_21_21_3_3_3_3_3_21_3_21_3_3_3_3_21_3_21_3_18_18_18_18_18_18_3_3_3_3_4_4_4_4_4_4_4_4_4_4_4_4_4_4_4_4_4_4_18_18_4_4_4_4_4_3_3_4_4_4_5_5_6_6_5_5_6_6_5_5_34
6285,63,1330960320,3,4,5,1330963320,3000,4108860,6232860,2124000,16_16_16_16_16_16_16_16_16_0_0_16_16_0_16_16_0_16_16_0_0_16_16_16_0_0_16_0_0_16_0_16_0_0_0_16_1_1_1_16_16_16_0_1_1_1_16_0_0_16_16_0_16_0_16_0_0_2_2_1_1_0_0_0_0_2_2_2_2_2_2_0_1_0_1_1_0_0_0_1_1_0_0_1_1_1_0_0_0_0_0_2_2_2_2_0_0_0_0_0_0_1_1_1_1_0_0_16_0_16_16_16_16_16_0_0_1_1_2_2_1_1_16_0_2_16_2_2_2_0_1_1_1_1_1_16_16_1_1_1_3_3_18_3_18_3_3_3_3_3_18_18_18_18_3_3_3_3_18_18_18_18_18_18_18_5_5_5_18_5_18_18_18_18_18_5_5_5_18_18_18_5_6_6_5_5_5_5_3_5_18_3_3_3_18_16_18_16_5_18_18_6_3_6_18_3_18_18_5_5_18_5_5_5_5_5_5_5_5_5_18_3_5_3_18_3_3_3_3_18_18_18_18_3_5_5_18_3_18_6_3_6_3_18_3_3_18_18_5_5_3_18_3_5_34_34_3_3_18_5_18_3_2_3_2_18_5_34_18_3_5_5_3_5_3_3_5_18_3_34_3
6286,63,1330960320,34,17,3,1330960320,0,4108860,6232860,2124000,16_16_16_16_16_16_16_16_16_0_0_16_16_0_16_16_0_16_16_0_0_16_16_16_0_0_16_0_0_16_0_16_0_0_0_16_1_1_1_16_16_16_0_1_1_1_16_0_0_16_16_0_16_0_16_0_0_2_2_1_1_0_0_0_0_2_2_2_2_2_2_0_1_0_1_1_0_0_0_1_1_0_0_1_1_1_0_0_0_0_0_2_2_2_2_0_0_0_0_0_0_1_1_1_1_0_0_16_0_16_16_16_16_16_0_0_1_1_2_2_1_1_16_0_2_16_2_2_2_0_1_1_1_1_1_16_16_1_1_1_3_3_18_3_18_3_3_3_3_3_18_18_18_18_3_3_3_3_18_18_18_18_18_18_18_5_5_5_18_5_18_18_18_18_18_5_5_5_18_18_18_5_6_6_5_5_5_5_3_5_18_3_3_3_18_16_18_16_5_18_18_6_3_6_18_3_18_18_5_5_18_5_5_5_5_5_5_5_5_5_18_3_5_3_18_3_3_3_3_18_18_18_18_3_5_5_18_3_18_6_3_6_3_18_3_3_18_18_5_5_3_18_3_5_34_34_3_3_18_5_18_3_2_3_2_18_5_34_18_3_5_5_3_5_3_3_5_18_3_34
6287,131,1330961100,3,3,18,1331155560,194460,4701000,6825900,2124900,16_16_16_16_16_16_16_16_16_16_16_16_16_16_16_16_16_16_16_16_16_16_16_16_16_16_1_1_1_1_2_2_3_3_3_3_18_18_18_18_18_3_3_3_3_18_18_18_18_18_18_18_18_18_18_18_18_18_18_18_18_18_18_18_5_5_5_5_5_5_5_5_5_5_5_5_6_6_5_5_6_6_5_5_5_5_5_5_5_5_5_5_6_6_5_5_34_34_34_34_3_3
6288,17,1330962000,1,9,1,1330962060,60,488220,626460,138240,19_19_1_19_19_1_19_19_1_1_1
6289,17,1330962060,1,9,1,1331099760,137700,488280,626460,138180,19_19_1_19_19_1_19_19_1_1_1_1
6290,146,1330962300,34,17,34,1330963200,900,5435100,6670800,1235700,16_16_16_16_16_16_16_1_16_1_16_1_1_16_1_16_16_2_1_1_16_1_2_16_2_2_3_3_3_3_21_21_3_3_3_3_3_21_3_21_3_3_3_3_21_3_21_3_18_18_18_18_18_18_3_3_3_3_4_4_4_4_4_4_4_4_4_4_4_4_4_4_4_4_4_4_18_18_4_4_4_4_4_3_3_4_4_4_5_5_6_6_5_5_6_6_5_5_34_34
6291,90,1330962660,2,15,2,1330995660,33000,1248000,1532940,284940,19_19_19_19_19_19_19_19_1_1_19_19_19_19_19_19_19_19_1_1_1_1_9_9_9_9_2_2
6292,218,1330963080,15,9,15,1331013600,50520,1862760,1974480,111720,19_19_19_19_19_19_1_1_1_1_1_1_13_13_2_2_3_13_13_3_15_15
6293,146,1330963200,34,15,34,1330971600,8400,5436000,6670800,1234800,16_16_16_16_16_16_16_1_16_1_16_1_1_16_1_16_16_2_1_1_16_1_2_16_2_2_3_3_3_3_21_21_3_3_3_3_3_21_3_21_3_3_3_3_21_3_21_3_18_18_18_18_18_18_3_3_3_3_4_4_4_4_4_4_4_4_4_4_4_4_4_4_4_4_4_4_18_18_4_4_4_4_4_3_3_4_4_4_5_5_6_6_5_5_6_6_5_5_34_34_34
6294,63,1330963320,5,2,18,1330971000,7680,4111860,6232860,2121000,16_16_16_16_16_16_16_16_16_0_0_16_16_0_16_16_0_16_16_0_0_16_16_16_0_0_16_0_0_16_0_16_0_0_0_16_1_1_1_16_16_16_0_1_1_1_16_0_0_16_16_0_16_0_16_0_0_2_2_1_1_0_0_0_0_2_2_2_2_2_2_0_1_0_1_1_0_0_0_1_1_0_0_1_1_1_0_0_0_0_0_2_2_2_2_0_0_0_0_0_0_1_1_1_1_0_0_16_0_16_16_16_16_16_0_0_1_1_2_2_1_1_16_0_2_16_2_2_2_0_1_1_1_1_1_16_16_1_1_1_3_3_18_3_18_3_3_3_3_3_18_18_18_18_3_3_3_3_18_18_18_18_18_18_18_5_5_5_18_5_18_18_18_18_18_5_5_5_18_18_18_5_6_6_5_5_5_5_3_5_18_3_3_3_18_16_18_16_5_18_18_6_3_6_18_3_18_18_5_5_18_5_5_5_5_5_5_5_5_5_18_3_5_3_18_3_3_3_3_18_18_18_18_3_5_5_18_3_18_6_3_6_3_18_3_3_18_18_5_5_3_18_3_5_34_34_3_3_18_5_18_3_2_3_2_18_5_34_18_3_5_5_3_5_3_3_5_18_3_34_3_5
6295,155,1330970580,4,5,4,1330980480,9900,2380380,3225180,844800,0_0_0_0_0_0_0_0_1_1_1_1_2_2_9_9_9_9_9_9_9_9_9_9_9_9_4_4_4
6296,63,1330971000,18,19,18,1330980780,9780,4119540,6232860,2113320,16_16_16_16_16_16_16_16_16_0_0_16_16_0_16_16_0_16_16_0_0_16_16_16_0_0_16_0_0_16_0_16_0_0_0_16_1_1_1_16_16_16_0_1_1_1_16_0_0_16_16_0_16_0_16_0_0_2_2_1_1_0_0_0_0_2_2_2_2_2_2_0_1_0_1_1_0_0_0_1_1_0_0_1_1_1_0_0_0_0_0_2_2_2_2_0_0_0_0_0_0_1_1_1_1_0_0_16_0_16_16_16_16_16_0_0_1_1_2_2_1_1_16_0_2_16_2_2_2_0_1_1_1_1_1_16_16_1_1_1_3_3_18_3_18_3_3_3_3_3_18_18_18_18_3_3_3_3_18_18_18_18_18_18_18_5_5_5_18_5_18_18_18_18_18_5_5_5_18_18_18_5_6_6_5_5_5_5_3_5_18_3_3_3_18_16_18_16_5_18_18_6_3_6_18_3_18_18_5_5_18_5_5_5_5_5_5_5_5_5_18_3_5_3_18_3_3_3_3_18_18_18_18_3_5_5_18_3_18_6_3_6_3_18_3_3_18_18_5_5_3_18_3_5_34_34_3_3_18_5_18_3_2_3_2_18_5_34_18_3_5_5_3_5_3_3_5_18_3_34_3_5_18
6297,31,1330971120,19,14,19,1330971240,120,125100,1374660,1249560,19_19_19_19_19_19_19_19_1_1_19_19_19
6298,31,1330971240,19,14,19,1330980840,9600,125220,1374660,1249440,19_19_19_19_19_19_19_19_1_1_19_19_19_19
6299,146,1330971600,34,15,34,1331028840,57240,5444400,6670800,1226400,16_16_16_16_16_16_16_1_16_1_16_1_1_16_1_16_16_2_1_1_16_1_2_16_2_2_3_3_3_3_21_21_3_3_3_3_3_21_3_21_3_3_3_3_21_3_21_3_18_18_18_18_18_18_3_3_3_3_4_4_4_4_4_4_4_4_4_4_4_4_4_4_4_4_4_4_18_18_4_4_4_4_4_3_3_4_4_4_5_5_6_6_5_5_6_6_5_5_34_34_34_34
6300,141,1330971840,34,15,34,1330984020,12180,5318640,7406100,2087460,1_1_16_16_16_16_16_1_16_16_1_1_1_16_16_16_16_16_16_16_16_16_16_16_16_16_16_16_1_1_1_1_1_1_1_1_1_1_1_1_16_2_2_16_3_3_3_3_3_3_18_18_18_18_18_3_18_3_3_3_5_5_5_5_5_5_3_3_4_4_4_4_4_3_1_3_1_4_18_3_3_18_18_1_1_18_18_5_5_18_5_5_5_5_6_6_5_5_6_6_6_6_5_5_5_5_5_5_5_5_6_6_5_5_5_5_5_5_5_5_5_5_5_5_34
6301,196,1330972440,7,12,1,1330984800,12360,1171740,3281700,2109960,7_7_7_7_7_7_7_7_7_7_7_7_7_7_7_7_7_7_7_7_1_1_1_1_7_7_1_1_7_7_1_1_7_7_7_1_1_7_7_7_7_7_7_7_7_7_1_1_7_7_7_30_30_7_1_7_7_1_7
6302,25,1330977600,16,14,16,1330984740,7140,0,1951380,1951380,16
6303,155,1330980480,4,5,4,1330980480,0,2390280,3225180,834900,0_0_0_0_0_0_0_0_1_1_1_1_2_2_9_9_9_9_9_9_9_9_9_9_9_9_4_4_4_4
6304,155,1330980480,4,5,4,1331009160,28680,2390280,3225180,834900,0_0_0_0_0_0_0_0_1_1_1_1_2_2_9_9_9_9_9_9_9_9_9_9_9_9_4_4_4_4_4
6305,63,1330980780,18,19,18,1330980840,60,4129320,6232860,2103540,16_16_16_16_16_16_16_16_16_0_0_16_16_0_16_16_0_16_16_0_0_16_16_16_0_0_16_0_0_16_0_16_0_0_0_16_1_1_1_16_16_16_0_1_1_1_16_0_0_16_16_0_16_0_16_0_0_2_2_1_1_0_0_0_0_2_2_2_2_2_2_0_1_0_1_1_0_0_0_1_1_0_0_1_1_1_0_0_0_0_0_2_2_2_2_0_0_0_0_0_0_1_1_1_1_0_0_16_0_16_16_16_16_16_0_0_1_1_2_2_1_1_16_0_2_16_2_2_2_0_1_1_1_1_1_16_16_1_1_1_3_3_18_3_18_3_3_3_3_3_18_18_18_18_3_3_3_3_18_18_18_18_18_18_18_5_5_5_18_5_18_18_18_18_18_5_5_5_18_18_18_5_6_6_5_5_5_5_3_5_18_3_3_3_18_16_18_16_5_18_18_6_3_6_18_3_18_18_5_5_18_5_5_5_5_5_5_5_5_5_18_3_5_3_18_3_3_3_3_18_18_18_18_3_5_5_18_3_18_6_3_6_3_18_3_3_18_18_5_5_3_18_3_5_34_34_3_3_18_5_18_3_2_3_2_18_5_34_18_3_5_5_3_5_3_3_5_18_3_34_3_5_18_18
6306,31,1330980840,19,14,3,1330984800,3960,134820,1374660,1239840,19_19_19_19_19_19_19_19_1_1_19_19_19_19_19
6307,63,1330980840,18,5,18,1331000580,19740,4129380,6232860,2103480,16_16_16_16_16_16_16_16_16_0_0_16_16_0_16_16_0_16_16_0_0_16_16_16_0_0_16_0_0_16_0_16_0_0_0_16_1_1_1_16_16_16_0_1_1_1_16_0_0_16_16_0_16_0_16_0_0_2_2_1_1_0_0_0_0_2_2_2_2_2_2_0_1_0_1_1_0_0_0_1_1_0_0_1_1_1_0_0_0_0_0_2_2_2_2_0_0_0_0_0_0_1_1_1_1_0_0_16_0_16_16_16_16_16_0_0_1_1_2_2_1_1_16_0_2_16_2_2_2_0_1_1_1_1_1_16_16_1_1_1_3_3_18_3_18_3_3_3_3_3_18_18_18_18_3_3_3_3_18_18_18_18_18_18_18_5_5_5_18_5_18_18_18_18_18_5_5_5_18_18_18_5_6_6_5_5_5_5_3_5_18_3_3_3_18_16_18_16_5_18_18_6_3_6_18_3_18_18_5_5_18_5_5_5_5_5_5_5_5_5_18_3_5_3_18_3_3_3_3_18_18_18_18_3_5_5_18_3_18_6_3_6_3_18_3_3_18_18_5_5_3_18_3_5_34_34_3_3_18_5_18_3_2_3_2_18_5_34_18_3_5_5_3_5_3_3_5_18_3_34_3_5_18_18_18
6308,75,1330981200,3,19,3,1330995600,14400,4872660,6135000,1262340,16_16_16_16_16_16_1_16_16_1_16_16_16_16_16_16_16_16_1_1_2_2_39_39_1_1_3
6309,172,1330981200,10,13,10,1330984740,3540,54360,1443960,1389600,10_10_10_1_10_10_1_10_10
6310,141,1330984020,34,15,34,1331010360,26340,5330820,7406100,2075280,1_1_16_16_16_16_16_1_16_16_1_1_1_16_16_16_16_16_16_16_16_16_16_16_16_16_16_16_1_1_1_1_1_1_1_1_1_1_1_1_16_2_2_16_3_3_3_3_3_3_18_18_18_18_18_3_18_3_3_3_5_5_5_5_5_5_3_3_4_4_4_4_4_3_1_3_1_4_18_3_3_18_18_1_1_18_18_5_5_18_5_5_5_5_6_6_5_5_6_6_6_6_5_5_5_5_5_5_5_5_6_6_5_5_5_5_5_5_5_5_5_5_5_5_34_34
6311,25,1330984740,16,14,8,1330984800,60,7140,1951380,1944240,16_16_16
6312,25,1330984740,16,14,16,1330984740,0,7140,1951380,1944240,16_16
6313,172,1330984740,10,13,10,1330984740,0,57900,1443960,1386060,10_10_10_1_10_10_1_10_10_10
6314,172,1330984740,10,13,10,1330988400,3660,57900,1443960,1386060,10_10_10_1_10_10_1_10_10_10_10
6315,169,1330984800,3,4,3,1330989300,4500,1323060,2190660,867600,50_50_50_50_50_50_50_50_50_50_50_50_50_50_50_50_50_1_1_50_50_50_50_1_1_50_50_50_50_50_50_50_50_1_1_50_3_3_50_2_50_2_50_50_50_6_6_3_3_50_5_2_2_2_2_5_50_50_1_1_2_2_3
6316,151,1330984800,3,4,3,1330989300,4500,2862600,3643800,781200,19_19_19_19_19_1_1_19_1_1_19_19_19_19_1_19_1_19_19_19_19_19_19_19_19_19_1_19_19_1_1_1_1_1_19_19_19_19_19_19_1_1_19_19_1_1_19_1_1_19_19_19_19_19_19_19_19_19_19_19_19_19_19_19_1_1_47_47_3_3
6317,196,1330984800,1,25,1,1330989300,4500,1184100,3281700,2097600,7_7_7_7_7_7_7_7_7_7_7_7_7_7_7_7_7_7_7_7_1_1_1_1_7_7_1_1_7_7_1_1_7_7_7_1_1_7_7_7_7_7_7_7_7_7_1_1_7_7_7_30_30_7_1_7_7_1_7_1
6318,151,1330984800,3,4,3,1330984800,0,2862600,3643800,781200,19_19_19_19_19_1_1_19_1_1_19_19_19_19_1_19_1_19_19_19_19_19_19_19_19_19_1_19_19_1_1_1_1_1_19_19_19_19_19_19_1_1_19_19_1_1_19_1_1_19_19_19_19_19_19_19_19_19_19_19_19_19_19_19_1_1_47_47_3
6319,25,1330984800,8,25,8,1330989300,4500,7200,1951380,1944180,16_16_16_8
6320,4,1330984800,1,18,1,1330989300,4500,631200,1326000,694800,10_10_10_10_10_10_10_1_1_10_10_10_10_10_10_10_10_10_10_1_10_1_10_1_1_10_10_10_10_10_1_1_1
6321,31,1330984800,3,4,19,1330985520,720,138780,1374660,1235880,19_19_19_19_19_19_19_19_1_1_19_19_19_19_19_3
6322,18,1330985100,0,14,0,1331008140,23040,51840,1779540,1727700,0_0_0
6323,31,1330985520,19,14,19,1330987080,1560,139500,1374660,1235160,19_19_19_19_19_19_19_19_1_1_19_19_19_19_19_3_19
6324,31,1330987080,19,16,3,1330989300,2220,141060,1374660,1233600,19_19_19_19_19_19_19_19_1_1_19_19_19_19_19_3_19_19
6325,172,1330988400,10,13,1,1331096040,107640,61560,1443960,1382400,10_10_10_1_10_10_1_10_10_10_10_10
6326,4,1330989300,1,18,2,1331206320,217020,635700,1326000,690300,10_10_10_10_10_10_10_1_1_10_10_10_10_10_10_10_10_10_10_1_10_1_10_1_1_10_10_10_10_10_1_1_1_1
6327,31,1330989300,3,4,19,1331007900,18600,143280,1374660,1231380,19_19_19_19_19_19_19_19_1_1_19_19_19_19_19_3_19_19_3
6328,25,1330989300,8,25,16,1330995600,6300,11700,1951380,1939680,16_16_16_8_8
6329,169,1330989300,3,4,3,1331071200,81900,1327560,2190660,863100,50_50_50_50_50_50_50_50_50_50_50_50_50_50_50_50_50_1_1_50_50_50_50_1_1_50_50_50_50_50_50_50_50_1_1_50_3_3_50_2_50_2_50_50_50_6_6_3_3_50_5_2_2_2_2_5_50_50_1_1_2_2_3_3
6330,151,1330989300,3,4,2,1331013360,24060,2867100,3643800,776700,19_19_19_19_19_1_1_19_1_1_19_19_19_19_1_19_1_19_19_19_19_19_19_19_19_19_1_19_19_1_1_1_1_1_19_19_19_19_19_19_1_1_19_19_1_1_19_1_1_19_19_19_19_19_19_19_19_19_19_19_19_19_19_19_1_1_47_47_3_3_3_3
6331,151,1330989300,3,4,3,1330989300,0,2867100,3643800,776700,19_19_19_19_19_1_1_19_1_1_19_19_19_19_1_19_1_19_19_19_19_19_19_19_19_19_1_19_19_1_1_1_1_1_19_19_19_19_19_19_1_1_19_19_1_1_19_1_1_19_19_19_19_19_19_19_19_19_19_19_19_19_19_19_1_1_47_47_3_3_3
6332,196,1330989300,1,25,7,1330994340,5040,1188600,3281700,2093100,7_7_7_7_7_7_7_7_7_7_7_7_7_7_7_7_7_7_7_7_1_1_1_1_7_7_1_1_7_7_1_1_7_7_7_1_1_7_7_7_7_7_7_7_7_7_1_1_7_7_7_30_30_7_1_7_7_1_7_1_1
6333,196,1330994340,7,12,7,1330999200,4860,1193640,3281700,2088060,7_7_7_7_7_7_7_7_7_7_7_7_7_7_7_7_7_7_7_7_1_1_1_1_7_7_1_1_7_7_1_1_7_7_7_1_1_7_7_7_7_7_7_7_7_7_1_1_7_7_7_30_30_7_1_7_7_1_7_1_1_7
6334,75,1330995600,3,19,3,1331028420,32820,4887060,6135000,1247940,16_16_16_16_16_16_1_16_16_1_16_16_16_16_16_16_16_16_1_1_2_2_39_39_1_1_3_3
6335,25,1330995600,16,14,16,1331009820,14220,18000,1951380,1933380,16_16_16_8_8_16
6336,90,1330995660,2,19,2,1331000520,4860,1281000,1532940,251940,19_19_19_19_19_19_19_19_1_1_19_19_19_19_19_19_19_19_1_1_1_1_9_9_9_9_2_2_2
6337,196,1330999200,7,12,7,1331006400,7200,1198500,3281700,2083200,7_7_7_7_7_7_7_7_7_7_7_7_7_7_7_7_7_7_7_7_1_1_1_1_7_7_1_1_7_7_1_1_7_7_7_1_1_7_7_7_7_7_7_7_7_7_1_1_7_7_7_30_30_7_1_7_7_1_7_1_1_7_7
6338,90,1331000520,2,19,3,1331042820,42300,1285860,1532940,247080,19_19_19_19_19_19_19_19_1_1_19_19_19_19_19_19_19_19_1_1_1_1_9_9_9_9_2_2_2_2
6339,63,1331000580,18,5,18,1331000640,60,4149120,6232860,2083740,16_16_16_16_16_16_16_16_16_0_0_16_16_0_16_16_0_16_16_0_0_16_16_16_0_0_16_0_0_16_0_16_0_0_0_16_1_1_1_16_16_16_0_1_1_1_16_0_0_16_16_0_16_0_16_0_0_2_2_1_1_0_0_0_0_2_2_2_2_2_2_0_1_0_1_1_0_0_0_1_1_0_0_1_1_1_0_0_0_0_0_2_2_2_2_0_0_0_0_0_0_1_1_1_1_0_0_16_0_16_16_16_16_16_0_0_1_1_2_2_1_1_16_0_2_16_2_2_2_0_1_1_1_1_1_16_16_1_1_1_3_3_18_3_18_3_3_3_3_3_18_18_18_18_3_3_3_3_18_18_18_18_18_18_18_5_5_5_18_5_18_18_18_18_18_5_5_5_18_18_18_5_6_6_5_5_5_5_3_5_18_3_3_3_18_16_18_16_5_18_18_6_3_6_18_3_18_18_5_5_18_5_5_5_5_5_5_5_5_5_18_3_5_3_18_3_3_3_3_18_18_18_18_3_5_5_18_3_18_6_3_6_3_18_3_3_18_18_5_5_3_18_3_5_34_34_3_3_18_5_18_3_2_3_2_18_5_34_18_3_5_5_3_5_3_3_5_18_3_34_3_5_18_18_18_18
6340,63,1331000640,18,19,18,1331007540,6900,4149180,6232860,2083680,16_16_16_16_16_16_16_16_16_0_0_16_16_0_16_16_0_16_16_0_0_16_16_16_0_0_16_0_0_16_0_16_0_0_0_16_1_1_1_16_16_16_0_1_1_1_16_0_0_16_16_0_16_0_16_0_0_2_2_1_1_0_0_0_0_2_2_2_2_2_2_0_1_0_1_1_0_0_0_1_1_0_0_1_1_1_0_0_0_0_0_2_2_2_2_0_0_0_0_0_0_1_1_1_1_0_0_16_0_16_16_16_16_16_0_0_1_1_2_2_1_1_16_0_2_16_2_2_2_0_1_1_1_1_1_16_16_1_1_1_3_3_18_3_18_3_3_3_3_3_18_18_18_18_3_3_3_3_18_18_18_18_18_18_18_5_5_5_18_5_18_18_18_18_18_5_5_5_18_18_18_5_6_6_5_5_5_5_3_5_18_3_3_3_18_16_18_16_5_18_18_6_3_6_18_3_18_18_5_5_18_5_5_5_5_5_5_5_5_5_18_3_5_3_18_3_3_3_3_18_18_18_18_3_5_5_18_3_18_6_3_6_3_18_3_3_18_18_5_5_3_18_3_5_34_34_3_3_18_5_18_3_2_3_2_18_5_34_18_3_5_5_3_5_3_3_5_18_3_34_3_5_18_18_18_18_18
6341,196,1331006400,7,12,1,1331010000,3600,1205700,3281700,2076000,7_7_7_7_7_7_7_7_7_7_7_7_7_7_7_7_7_7_7_7_1_1_1_1_7_7_1_1_7_7_1_1_7_7_7_1_1_7_7_7_7_7_7_7_7_7_1_1_7_7_7_30_30_7_1_7_7_1_7_1_1_7_7_7
6342,63,1331007540,18,19,18,1331007600,60,4156080,6232860,2076780,16_16_16_16_16_16_16_16_16_0_0_16_16_0_16_16_0_16_16_0_0_16_16_16_0_0_16_0_0_16_0_16_0_0_0_16_1_1_1_16_16_16_0_1_1_1_16_0_0_16_16_0_16_0_16_0_0_2_2_1_1_0_0_0_0_2_2_2_2_2_2_0_1_0_1_1_0_0_0_1_1_0_0_1_1_1_0_0_0_0_0_2_2_2_2_0_0_0_0_0_0_1_1_1_1_0_0_16_0_16_16_16_16_16_0_0_1_1_2_2_1_1_16_0_2_16_2_2_2_0_1_1_1_1_1_16_16_1_1_1_3_3_18_3_18_3_3_3_3_3_18_18_18_18_3_3_3_3_18_18_18_18_18_18_18_5_5_5_18_5_18_18_18_18_18_5_5_5_18_18_18_5_6_6_5_5_5_5_3_5_18_3_3_3_18_16_18_16_5_18_18_6_3_6_18_3_18_18_5_5_18_5_5_5_5_5_5_5_5_5_18_3_5_3_18_3_3_3_3_18_18_18_18_3_5_5_18_3_18_6_3_6_3_18_3_3_18_18_5_5_3_18_3_5_34_34_3_3_18_5_18_3_2_3_2_18_5_34_18_3_5_5_3_5_3_3_5_18_3_34_3_5_18_18_18_18_18_18
6343,63,1331007600,18,19,18,1331008980,1380,4156140,6232860,2076720,16_16_16_16_16_16_16_16_16_0_0_16_16_0_16_16_0_16_16_0_0_16_16_16_0_0_16_0_0_16_0_16_0_0_0_16_1_1_1_16_16_16_0_1_1_1_16_0_0_16_16_0_16_0_16_0_0_2_2_1_1_0_0_0_0_2_2_2_2_2_2_0_1_0_1_1_0_0_0_1_1_0_0_1_1_1_0_0_0_0_0_2_2_2_2_0_0_0_0_0_0_1_1_1_1_0_0_16_0_16_16_16_16_16_0_0_1_1_2_2_1_1_16_0_2_16_2_2_2_0_1_1_1_1_1_16_16_1_1_1_3_3_18_3_18_3_3_3_3_3_18_18_18_18_3_3_3_3_18_18_18_18_18_18_18_5_5_5_18_5_18_18_18_18_18_5_5_5_18_18_18_5_6_6_5_5_5_5_3_5_18_3_3_3_18_16_18_16_5_18_18_6_3_6_18_3_18_18_5_5_18_5_5_5_5_5_5_5_5_5_18_3_5_3_18_3_3_3_3_18_18_18_18_3_5_5_18_3_18_6_3_6_3_18_3_3_18_18_5_5_3_18_3_5_34_34_3_3_18_5_18_3_2_3_2_18_5_34_18_3_5_5_3_5_3_3_5_18_3_34_3_5_18_18_18_18_18_18_18
6344,31,1331007900,19,16,1,1331010060,2160,161880,1374660,1212780,19_19_19_19_19_19_19_19_1_1_19_19_19_19_19_3_19_19_3_19
6345,18,1331008140,0,14,0,1331009940,1800,74880,1779540,1704660,0_0_0_0
6346,63,1331008980,18,19,18,1331041800,32820,4157520,6232860,2075340,16_16_16_16_16_16_16_16_16_0_0_16_16_0_16_16_0_16_16_0_0_16_16_16_0_0_16_0_0_16_0_16_0_0_0_16_1_1_1_16_16_16_0_1_1_1_16_0_0_16_16_0_16_0_16_0_0_2_2_1_1_0_0_0_0_2_2_2_2_2_2_0_1_0_1_1_0_0_0_1_1_0_0_1_1_1_0_0_0_0_0_2_2_2_2_0_0_0_0_0_0_1_1_1_1_0_0_16_0_16_16_16_16_16_0_0_1_1_2_2_1_1_16_0_2_16_2_2_2_0_1_1_1_1_1_16_16_1_1_1_3_3_18_3_18_3_3_3_3_3_18_18_18_18_3_3_3_3_18_18_18_18_18_18_18_5_5_5_18_5_18_18_18_18_18_5_5_5_18_18_18_5_6_6_5_5_5_5_3_5_18_3_3_3_18_16_18_16_5_18_18_6_3_6_18_3_18_18_5_5_18_5_5_5_5_5_5_5_5_5_18_3_5_3_18_3_3_3_3_18_18_18_18_3_5_5_18_3_18_6_3_6_3_18_3_3_18_18_5_5_3_18_3_5_34_34_3_3_18_5_18_3_2_3_2_18_5_34_18_3_5_5_3_5_3_3_5_18_3_34_3_5_18_18_18_18_18_18_18_18
6347,155,1331009160,4,5,4,1331012700,3540,2418960,3225180,806220,0_0_0_0_0_0_0_0_1_1_1_1_2_2_9_9_9_9_9_9_9_9_9_9_9_9_4_4_4_4_4_4
6348,220,1331009760,1,9,1,1331009820,60,665400,2714040,2048640,0_0_0_0_1_0_1_0_0_0_0_0_1_0_0_1_0_0_0_0_0_0_0_0_0_0_0_0_0_0_0_1_1_0_1_1_1
6349,25,1331009820,16,20,8,1331011020,1200,32220,1951380,1919160,16_16_16_8_8_16_16
6350,220,1331009820,1,9,0,1331014500,4680,665460,2714040,2048580,0_0_0_0_1_0_1_0_0_0_0_0_1_0_0_1_0_0_0_0_0_0_0_0_0_0_0_0_0_0_0_1_1_0_1_1_1_1
6351,18,1331009940,0,0,0,1331015700,5760,76680,1779540,1702860,0_0_0_0_0
6352,196,1331010000,1,18,7,1331010000,0,1209300,3281700,2072400,7_7_7_7_7_7_7_7_7_7_7_7_7_7_7_7_7_7_7_7_1_1_1_1_7_7_1_1_7_7_1_1_7_7_7_1_1_7_7_7_7_7_7_7_7_7_1_1_7_7_7_30_30_7_1_7_7_1_7_1_1_7_7_7_1
6353,196,1331010000,7,10,7,1331016000,6000,1209300,3281700,2072400,7_7_7_7_7_7_7_7_7_7_7_7_7_7_7_7_7_7_7_7_1_1_1_1_7_7_1_1_7_7_1_1_7_7_7_1_1_7_7_7_7_7_7_7_7_7_1_1_7_7_7_30_30_7_1_7_7_1_7_1_1_7_7_7_1_7
6354,31,1331010060,1,9,19,1331010420,360,164040,1374660,1210620,19_19_19_19_19_19_19_19_1_1_19_19_19_19_19_3_19_19_3_19_1
6355,141,1331010360,34,17,34,1331018580,8220,5357160,7406100,2048940,1_1_16_16_16_16_16_1_16_16_1_1_1_16_16_16_16_16_16_16_16_16_16_16_16_16_16_16_1_1_1_1_1_1_1_1_1_1_1_1_16_2_2_16_3_3_3_3_3_3_18_18_18_18_18_3_18_3_3_3_5_5_5_5_5_5_3_3_4_4_4_4_4_3_1_3_1_4_18_3_3_18_18_1_1_18_18_5_5_18_5_5_5_5_6_6_5_5_6_6_6_6_5_5_5_5_5_5_5_5_6_6_5_5_5_5_5_5_5_5_5_5_5_5_34_34_34
6356,31,1331010420,19,11,1,1331012100,1680,164400,1374660,1210260,19_19_19_19_19_19_19_19_1_1_19_19_19_19_19_3_19_19_3_19_1_19
6357,25,1331011020,8,6,8,1331014620,3600,33420,1951380,1917960,16_16_16_8_8_16_16_8
6358,13,1331011320,1,9,19,1331011680,360,444780,2525940,2081160,19_19_19_1_1_19_19_19_19_19_19_19_19_19_19_19_1_1_1
6359,13,1331011680,19,11,1,1331011740,60,445140,2525940,2080800,19_19_19_1_1_19_19_19_19_19_19_19_19_19_19_19_1_1_1_19
6360,13,1331011740,1,9,19,1331011740,0,445200,2525940,2080740,19_19_19_1_1_19_19_19_19_19_19_19_19_19_19_19_1_1_1_19_1
6361,13,1331011740,19,11,19,1331161680,149940,445200,2525940,2080740,19_19_19_1_1_19_19_19_19_19_19_19_19_19_19_19_1_1_1_19_1_19
6362,31,1331012100,1,9,19,1331022540,10440,166080,1374660,1208580,19_19_19_19_19_19_19_19_1_1_19_19_19_19_19_3_19_19_3_19_1_19_1
6363,181,1331012400,26,13,26,1331017740,5340,0,189540,189540,26
6364,155,1331012700,4,22,4,1331041800,29100,2422500,3225180,802680,0_0_0_0_0_0_0_0_1_1_1_1_2_2_9_9_9_9_9_9_9_9_9_9_9_9_4_4_4_4_4_4_4
6365,151,1331013360,2,4,3,1331014320,960,2891160,3643800,752640,19_19_19_19_19_1_1_19_1_1_19_19_19_19_1_19_1_19_19_19_19_19_19_19_19_19_1_19_19_1_1_1_1_1_19_19_19_19_19_19_1_1_19_19_1_1_19_1_1_19_19_19_19_19_19_19_19_19_19_19_19_19_19_19_1_1_47_47_3_3_3_3_2
6366,218,1331013600,15,9,15,1331022420,8820,1913280,1974480,61200,19_19_19_19_19_19_1_1_1_1_1_1_13_13_2_2_3_13_13_3_15_15_15
6367,151,1331014320,3,3,3,1331017560,3240,2892120,3643800,751680,19_19_19_19_19_1_1_19_1_1_19_19_19_19_1_19_1_19_19_19_19_19_19_19_19_19_1_19_19_1_1_1_1_1_19_19_19_19_19_19_1_1_19_19_1_1_19_1_1_19_19_19_19_19_19_19_19_19_19_19_19_19_19_19_1_1_47_47_3_3_3_3_2_3
6368,220,1331014500,0,0,0,1331014560,60,670140,2714040,2043900,0_0_0_0_1_0_1_0_0_0_0_0_1_0_0_1_0_0_0_0_0_0_0_0_0_0_0_0_0_0_0_1_1_0_1_1_1_1_0
6369,220,1331014560,0,0,1,1331014620,60,670200,2714040,2043840,0_0_0_0_1_0_1_0_0_0_0_0_1_0_0_1_0_0_0_0_0_0_0_0_0_0_0_0_0_0_0_1_1_0_1_1_1_1_0_0
6370,25,1331014620,8,6,16,1331022180,7560,37020,1951380,1914360,16_16_16_8_8_16_16_8_8
6371,220,1331014620,1,9,1,1331019120,4500,670260,2714040,2043780,0_0_0_0_1_0_1_0_0_0_0_0_1_0_0_1_0_0_0_0_0_0_0_0_0_0_0_0_0_0_0_1_1_0_1_1_1_1_0_0_1
6372,18,1331015700,0,0,0,1331020080,4380,82440,1779540,1697100,0_0_0_0_0_0_0
6373,18,1331015700,0,0,0,1331015700,0,82440,1779540,1697100,0_0_0_0_0_0
6374,196,1331016000,7,10,1,1331032800,16800,1215300,3281700,2066400,7_7_7_7_7_7_7_7_7_7_7_7_7_7_7_7_7_7_7_7_1_1_1_1_7_7_1_1_7_7_1_1_7_7_7_1_1_7_7_7_7_7_7_7_7_7_1_1_7_7_7_30_30_7_1_7_7_1_7_1_1_7_7_7_1_7_7
6375,107,1331017200,1,18,1,1331022600,5400,3090600,4991760,1901160,8_8_8_8_28_28_28_28_28_28_8_8_8_8_16_16_16_16_16_1_16_16_16_1_16_16_16_16_1_16_1_16_16_16_16_16_16_16_1_16_1_16_16_16_16_16_1_1_16_16_16_1_1_16_16_16_16_16_16_16_16_16_1_1_1_1_1_1_1
6376,151,1331017560,3,4,2,1331017860,300,2895360,3643800,748440,19_19_19_19_19_1_1_19_1_1_19_19_19_19_1_19_1_19_19_19_19_19_19_19_19_19_1_19_19_1_1_1_1_1_19_19_19_19_19_19_1_1_19_19_1_1_19_1_1_19_19_19_19_19_19_19_19_19_19_19_19_19_19_19_1_1_47_47_3_3_3_3_2_3_3
6377,181,1331017740,26,13,26,1331150760,133020,5340,189540,184200,26_26
6378,5,1331017800,10,13,10,1331021880,4080,0,748200,748200,10
6379,151,1331017860,2,4,3,1331019120,1260,2895660,3643800,748140,19_19_19_19_19_1_1_19_1_1_19_19_19_19_1_19_1_19_19_19_19_19_19_19_19_19_1_19_19_1_1_1_1_1_19_19_19_19_19_19_1_1_19_19_1_1_19_1_1_19_19_19_19_19_19_19_19_19_19_19_19_19_19_19_1_1_47_47_3_3_3_3_2_3_3_2
6380,141,1331018580,34,17,5,1332050400,1031820,5365380,7406100,2040720,1_1_16_16_16_16_16_1_16_16_1_1_1_16_16_16_16_16_16_16_16_16_16_16_16_16_16_16_1_1_1_1_1_1_1_1_1_1_1_1_16_2_2_16_3_3_3_3_3_3_18_18_18_18_18_3_18_3_3_3_5_5_5_5_5_5_3_3_4_4_4_4_4_3_1_3_1_4_18_3_3_18_18_1_1_18_18_5_5_18_5_5_5_5_6_6_5_5_6_6_6_6_5_5_5_5_5_5_5_5_6_6_5_5_5_5_5_5_5_5_5_5_5_5_34_34_34_34
6381,76,1331018580,34,17,34,1331026980,8400,5476980,7552500,2075520,3_3_3_3_3_3_3_3_3_18_3_18_18_18_18_18_3_3_3_1_1_3_17_17_17_18_17_17_18_18_18_18_18_17_17_18_3_3_18_17_18_18_17_18_18_17_17_17_5_5_5_5_1_1_17_17_17_2_2_17_17_17_5_5_5_5_5_5_17_17_5_5_5_17_5_5_5_5_5_17_17_17_1_1_1_1_1_1_1_1_2_2_34_34_5_5_5_5_6_6_3_3_4_3_3_4_4_4_4_4_3_3_3_3_3_3_4_3_3_3_3_4_4_4_3_4_4_4_3_4_4_4_3_3_4_4_4_4_5_3_3_5_5_5_5_5_4_5_4_5_4_3_3_3_3_4_3_3_4_4_5_5_5_4_5_5_5_4_6_6_34
6382,220,1331019120,1,9,2,1331546400,527280,674760,2714040,2039280,0_0_0_0_1_0_1_0_0_0_0_0_1_0_0_1_0_0_0_0_0_0_0_0_0_0_0_0_0_0_0_1_1_0_1_1_1_1_0_0_1_1
6383,151,1331019120,3,4,3,1331022180,3060,2896920,3643800,746880,19_19_19_19_19_1_1_19_1_1_19_19_19_19_1_19_1_19_19_19_19_19_19_19_19_19_1_19_19_1_1_1_1_1_19_19_19_19_19_19_1_1_19_19_1_1_19_1_1_19_19_19_19_19_19_19_19_19_19_19_19_19_19_19_1_1_47_47_3_3_3_3_2_3_3_2_3
6384,18,1331020080,0,0,0,1331020140,60,86820,1779540,1692720,0_0_0_0_0_0_0_0
6385,18,1331020140,0,0,1,1331022600,2460,86880,1779540,1692660,0_0_0_0_0_0_0_0_0
6386,32,1331021880,10,13,1,1331041800,19920,0,1205580,1205580,10
6387,5,1331021880,10,13,10,1331173140,151260,4080,748200,744120,10_10
6388,25,1331022180,16,20,0,1331716620,694440,44580,1951380,1906800,16_16_16_8_8_16_16_8_8_16
6389,151,1331022180,3,4,3,1331028360,6180,2899980,3643800,743820,19_19_19_19_19_1_1_19_1_1_19_19_19_19_1_19_1_19_19_19_19_19_19_19_19_19_1_19_19_1_1_1_1_1_19_19_19_19_19_19_1_1_19_19_1_1_19_1_1_19_19_19_19_19_19_19_19_19_19_19_19_19_19_19_1_1_47_47_3_3_3_3_2_3_3_2_3_3
6390,218,1331022420,15,9,6,1331071200,48780,1922100,1974480,52380,19_19_19_19_19_19_1_1_1_1_1_1_13_13_2_2_3_13_13_3_15_15_15_15
6391,31,1331022540,19,11,19,1331022540,0,176520,1374660,1198140,19_19_19_19_19_19_19_19_1_1_19_19_19_19_19_3_19_19_3_19_1_19_1_19
6392,31,1331022540,19,11,1,1331033640,11100,176520,1374660,1198140,19_19_19_19_19_19_19_19_1_1_19_19_19_19_19_3_19_19_3_19_1_19_1_19_19
6393,107,1331022600,1,18,6,1332882000,1859400,3096000,4991760,1895760,8_8_8_8_28_28_28_28_28_28_8_8_8_8_16_16_16_16_16_1_16_16_16_1_16_16_16_16_1_16_1_16_16_16_16_16_16_16_1_16_1_16_16_16_16_16_1_1_16_16_16_1_1_16_16_16_16_16_16_16_16_16_1_1_1_1_1_1_1_1
6394,18,1331022600,1,18,1,1331028000,5400,89340,1779540,1690200,0_0_0_0_0_0_0_0_0_1
6395,210,1331023740,5,9,5,1331033640,9900,1037100,1118160,81060,10_10_10_10_10_10_10_10_10_10_1_1_10_10_1_1_2_2_9_9_14_14_14_14_5_5_6_6_5_5_5
6396,76,1331026980,34,17,5,1331883240,856260,5485380,7552500,2067120,3_3_3_3_3_3_3_3_3_18_3_18_18_18_18_18_3_3_3_1_1_3_17_17_17_18_17_17_18_18_18_18_18_17_17_18_3_3_18_17_18_18_17_18_18_17_17_17_5_5_5_5_1_1_17_17_17_2_2_17_17_17_5_5_5_5_5_5_17_17_5_5_5_17_5_5_5_5_5_17_17_17_1_1_1_1_1_1_1_1_2_2_34_34_5_5_5_5_6_6_3_3_4_3_3_4_4_4_4_4_3_3_3_3_3_3_4_3_3_3_3_4_4_4_3_4_4_4_3_4_4_4_3_3_4_4_4_4_5_3_3_5_5_5_5_5_4_5_4_5_4_3_3_3_3_4_3_3_4_4_5_5_5_4_5_5_5_4_6_6_34_34
6397,18,1331028000,1,18,1,1331031000,3000,94740,1779540,1684800,0_0_0_0_0_0_0_0_0_1_1_1
6398,18,1331028000,1,18,1,1331028000,0,94740,1779540,1684800,0_0_0_0_0_0_0_0_0_1_1
6399,151,1331028360,3,3,3,1331031240,2880,2906160,3643800,737640,19_19_19_19_19_1_1_19_1_1_19_19_19_19_1_19_1_19_19_19_19_19_19_19_19_19_1_19_19_1_1_1_1_1_19_19_19_19_19_19_1_1_19_19_1_1_19_1_1_19_19_19_19_19_19_19_19_19_19_19_19_19_19_19_1_1_47_47_3_3_3_3_2_3_3_2_3_3_3
6400,75,1331028420,3,3,3,1331033520,5100,4919880,6135000,1215120,16_16_16_16_16_16_1_16_16_1_16_16_16_16_16_16_16_16_1_1_2_2_39_39_1_1_3_3_3
6401,146,1331028840,34,17,34,1331042640,13800,5501640,6670800,1169160,16_16_16_16_16_16_16_1_16_1_16_1_1_16_1_16_16_2_1_1_16_1_2_16_2_2_3_3_3_3_21_21_3_3_3_3_3_21_3_21_3_3_3_3_21_3_21_3_18_18_18_18_18_18_3_3_3_3_4_4_4_4_4_4_4_4_4_4_4_4_4_4_4_4_4_4_18_18_4_4_4_4_4_3_3_4_4_4_5_5_6_6_5_5_6_6_5_5_34_34_34_34_34
6402,18,1331031000,1,18,0,1331034480,3480,97740,1779540,1681800,0_0_0_0_0_0_0_0_0_1_1_1_1
6403,151,1331031240,3,4,3,1331044500,13260,2909040,3643800,734760,19_19_19_19_19_1_1_19_1_1_19_19_19_19_1_19_1_19_19_19_19_19_19_19_19_19_1_19_19_1_1_1_1_1_19_19_19_19_19_19_1_1_19_19_1_1_19_1_1_19_19_19_19_19_19_19_19_19_19_19_19_19_19_19_1_1_47_47_3_3_3_3_2_3_3_2_3_3_3_3
6404,196,1331032800,1,18,1,1331035200,2400,1232100,3281700,2049600,7_7_7_7_7_7_7_7_7_7_7_7_7_7_7_7_7_7_7_7_1_1_1_1_7_7_1_1_7_7_1_1_7_7_7_1_1_7_7_7_7_7_7_7_7_7_1_1_7_7_7_30_30_7_1_7_7_1_7_1_1_7_7_7_1_7_7_1
6405,75,1331033520,3,3,3,1331071200,37680,4924980,6135000,1210020,16_16_16_16_16_16_1_16_16_1_16_16_16_16_16_16_16_16_1_1_2_2_39_39_1_1_3_3_3_3
6406,31,1331033640,1,9,3,1331033700,60,187620,1374660,1187040,19_19_19_19_19_19_19_19_1_1_19_19_19_19_19_3_19_19_3_19_1_19_1_19_19_1
6407,210,1331033640,5,9,5,1331035860,2220,1047000,1118160,71160,10_10_10_10_10_10_10_10_10_10_1_1_10_10_1_1_2_2_9_9_14_14_14_14_5_5_6_6_5_5_5_5
6408,31,1331033700,3,3,1,1331038140,4440,187680,1374660,1186980,19_19_19_19_19_19_19_19_1_1_19_19_19_19_19_3_19_19_3_19_1_19_1_19_19_1_3
6409,54,1331033700,5,9,5,1331038260,4560,1272900,1314000,41100,7_7_7_7_7_7_7_7_7_7_1_1_5_5_1_1_2_2_3_3_5
6410,18,1331034480,0,0,9,1331210760,176280,101220,1779540,1678320,0_0_0_0_0_0_0_0_0_1_1_1_1_0
6411,196,1331035200,1,18,1,1331039040,3840,1234500,3281700,2047200,7_7_7_7_7_7_7_7_7_7_7_7_7_7_7_7_7_7_7_7_1_1_1_1_7_7_1_1_7_7_1_1_7_7_7_1_1_7_7_7_7_7_7_7_7_7_1_1_7_7_7_30_30_7_1_7_7_1_7_1_1_7_7_7_1_7_7_1_1
6412,210,1331035860,5,9,5,1331040360,4500,1049220,1118160,68940,10_10_10_10_10_10_10_10_10_10_1_1_10_10_1_1_2_2_9_9_14_14_14_14_5_5_6_6_5_5_5_5_5
6413,31,1331038140,1,9,3,1331039520,1380,192120,1374660,1182540,19_19_19_19_19_19_19_19_1_1_19_19_19_19_19_3_19_19_3_19_1_19_1_19_19_1_3_1
6414,54,1331038260,5,9,5,1331043840,5580,1277460,1314000,36540,7_7_7_7_7_7_7_7_7_7_1_1_5_5_1_1_2_2_3_3_5_5
6415,196,1331039040,1,18,7,1331060460,21420,1238340,3281700,2043360,7_7_7_7_7_7_7_7_7_7_7_7_7_7_7_7_7_7_7_7_1_1_1_1_7_7_1_1_7_7_1_1_7_7_7_1_1_7_7_7_7_7_7_7_7_7_1_1_7_7_7_30_30_7_1_7_7_1_7_1_1_7_7_7_1_7_7_1_1_1
6416,31,1331039520,3,3,19,1331041980,2460,193500,1374660,1181160,19_19_19_19_19_19_19_19_1_1_19_19_19_19_19_3_19_19_3_19_1_19_1_19_19_1_3_1_3
6417,210,1331040360,5,9,34,1331042700,2340,1053720,1118160,64440,10_10_10_10_10_10_10_10_10_10_1_1_10_10_1_1_2_2_9_9_14_14_14_14_5_5_6_6_5_5_5_5_5_5
6418,63,1331041800,18,23,18,1331048520,6720,4190340,6232860,2042520,16_16_16_16_16_16_16_16_16_0_0_16_16_0_16_16_0_16_16_0_0_16_16_16_0_0_16_0_0_16_0_16_0_0_0_16_1_1_1_16_16_16_0_1_1_1_16_0_0_16_16_0_16_0_16_0_0_2_2_1_1_0_0_0_0_2_2_2_2_2_2_0_1_0_1_1_0_0_0_1_1_0_0_1_1_1_0_0_0_0_0_2_2_2_2_0_0_0_0_0_0_1_1_1_1_0_0_16_0_16_16_16_16_16_0_0_1_1_2_2_1_1_16_0_2_16_2_2_2_0_1_1_1_1_1_16_16_1_1_1_3_3_18_3_18_3_3_3_3_3_18_18_18_18_3_3_3_3_18_18_18_18_18_18_18_5_5_5_18_5_18_18_18_18_18_5_5_5_18_18_18_5_6_6_5_5_5_5_3_5_18_3_3_3_18_16_18_16_5_18_18_6_3_6_18_3_18_18_5_5_18_5_5_5_5_5_5_5_5_5_18_3_5_3_18_3_3_3_3_18_18_18_18_3_5_5_18_3_18_6_3_6_3_18_3_3_18_18_5_5_3_18_3_5_34_34_3_3_18_5_18_3_2_3_2_18_5_34_18_3_5_5_3_5_3_3_5_18_3_34_3_5_18_18_18_18_18_18_18_18_18
6419,32,1331041800,1,18,1,1331049000,7200,19920,1205580,1185660,10_1
6420,155,1331041800,4,23,4,1331041860,60,2451600,3225180,773580,0_0_0_0_0_0_0_0_1_1_1_1_2_2_9_9_9_9_9_9_9_9_9_9_9_9_4_4_4_4_4_4_4_4
6421,155,1331041860,4,22,3,1331042400,540,2451660,3225180,773520,0_0_0_0_0_0_0_0_1_1_1_1_2_2_9_9_9_9_9_9_9_9_9_9_9_9_4_4_4_4_4_4_4_4_4
6422,31,1331041980,19,11,19,1331062320,20340,195960,1374660,1178700,19_19_19_19_19_19_19_19_1_1_19_19_19_19_19_3_19_19_3_19_1_19_1_19_19_1_3_1_3_19
6423,155,1331042400,3,3,3,1331046000,3600,2452200,3225180,772980,0_0_0_0_0_0_0_0_1_1_1_1_2_2_9_9_9_9_9_9_9_9_9_9_9_9_4_4_4_4_4_4_4_4_4_3
6424,146,1331042640,34,17,5,1331200980,158340,5515440,6670800,1155360,16_16_16_16_16_16_16_1_16_1_16_1_1_16_1_16_16_2_1_1_16_1_2_16_2_2_3_3_3_3_21_21_3_3_3_3_3_21_3_21_3_3_3_3_21_3_21_3_18_18_18_18_18_18_3_3_3_3_4_4_4_4_4_4_4_4_4_4_4_4_4_4_4_4_4_4_18_18_4_4_4_4_4_3_3_4_4_4_5_5_6_6_5_5_6_6_5_5_34_34_34_34_34_34
6425,210,1331042700,34,15,34,1331049900,7200,1056060,1118160,62100,10_10_10_10_10_10_10_10_10_10_1_1_10_10_1_1_2_2_9_9_14_14_14_14_5_5_6_6_5_5_5_5_5_5_34
6426,64,1331042700,11,17,11,1331048700,6000,4942620,6845160,1902540,1_1_11
6427,90,1331042820,3,3,3,1331044500,1680,1328160,1532940,204780,19_19_19_19_19_19_19_19_1_1_19_19_19_19_19_19_19_19_1_1_1_1_9_9_9_9_2_2_2_2_3
6428,54,1331043840,5,9,5,1331043900,60,1283040,1314000,30960,7_7_7_7_7_7_7_7_7_7_1_1_5_5_1_1_2_2_3_3_5_5_5
6429,54,1331043900,5,9,17,1331043960,60,1283100,1314000,30900,7_7_7_7_7_7_7_7_7_7_1_1_5_5_1_1_2_2_3_3_5_5_5_5
6430,54,1331043960,17,9,17,1331044200,240,1283160,1314000,30840,7_7_7_7_7_7_7_7_7_7_1_1_5_5_1_1_2_2_3_3_5_5_5_5_17
6431,54,1331044200,17,9,6,1331071200,27000,1283400,1314000,30600,7_7_7_7_7_7_7_7_7_7_1_1_5_5_1_1_2_2_3_3_5_5_5_5_17_17
6432,151,1331044500,3,3,3,1331048400,3900,2922300,3643800,721500,19_19_19_19_19_1_1_19_1_1_19_19_19_19_1_19_1_19_19_19_19_19_19_19_19_19_1_19_19_1_1_1_1_1_19_19_19_19_19_19_1_1_19_19_1_1_19_1_1_19_19_19_19_19_19_19_19_19_19_19_19_19_19_19_1_1_47_47_3_3_3_3_2_3_3_2_3_3_3_3_3
6433,90,1331044500,3,3,3,1331110740,66240,1329840,1532940,203100,19_19_19_19_19_19_19_19_1_1_19_19_19_19_19_19_19_19_1_1_1_1_9_9_9_9_2_2_2_2_3_3
6434,155,1331046000,3,3,4,1331048520,2520,2455800,3225180,769380,0_0_0_0_0_0_0_0_1_1_1_1_2_2_9_9_9_9_9_9_9_9_9_9_9_9_4_4_4_4_4_4_4_4_4_3_3
6435,151,1331048400,3,3,4,1331166120,117720,2926200,3643800,717600,19_19_19_19_19_1_1_19_1_1_19_19_19_19_1_19_1_19_19_19_19_19_19_19_19_19_1_19_19_1_1_1_1_1_19_19_19_19_19_19_1_1_19_19_1_1_19_1_1_19_19_19_19_19_19_19_19_19_19_19_19_19_19_19_1_1_47_47_3_3_3_3_2_3_3_2_3_3_3_3_3_3
6436,155,1331048520,4,23,4,1331056920,8400,2458320,3225180,766860,0_0_0_0_0_0_0_0_1_1_1_1_2_2_9_9_9_9_9_9_9_9_9_9_9_9_4_4_4_4_4_4_4_4_4_3_3_4
6437,63,1331048520,18,23,18,1331057400,8880,4197060,6232860,2035800,16_16_16_16_16_16_16_16_16_0_0_16_16_0_16_16_0_16_16_0_0_16_16_16_0_0_16_0_0_16_0_16_0_0_0_16_1_1_1_16_16_16_0_1_1_1_16_0_0_16_16_0_16_0_16_0_0_2_2_1_1_0_0_0_0_2_2_2_2_2_2_0_1_0_1_1_0_0_0_1_1_0_0_1_1_1_0_0_0_0_0_2_2_2_2_0_0_0_0_0_0_1_1_1_1_0_0_16_0_16_16_16_16_16_0_0_1_1_2_2_1_1_16_0_2_16_2_2_2_0_1_1_1_1_1_16_16_1_1_1_3_3_18_3_18_3_3_3_3_3_18_18_18_18_3_3_3_3_18_18_18_18_18_18_18_5_5_5_18_5_18_18_18_18_18_5_5_5_18_18_18_5_6_6_5_5_5_5_3_5_18_3_3_3_18_16_18_16_5_18_18_6_3_6_18_3_18_18_5_5_18_5_5_5_5_5_5_5_5_5_18_3_5_3_18_3_3_3_3_18_18_18_18_3_5_5_18_3_18_6_3_6_3_18_3_3_18_18_5_5_3_18_3_5_34_34_3_3_18_5_18_3_2_3_2_18_5_34_18_3_5_5_3_5_3_3_5_18_3_34_3_5_18_18_18_18_18_18_18_18_18_18
6438,64,1331048700,11,17,5,1331127900,79200,4948620,6845160,1896540,1_1_11_11
6439,32,1331049000,1,18,10,1331050860,1860,27120,1205580,1178460,10_1_1
6440,81,1331049600,14,15,14,1331055600,6000,0,111600,111600,14
6441,210,1331049900,34,15,6,1331071200,21300,1063260,1118160,54900,10_10_10_10_10_10_10_10_10_10_1_1_10_10_1_1_2_2_9_9_14_14_14_14_5_5_6_6_5_5_5_5_5_5_34_34
6442,32,1331050860,10,13,10,1331124120,73260,28980,1205580,1176600,10_1_1_10
6443,81,1331055600,14,15,14,1331058600,3000,6000,111600,105600,14_14_14
6444,81,1331055600,14,15,14,1331055600,0,6000,111600,105600,14_14
6445,155,1331056920,4,5,3,1331062800,5880,2466720,3225180,758460,0_0_0_0_0_0_0_0_1_1_1_1_2_2_9_9_9_9_9_9_9_9_9_9_9_9_4_4_4_4_4_4_4_4_4_3_3_4_4
6446,63,1331057400,18,19,18,1331095680,38280,4205940,6232860,2026920,16_16_16_16_16_16_16_16_16_0_0_16_16_0_16_16_0_16_16_0_0_16_16_16_0_0_16_0_0_16_0_16_0_0_0_16_1_1_1_16_16_16_0_1_1_1_16_0_0_16_16_0_16_0_16_0_0_2_2_1_1_0_0_0_0_2_2_2_2_2_2_0_1_0_1_1_0_0_0_1_1_0_0_1_1_1_0_0_0_0_0_2_2_2_2_0_0_0_0_0_0_1_1_1_1_0_0_16_0_16_16_16_16_16_0_0_1_1_2_2_1_1_16_0_2_16_2_2_2_0_1_1_1_1_1_16_16_1_1_1_3_3_18_3_18_3_3_3_3_3_18_18_18_18_3_3_3_3_18_18_18_18_18_18_18_5_5_5_18_5_18_18_18_18_18_5_5_5_18_18_18_5_6_6_5_5_5_5_3_5_18_3_3_3_18_16_18_16_5_18_18_6_3_6_18_3_18_18_5_5_18_5_5_5_5_5_5_5_5_5_18_3_5_3_18_3_3_3_3_18_18_18_18_3_5_5_18_3_18_6_3_6_3_18_3_3_18_18_5_5_3_18_3_5_34_34_3_3_18_5_18_3_2_3_2_18_5_34_18_3_5_5_3_5_3_3_5_18_3_34_3_5_18_18_18_18_18_18_18_18_18_18_18
6447,206,1331058060,16,14,16,1331070660,12600,0,2086740,2086740,16
6448,81,1331058600,14,15,5,1331123400,64800,9000,111600,102600,14_14_14_14
6449,196,1331060460,7,12,7,1331084220,23760,1259760,3281700,2021940,7_7_7_7_7_7_7_7_7_7_7_7_7_7_7_7_7_7_7_7_1_1_1_1_7_7_1_1_7_7_1_1_7_7_7_1_1_7_7_7_7_7_7_7_7_7_1_1_7_7_7_30_30_7_1_7_7_1_7_1_1_7_7_7_1_7_7_1_1_1_7
6450,31,1331062320,19,16,2,1331069640,7320,216300,1374660,1158360,19_19_19_19_19_19_19_19_1_1_19_19_19_19_19_3_19_19_3_19_1_19_1_19_19_1_3_1_3_19_19
6451,155,1331062800,3,15,4,1331065440,2640,2472600,3225180,752580,0_0_0_0_0_0_0_0_1_1_1_1_2_2_9_9_9_9_9_9_9_9_9_9_9_9_4_4_4_4_4_4_4_4_4_3_3_4_4_3
6452,155,1331065440,4,5,3,1331065500,60,2475240,3225180,749940,0_0_0_0_0_0_0_0_1_1_1_1_2_2_9_9_9_9_9_9_9_9_9_9_9_9_4_4_4_4_4_4_4_4_4_3_3_4_4_3_4
6453,155,1331065500,3,15,4,1331065800,300,2475300,3225180,749880,0_0_0_0_0_0_0_0_1_1_1_1_2_2_9_9_9_9_9_9_9_9_9_9_9_9_4_4_4_4_4_4_4_4_4_3_3_4_4_3_4_3
6454,110,1331065800,34,15,34,1331069700,3900,5524200,5579400,55200,1_1_0_0_1_1_1_1_2_2_2_2_4_4_4_4_4_4_4_4_4_4_4_4_4_4_4_4_4_4_4_4_4_4_4_4_4_4_4_4_4_4_4_4_4_4_4_4_4_4_4_4_5_5_6_6_5_5_5_5_18_18_18_18_18_18_5_5_5_5_5_5_6_6_34
6455,155,1331065800,4,19,4,1331089200,23400,2475600,3225180,749580,0_0_0_0_0_0_0_0_1_1_1_1_2_2_9_9_9_9_9_9_9_9_9_9_9_9_4_4_4_4_4_4_4_4_4_3_3_4_4_3_4_3_4
6456,31,1331069640,2,5,6,1331071200,1560,223620,1374660,1151040,19_19_19_19_19_19_19_19_1_1_19_19_19_19_19_3_19_19_3_19_1_19_1_19_19_1_3_1_3_19_19_2
6457,110,1331069700,34,15,34,1331109000,39300,5528100,5579400,51300,1_1_0_0_1_1_1_1_2_2_2_2_4_4_4_4_4_4_4_4_4_4_4_4_4_4_4_4_4_4_4_4_4_4_4_4_4_4_4_4_4_4_4_4_4_4_4_4_4_4_4_4_5_5_6_6_5_5_5_5_18_18_18_18_18_18_5_5_5_5_5_5_6_6_34_34
6458,206,1331070660,16,14,16,1331095920,25260,12600,2086740,2074140,16_16_16
6459,206,1331070660,16,14,16,1331070660,0,12600,2086740,2074140,16_16
6460,169,1331071200,3,4,3,1331075700,4500,1409460,2190660,781200,50_50_50_50_50_50_50_50_50_50_50_50_50_50_50_50_50_1_1_50_50_50_50_1_1_50_50_50_50_50_50_50_50_1_1_50_3_3_50_2_50_2_50_50_50_6_6_3_3_50_5_2_2_2_2_5_50_50_1_1_2_2_3_3_3_3_3
6461,210,1331071200,6,7,6,1331071200,0,1084560,1118160,33600,10_10_10_10_10_10_10_10_10_10_1_1_10_10_1_1_2_2_9_9_14_14_14_14_5_5_6_6_5_5_5_5_5_5_34_34_6
6462,218,1331071200,6,7,6,1331074800,3600,1970880,1974480,3600,19_19_19_19_19_19_1_1_1_1_1_1_13_13_2_2_3_13_13_3_15_15_15_15_6
6463,188,1331071200,3,4,3,1331075700,4500,2399160,4327560,1928400,0_0_0_0_0_1_1_0_0_0_0_0_0_0_0_0_1_1_2_2_2_2_3
6464,169,1331071200,3,4,3,1331071200,0,1409460,2190660,781200,50_50_50_50_50_50_50_50_50_50_50_50_50_50_50_50_50_1_1_50_50_50_50_1_1_50_50_50_50_50_50_50_50_1_1_50_3_3_50_2_50_2_50_50_50_6_6_3_3_50_5_2_2_2_2_5_50_50_1_1_2_2_3_3_3_3
6465,169,1331071200,3,4,3,1331071200,0,1409460,2190660,781200,50_50_50_50_50_50_50_50_50_50_50_50_50_50_50_50_50_1_1_50_50_50_50_1_1_50_50_50_50_50_50_50_50_1_1_50_3_3_50_2_50_2_50_50_50_6_6_3_3_50_5_2_2_2_2_5_50_50_1_1_2_2_3_3_3
6466,75,1331071200,3,4,3,1331075700,4500,4962660,6135000,1172340,16_16_16_16_16_16_1_16_16_1_16_16_16_16_16_16_16_16_1_1_2_2_39_39_1_1_3_3_3_3_3
6467,54,1331071200,6,7,6,1331074800,3600,1310400,1314000,3600,7_7_7_7_7_7_7_7_7_7_1_1_5_5_1_1_2_2_3_3_5_5_5_5_17_17_6
6468,210,1331071200,6,7,6,1331074800,3600,1084560,1118160,33600,10_10_10_10_10_10_10_10_10_10_1_1_10_10_1_1_2_2_9_9_14_14_14_14_5_5_6_6_5_5_5_5_5_5_34_34_6_6
6469,31,1331071200,6,7,6,1331074800,3600,225180,1374660,1149480,19_19_19_19_19_19_19_19_1_1_19_19_19_19_19_3_19_19_3_19_1_19_1_19_19_1_3_1_3_19_19_2_6
6470,54,1331074800,6,7,99,1331074800,0,1314000,1314000,0,7_7_7_7_7_7_7_7_7_7_1_1_5_5_1_1_2_2_3_3_5_5_5_5_17_17_6_6
6471,31,1331074800,6,7,2,1331077380,2580,228780,1374660,1145880,19_19_19_19_19_19_19_19_1_1_19_19_19_19_19_3_19_19_3_19_1_19_1_19_19_1_3_1_3_19_19_2_6_6
6472,210,1331074800,6,7,6,1331074800,0,1088160,1118160,30000,10_10_10_10_10_10_10_10_10_10_1_1_10_10_1_1_2_2_9_9_14_14_14_14_5_5_6_6_5_5_5_5_5_5_34_34_6_6_6
6473,218,1331074800,6,7,99,1331074800,0,1974480,1974480,0,19_19_19_19_19_19_1_1_1_1_1_1_13_13_2_2_3_13_13_3_15_15_15_15_6_6
6474,210,1331074800,6,7,5,1331100960,26160,1088160,1118160,30000,10_10_10_10_10_10_10_10_10_10_1_1_10_10_1_1_2_2_9_9_14_14_14_14_5_5_6_6_5_5_5_5_5_5_34_34_6_6_6_6
6475,169,1331075700,3,4,5,1331470800,395100,1413960,2190660,776700,50_50_50_50_50_50_50_50_50_50_50_50_50_50_50_50_50_1_1_50_50_50_50_1_1_50_50_50_50_50_50_50_50_1_1_50_3_3_50_2_50_2_50_50_50_6_6_3_3_50_5_2_2_2_2_5_50_50_1_1_2_2_3_3_3_3_3_3_3_3
6476,169,1331075700,3,4,3,1331075700,0,1413960,2190660,776700,50_50_50_50_50_50_50_50_50_50_50_50_50_50_50_50_50_1_1_50_50_50_50_1_1_50_50_50_50_50_50_50_50_1_1_50_3_3_50_2_50_2_50_50_50_6_6_3_3_50_5_2_2_2_2_5_50_50_1_1_2_2_3_3_3_3_3_3
6477,188,1331075700,3,4,3,1331157600,81900,2403660,4327560,1923900,0_0_0_0_0_1_1_0_0_0_0_0_0_0_0_0_1_1_2_2_2_2_3_3
6478,169,1331075700,3,4,3,1331075700,0,1413960,2190660,776700,50_50_50_50_50_50_50_50_50_50_50_50_50_50_50_50_50_1_1_50_50_50_50_1_1_50_50_50_50_50_50_50_50_1_1_50_3_3_50_2_50_2_50_50_50_6_6_3_3_50_5_2_2_2_2_5_50_50_1_1_2_2_3_3_3_3_3_3_3
6479,75,1331075700,3,4,3,1331130300,54600,4967160,6135000,1167840,16_16_16_16_16_16_1_16_16_1_16_16_16_16_16_16_16_16_1_1_2_2_39_39_1_1_3_3_3_3_3_3
6480,31,1331077380,2,5,19,1331095800,18420,231360,1374660,1143300,19_19_19_19_19_19_19_19_1_1_19_19_19_19_19_3_19_19_3_19_1_19_1_19_19_1_3_1_3_19_19_2_6_6_2
6481,196,1331084220,7,12,30,1331085600,1380,1283520,3281700,1998180,7_7_7_7_7_7_7_7_7_7_7_7_7_7_7_7_7_7_7_7_1_1_1_1_7_7_1_1_7_7_1_1_7_7_7_1_1_7_7_7_7_7_7_7_7_7_1_1_7_7_7_30_30_7_1_7_7_1_7_1_1_7_7_7_1_7_7_1_1_1_7_7
6482,196,1331085600,30,27,30,1331089200,3600,1284900,3281700,1996800,7_7_7_7_7_7_7_7_7_7_7_7_7_7_7_7_7_7_7_7_1_1_1_1_7_7_1_1_7_7_1_1_7_7_7_1_1_7_7_7_7_7_7_7_7_7_1_1_7_7_7_30_30_7_1_7_7_1_7_1_1_7_7_7_1_7_7_1_1_1_7_7_30
6483,196,1331089200,30,27,1,1331096220,7020,1288500,3281700,1993200,7_7_7_7_7_7_7_7_7_7_7_7_7_7_7_7_7_7_7_7_1_1_1_1_7_7_1_1_7_7_1_1_7_7_7_1_1_7_7_7_7_7_7_7_7_7_1_1_7_7_7_30_30_7_1_7_7_1_7_1_1_7_7_7_1_7_7_1_1_1_7_7_30_30
6484,155,1331089200,4,19,4,1331089200,0,2499000,3225180,726180,0_0_0_0_0_0_0_0_1_1_1_1_2_2_9_9_9_9_9_9_9_9_9_9_9_9_4_4_4_4_4_4_4_4_4_3_3_4_4_3_4_3_4_4
6485,155,1331089200,4,5,4,1331095800,6600,2499000,3225180,726180,0_0_0_0_0_0_0_0_1_1_1_1_2_2_9_9_9_9_9_9_9_9_9_9_9_9_4_4_4_4_4_4_4_4_4_3_3_4_4_3_4_3_4_4_4
6486,63,1331095680,18,19,18,1331096280,600,4244220,6232860,1988640,16_16_16_16_16_16_16_16_16_0_0_16_16_0_16_16_0_16_16_0_0_16_16_16_0_0_16_0_0_16_0_16_0_0_0_16_1_1_1_16_16_16_0_1_1_1_16_0_0_16_16_0_16_0_16_0_0_2_2_1_1_0_0_0_0_2_2_2_2_2_2_0_1_0_1_1_0_0_0_1_1_0_0_1_1_1_0_0_0_0_0_2_2_2_2_0_0_0_0_0_0_1_1_1_1_0_0_16_0_16_16_16_16_16_0_0_1_1_2_2_1_1_16_0_2_16_2_2_2_0_1_1_1_1_1_16_16_1_1_1_3_3_18_3_18_3_3_3_3_3_18_18_18_18_3_3_3_3_18_18_18_18_18_18_18_5_5_5_18_5_18_18_18_18_18_5_5_5_18_18_18_5_6_6_5_5_5_5_3_5_18_3_3_3_18_16_18_16_5_18_18_6_3_6_18_3_18_18_5_5_18_5_5_5_5_5_5_5_5_5_18_3_5_3_18_3_3_3_3_18_18_18_18_3_5_5_18_3_18_6_3_6_3_18_3_3_18_18_5_5_3_18_3_5_34_34_3_3_18_5_18_3_2_3_2_18_5_34_18_3_5_5_3_5_3_3_5_18_3_34_3_5_18_18_18_18_18_18_18_18_18_18_18_18
6487,31,1331095800,19,16,19,1331096340,540,249780,1374660,1124880,19_19_19_19_19_19_19_19_1_1_19_19_19_19_19_3_19_19_3_19_1_19_1_19_19_1_3_1_3_19_19_2_6_6_2_19
6488,155,1331095800,4,5,4,1331096400,600,2505600,3225180,719580,0_0_0_0_0_0_0_0_1_1_1_1_2_2_9_9_9_9_9_9_9_9_9_9_9_9_4_4_4_4_4_4_4_4_4_3_3_4_4_3_4_3_4_4_4_4
6489,206,1331095920,16,14,1,1331119200,23280,37860,2086740,2048880,16_16_16_16
6490,172,1331096040,1,9,1,1331097120,1080,169200,1443960,1274760,10_10_10_1_10_10_1_10_10_10_10_10_1
6491,196,1331096220,1,18,1,1331097900,1680,1295520,3281700,1986180,7_7_7_7_7_7_7_7_7_7_7_7_7_7_7_7_7_7_7_7_1_1_1_1_7_7_1_1_7_7_1_1_7_7_7_1_1_7_7_7_7_7_7_7_7_7_1_1_7_7_7_30_30_7_1_7_7_1_7_1_1_7_7_7_1_7_7_1_1_1_7_7_30_30_1
6492,63,1331096280,18,22,18,1331134560,38280,4244820,6232860,1988040,16_16_16_16_16_16_16_16_16_0_0_16_16_0_16_16_0_16_16_0_0_16_16_16_0_0_16_0_0_16_0_16_0_0_0_16_1_1_1_16_16_16_0_1_1_1_16_0_0_16_16_0_16_0_16_0_0_2_2_1_1_0_0_0_0_2_2_2_2_2_2_0_1_0_1_1_0_0_0_1_1_0_0_1_1_1_0_0_0_0_0_2_2_2_2_0_0_0_0_0_0_1_1_1_1_0_0_16_0_16_16_16_16_16_0_0_1_1_2_2_1_1_16_0_2_16_2_2_2_0_1_1_1_1_1_16_16_1_1_1_3_3_18_3_18_3_3_3_3_3_18_18_18_18_3_3_3_3_18_18_18_18_18_18_18_5_5_5_18_5_18_18_18_18_18_5_5_5_18_18_18_5_6_6_5_5_5_5_3_5_18_3_3_3_18_16_18_16_5_18_18_6_3_6_18_3_18_18_5_5_18_5_5_5_5_5_5_5_5_5_18_3_5_3_18_3_3_3_3_18_18_18_18_3_5_5_18_3_18_6_3_6_3_18_3_3_18_18_5_5_3_18_3_5_34_34_3_3_18_5_18_3_2_3_2_18_5_34_18_3_5_5_3_5_3_3_5_18_3_34_3_5_18_18_18_18_18_18_18_18_18_18_18_18_18
6493,31,1331096340,19,11,1,1331097180,840,250320,1374660,1124340,19_19_19_19_19_19_19_19_1_1_19_19_19_19_19_3_19_19_3_19_1_19_1_19_19_1_3_1_3_19_19_2_6_6_2_19_19
6494,155,1331096400,4,23,4,1331101800,5400,2506200,3225180,718980,0_0_0_0_0_0_0_0_1_1_1_1_2_2_9_9_9_9_9_9_9_9_9_9_9_9_4_4_4_4_4_4_4_4_4_3_3_4_4_3_4_3_4_4_4_4_4
6495,172,1331097120,1,9,2,1331812800,715680,170280,1443960,1273680,10_10_10_1_10_10_1_10_10_10_10_10_1_1
6496,31,1331097180,1,9,1,1331098260,1080,251160,1374660,1123500,19_19_19_19_19_19_19_19_1_1_19_19_19_19_19_3_19_19_3_19_1_19_1_19_19_1_3_1_3_19_19_2_6_6_2_19_19_1
6497,173,1331097300,34,17,34,1331109000,11700,3106080,3215700,109620,0_0_0_0_0_0_1_1_0_0_1_1_2_2_3_3_14_14_14_14_14_14_14_18_14_18_18_14_18_18_18_18_13_13_13_14_13_14_18_18_18_14_13_18_13_18_6_6_5_13_5_13_6_6_5_5_34
6498,196,1331097900,1,18,10,1332136140,1038240,1297200,3281700,1984500,7_7_7_7_7_7_7_7_7_7_7_7_7_7_7_7_7_7_7_7_1_1_1_1_7_7_1_1_7_7_1_1_7_7_7_1_1_7_7_7_7_7_7_7_7_7_1_1_7_7_7_30_30_7_1_7_7_1_7_1_1_7_7_7_1_7_7_1_1_1_7_7_30_30_1_1
6499,57,1331098200,8,18,8,1331102400,4200,830460,2756640,1926180,26_26_26_26_26_26_26_26_26_26_26_26_26_26_26_26_26_26_26_26_26_26_26_26_26_8_8_8_8_2_2_26_8_8_26_26_26_26_26_26_26_26_8_8_26_26_26_26_26_26_8
6500,31,1331098260,1,9,5,1331098320,60,252240,1374660,1122420,19_19_19_19_19_19_19_19_1_1_19_19_19_19_19_3_19_19_3_19_1_19_1_19_19_1_3_1_3_19_19_2_6_6_2_19_19_1_1
6501,31,1331098320,5,9,5,1331102820,4500,252300,1374660,1122360,19_19_19_19_19_19_19_19_1_1_19_19_19_19_19_3_19_19_3_19_1_19_1_19_19_1_3_1_3_19_19_2_6_6_2_19_19_1_1_5
6502,26,1331098740,1,6,1,1331102340,3600,249900,2036760,1786860,16_16_16_16_16_16_16_1_1_16_1
6503,17,1331099760,1,9,1,1331100240,480,625980,626460,480,19_19_1_19_19_1_19_19_1_1_1_1_1
6504,17,1331100240,1,9,99,1331100240,0,626460,626460,0,19_19_1_19_19_1_19_19_1_1_1_1_1_1
6505,210,1331100960,5,9,5,1331104800,3840,1114320,1118160,3840,10_10_10_10_10_10_10_10_10_10_1_1_10_10_1_1_2_2_9_9_14_14_14_14_5_5_6_6_5_5_5_5_5_5_34_34_6_6_6_6_5
6506,155,1331101800,4,23,5,1331643360,541560,2511600,3225180,713580,0_0_0_0_0_0_0_0_1_1_1_1_2_2_9_9_9_9_9_9_9_9_9_9_9_9_4_4_4_4_4_4_4_4_4_3_3_4_4_3_4_3_4_4_4_4_4_4
6507,10,1331101800,4,23,4,1331111760,9960,803520,979740,176220,0_0_0_1_1_0_0_0_1_1_2_2_9_9_9_9_3_3_3_3_4
6508,26,1331102340,1,6,2,1331104080,1740,253500,2036760,1783260,16_16_16_16_16_16_16_1_1_16_1_1
6509,57,1331102400,8,18,8,1331190120,87720,834660,2756640,1921980,26_26_26_26_26_26_26_26_26_26_26_26_26_26_26_26_26_26_26_26_26_26_26_26_26_8_8_8_8_2_2_26_8_8_26_26_26_26_26_26_26_26_8_8_26_26_26_26_26_26_8_8
6510,31,1331102820,5,9,19,1331127720,24900,256800,1374660,1117860,19_19_19_19_19_19_19_19_1_1_19_19_19_19_19_3_19_19_3_19_1_19_1_19_19_1_3_1_3_19_19_2_6_6_2_19_19_1_1_5_5
6511,26,1331104080,2,3,2,1331108580,4500,255240,2036760,1781520,16_16_16_16_16_16_16_1_1_16_1_1_2
6512,208,1331104260,16,20,16,1331132700,28440,0,1620480,1620480,16
6513,210,1331104800,5,9,99,1331104800,0,1118160,1118160,0,10_10_10_10_10_10_10_10_10_10_1_1_10_10_1_1_2_2_9_9_14_14_14_14_5_5_6_6_5_5_5_5_5_5_34_34_6_6_6_6_5_5
6514,26,1331108580,2,3,25,1331110680,2100,259740,2036760,1777020,16_16_16_16_16_16_16_1_1_16_1_1_2_2
6515,173,1331109000,34,17,6,1331157600,48600,3117780,3215700,97920,0_0_0_0_0_0_1_1_0_0_1_1_2_2_3_3_14_14_14_14_14_14_14_18_14_18_18_14_18_18_18_18_13_13_13_14_13_14_18_18_18_14_13_18_13_18_6_6_5_13_5_13_6_6_5_5_34_34
6516,110,1331109000,34,17,34,1331121000,12000,5567400,5579400,12000,1_1_0_0_1_1_1_1_2_2_2_2_4_4_4_4_4_4_4_4_4_4_4_4_4_4_4_4_4_4_4_4_4_4_4_4_4_4_4_4_4_4_4_4_4_4_4_4_4_4_4_4_5_5_6_6_5_5_5_5_18_18_18_18_18_18_5_5_5_5_5_5_6_6_34_34_34
6517,26,1331110680,25,3,9,1331110740,60,261840,2036760,1774920,16_16_16_16_16_16_16_1_1_16_1_1_2_2_25
6518,90,1331110740,3,3,3,1331125560,14820,1396080,1532940,136860,19_19_19_19_19_19_19_19_1_1_19_19_19_19_19_19_19_19_1_1_1_1_9_9_9_9_2_2_2_2_3_3_3
6519,26,1331110740,9,4,25,1331115180,4440,261900,2036760,1774860,16_16_16_16_16_16_16_1_1_16_1_1_2_2_25_9
6520,10,1331111760,4,23,4,1331111880,120,813480,979740,166260,0_0_0_1_1_0_0_0_1_1_2_2_9_9_9_9_3_3_3_3_4_4
6521,10,1331111880,4,23,4,1331122200,10320,813600,979740,166140,0_0_0_1_1_0_0_0_1_1_2_2_9_9_9_9_3_3_3_3_4_4_4
6522,187,1331112480,1,9,1,1331125740,13260,1461660,2496960,1035300,10_10_10_10_10_10_10_10_10_10_10_10_1_1_1
6523,46,1331114400,27,26,27,1331118000,3600,1695360,2027040,331680,26_26_26_26_26_26_26_26_8_8_9_9_3_3_5_5_27
6524,26,1331115180,25,3,9,1331115240,60,266340,2036760,1770420,16_16_16_16_16_16_16_1_1_16_1_1_2_2_25_9_25
6525,26,1331115240,9,4,3,1331125560,10320,266400,2036760,1770360,16_16_16_16_16_16_16_1_1_16_1_1_2_2_25_9_25_9
6526,46,1331118000,28,26,28,1331125200,7200,1698960,2027040,328080,26_26_26_26_26_26_26_26_8_8_9_9_3_3_5_5_27_27_28
6527,46,1331118000,27,26,28,1331118000,0,1698960,2027040,328080,26_26_26_26_26_26_26_26_8_8_9_9_3_3_5_5_27_27
6528,206,1331119200,1,18,1,1331127480,8280,61140,2086740,2025600,16_16_16_16_1
6529,110,1331121000,34,17,99,1331121000,0,5579400,5579400,0,1_1_0_0_1_1_1_1_2_2_2_2_4_4_4_4_4_4_4_4_4_4_4_4_4_4_4_4_4_4_4_4_4_4_4_4_4_4_4_4_4_4_4_4_4_4_4_4_4_4_4_4_5_5_6_6_5_5_5_5_18_18_18_18_18_18_5_5_5_5_5_5_6_6_34_34_34_34
6530,10,1331122200,4,23,4,1331122320,120,823920,979740,155820,0_0_0_1_1_0_0_0_1_1_2_2_9_9_9_9_3_3_3_3_4_4_4_4
6531,10,1331122320,4,22,4,1331128560,6240,824040,979740,155700,0_0_0_1_1_0_0_0_1_1_2_2_9_9_9_9_3_3_3_3_4_4_4_4_4
6532,81,1331123400,5,9,5,1331126220,2820,73800,111600,37800,14_14_14_14_5
6533,32,1331124120,10,13,10,1331139540,15420,102240,1205580,1103340,10_1_1_10_10
6534,46,1331125200,28,26,28,1331143200,18000,1706160,2027040,320880,26_26_26_26_26_26_26_26_8_8_9_9_3_3_5_5_27_27_28_28
6535,26,1331125560,3,3,3,1331129520,3960,276720,2036760,1760040,16_16_16_16_16_16_16_1_1_16_1_1_2_2_25_9_25_9_3
6536,90,1331125560,3,3,5,1331182200,56640,1410900,1532940,122040,19_19_19_19_19_19_19_19_1_1_19_19_19_19_19_19_19_19_1_1_1_1_9_9_9_9_2_2_2_2_3_3_3_3
6537,187,1331125740,1,9,2,1331456640,330900,1474920,2496960,1022040,10_10_10_10_10_10_10_10_10_10_10_10_1_1_1_1
6538,81,1331126220,5,9,6,1331157600,31380,76620,111600,34980,14_14_14_14_5_5
6539,61,1331126400,34,17,34,1331136000,9600,5671200,6225300,554100,4_4_18_18_34_34_34_3_3_34_3_3_34_35_34_35_35_35_36_36_35_35_35_35_34_34_34_34_34_34_34_34_34_34_34_34_34_34_34_34_34
6540,206,1331127480,1,18,2,1331128200,720,69420,2086740,2017320,16_16_16_16_1_1
6541,31,1331127720,19,11,5,1331129160,1440,281700,1374660,1092960,19_19_19_19_19_19_19_19_1_1_19_19_19_19_19_3_19_19_3_19_1_19_1_19_19_1_3_1_3_19_19_2_6_6_2_19_19_1_1_5_5_19
6542,64,1331127900,5,9,5,1331132100,4200,5027820,6845160,1817340,1_1_11_11_5
6543,206,1331128200,2,3,2,1331129460,1260,70140,2086740,2016600,16_16_16_16_1_1_2
6544,10,1331128560,4,22,4,1331128620,60,830280,979740,149460,0_0_0_1_1_0_0_0_1_1_2_2_9_9_9_9_3_3_3_3_4_4_4_4_4_4
6545,10,1331128620,4,15,4,1331141400,12780,830340,979740,149400,0_0_0_1_1_0_0_0_1_1_2_2_9_9_9_9_3_3_3_3_4_4_4_4_4_4_4
6546,31,1331129160,5,9,1,1331131320,2160,283140,1374660,1091520,19_19_19_19_19_19_19_19_1_1_19_19_19_19_19_3_19_19_3_19_1_19_1_19_19_1_3_1_3_19_19_2_6_6_2_19_19_1_1_5_5_19_5
6547,206,1331129460,2,3,3,1332968400,1838940,71400,2086740,2015340,16_16_16_16_1_1_2_2
6548,26,1331129520,3,3,18,1331143860,14340,280680,2036760,1756080,16_16_16_16_16_16_16_1_1_16_1_1_2_2_25_9_25_9_3_3
6549,75,1331130300,3,3,3,1331134200,3900,5021760,6135000,1113240,16_16_16_16_16_16_1_16_16_1_16_16_16_16_16_16_16_16_1_1_2_2_39_39_1_1_3_3_3_3_3_3_3
6550,31,1331131320,1,9,1,1331131380,60,285300,1374660,1089360,19_19_19_19_19_19_19_19_1_1_19_19_19_19_19_3_19_19_3_19_1_19_1_19_19_1_3_1_3_19_19_2_6_6_2_19_19_1_1_5_5_19_5_1
6551,31,1331131380,1,9,5,1331133660,2280,285360,1374660,1089300,19_19_19_19_19_19_19_19_1_1_19_19_19_19_19_3_19_19_3_19_1_19_1_19_19_1_3_1_3_19_19_2_6_6_2_19_19_1_1_5_5_19_5_1_1
6552,64,1331132100,5,9,1,1331132280,180,5032020,6845160,1813140,1_1_11_11_5_5
6553,64,1331132280,1,9,1,1331136780,4500,5032200,6845160,1812960,1_1_11_11_5_5_1
6554,208,1331132700,16,20,16,1331132700,0,28440,1620480,1592040,16_16
6555,208,1331132700,16,20,16,1331133720,1020,28440,1620480,1592040,16_16_16
6556,31,1331133660,5,9,3,1331210520,76860,287640,1374660,1087020,19_19_19_19_19_19_19_19_1_1_19_19_19_19_19_3_19_19_3_19_1_19_1_19_19_1_3_1_3_19_19_2_6_6_2_19_19_1_1_5_5_19_5_1_1_5
6557,208,1331133720,16,20,16,1331144280,10560,29460,1620480,1591020,16_16_16_16
6558,75,1331134200,3,3,3,1331157600,23400,5025660,6135000,1109340,16_16_16_16_16_16_1_16_16_1_16_16_16_16_16_16_16_16_1_1_2_2_39_39_1_1_3_3_3_3_3_3_3_3
6559,63,1331134560,18,22,18,1331143800,9240,4283100,6232860,1949760,16_16_16_16_16_16_16_16_16_0_0_16_16_0_16_16_0_16_16_0_0_16_16_16_0_0_16_0_0_16_0_16_0_0_0_16_1_1_1_16_16_16_0_1_1_1_16_0_0_16_16_0_16_0_16_0_0_2_2_1_1_0_0_0_0_2_2_2_2_2_2_0_1_0_1_1_0_0_0_1_1_0_0_1_1_1_0_0_0_0_0_2_2_2_2_0_0_0_0_0_0_1_1_1_1_0_0_16_0_16_16_16_16_16_0_0_1_1_2_2_1_1_16_0_2_16_2_2_2_0_1_1_1_1_1_16_16_1_1_1_3_3_18_3_18_3_3_3_3_3_18_18_18_18_3_3_3_3_18_18_18_18_18_18_18_5_5_5_18_5_18_18_18_18_18_5_5_5_18_18_18_5_6_6_5_5_5_5_3_5_18_3_3_3_18_16_18_16_5_18_18_6_3_6_18_3_18_18_5_5_18_5_5_5_5_5_5_5_5_5_18_3_5_3_18_3_3_3_3_18_18_18_18_3_5_5_18_3_18_6_3_6_3_18_3_3_18_18_5_5_3_18_3_5_34_34_3_3_18_5_18_3_2_3_2_18_5_34_18_3_5_5_3_5_3_3_5_18_3_34_3_5_18_18_18_18_18_18_18_18_18_18_18_18_18_18
6560,61,1331136000,34,17,34,1331141400,5400,5680800,6225300,544500,4_4_18_18_34_34_34_3_3_34_3_3_34_35_34_35_35_35_36_36_35_35_35_35_34_34_34_34_34_34_34_34_34_34_34_34_34_34_34_34_34_34
6561,64,1331136780,1,9,6,1331157600,20820,5036700,6845160,1808460,1_1_11_11_5_5_1_1
6562,32,1331139540,10,13,10,1331144340,4800,117660,1205580,1087920,10_1_1_10_10_10
6563,10,1331141400,4,15,5,1331197200,55800,843120,979740,136620,0_0_0_1_1_0_0_0_1_1_2_2_9_9_9_9_3_3_3_3_4_4_4_4_4_4_4_4
6564,61,1331141400,34,15,34,1331156100,14700,5686200,6225300,539100,4_4_18_18_34_34_34_3_3_34_3_3_34_35_34_35_35_35_36_36_35_35_35_35_34_34_34_34_34_34_34_34_34_34_34_34_34_34_34_34_34_34_34
6565,46,1331143200,28,27,28,1331173800,30600,1724160,2027040,302880,26_26_26_26_26_26_26_26_8_8_9_9_3_3_5_5_27_27_28_28_28
6566,63,1331143800,18,19,18,1331154420,10620,4292340,6232860,1940520,16_16_16_16_16_16_16_16_16_0_0_16_16_0_16_16_0_16_16_0_0_16_16_16_0_0_16_0_0_16_0_16_0_0_0_16_1_1_1_16_16_16_0_1_1_1_16_0_0_16_16_0_16_0_16_0_0_2_2_1_1_0_0_0_0_2_2_2_2_2_2_0_1_0_1_1_0_0_0_1_1_0_0_1_1_1_0_0_0_0_0_2_2_2_2_0_0_0_0_0_0_1_1_1_1_0_0_16_0_16_16_16_16_16_0_0_1_1_2_2_1_1_16_0_2_16_2_2_2_0_1_1_1_1_1_16_16_1_1_1_3_3_18_3_18_3_3_3_3_3_18_18_18_18_3_3_3_3_18_18_18_18_18_18_18_5_5_5_18_5_18_18_18_18_18_5_5_5_18_18_18_5_6_6_5_5_5_5_3_5_18_3_3_3_18_16_18_16_5_18_18_6_3_6_18_3_18_18_5_5_18_5_5_5_5_5_5_5_5_5_18_3_5_3_18_3_3_3_3_18_18_18_18_3_5_5_18_3_18_6_3_6_3_18_3_3_18_18_5_5_3_18_3_5_34_34_3_3_18_5_18_3_2_3_2_18_5_34_18_3_5_5_3_5_3_3_5_18_3_34_3_5_18_18_18_18_18_18_18_18_18_18_18_18_18_18_18
6567,26,1331143860,18,5,18,1331152560,8700,295020,2036760,1741740,16_16_16_16_16_16_16_1_1_16_1_1_2_2_25_9_25_9_3_3_18
6568,208,1331144280,16,14,16,1331147100,2820,40020,1620480,1580460,16_16_16_16_16
6569,32,1331144340,10,16,10,1331150760,6420,122460,1205580,1083120,10_1_1_10_10_10_10
6570,208,1331147100,16,14,16,1331147100,0,42840,1620480,1577640,16_16_16_16_16_16
6571,208,1331147100,16,14,16,1331177400,30300,42840,1620480,1577640,16_16_16_16_16_16_16
6572,32,1331150760,10,16,1,1331182800,32040,128880,1205580,1076700,10_1_1_10_10_10_10_10
6573,181,1331150760,26,16,6,1331157600,6840,138360,189540,51180,26_26_26
6574,26,1331152560,18,5,18,1331152560,0,303720,2036760,1733040,16_16_16_16_16_16_16_1_1_16_1_1_2_2_25_9_25_9_3_3_18_18
6575,26,1331152560,18,5,18,1331166060,13500,303720,2036760,1733040,16_16_16_16_16_16_16_1_1_16_1_1_2_2_25_9_25_9_3_3_18_18_18
6576,63,1331154420,18,19,18,1331154480,60,4302960,6232860,1929900,16_16_16_16_16_16_16_16_16_0_0_16_16_0_16_16_0_16_16_0_0_16_16_16_0_0_16_0_0_16_0_16_0_0_0_16_1_1_1_16_16_16_0_1_1_1_16_0_0_16_16_0_16_0_16_0_0_2_2_1_1_0_0_0_0_2_2_2_2_2_2_0_1_0_1_1_0_0_0_1_1_0_0_1_1_1_0_0_0_0_0_2_2_2_2_0_0_0_0_0_0_1_1_1_1_0_0_16_0_16_16_16_16_16_0_0_1_1_2_2_1_1_16_0_2_16_2_2_2_0_1_1_1_1_1_16_16_1_1_1_3_3_18_3_18_3_3_3_3_3_18_18_18_18_3_3_3_3_18_18_18_18_18_18_18_5_5_5_18_5_18_18_18_18_18_5_5_5_18_18_18_5_6_6_5_5_5_5_3_5_18_3_3_3_18_16_18_16_5_18_18_6_3_6_18_3_18_18_5_5_18_5_5_5_5_5_5_5_5_5_18_3_5_3_18_3_3_3_3_18_18_18_18_3_5_5_18_3_18_6_3_6_3_18_3_3_18_18_5_5_3_18_3_5_34_34_3_3_18_5_18_3_2_3_2_18_5_34_18_3_5_5_3_5_3_3_5_18_3_34_3_5_18_18_18_18_18_18_18_18_18_18_18_18_18_18_18_18
6577,63,1331154480,18,19,18,1331155500,1020,4303020,6232860,1929840,16_16_16_16_16_16_16_16_16_0_0_16_16_0_16_16_0_16_16_0_0_16_16_16_0_0_16_0_0_16_0_16_0_0_0_16_1_1_1_16_16_16_0_1_1_1_16_0_0_16_16_0_16_0_16_0_0_2_2_1_1_0_0_0_0_2_2_2_2_2_2_0_1_0_1_1_0_0_0_1_1_0_0_1_1_1_0_0_0_0_0_2_2_2_2_0_0_0_0_0_0_1_1_1_1_0_0_16_0_16_16_16_16_16_0_0_1_1_2_2_1_1_16_0_2_16_2_2_2_0_1_1_1_1_1_16_16_1_1_1_3_3_18_3_18_3_3_3_3_3_18_18_18_18_3_3_3_3_18_18_18_18_18_18_18_5_5_5_18_5_18_18_18_18_18_5_5_5_18_18_18_5_6_6_5_5_5_5_3_5_18_3_3_3_18_16_18_16_5_18_18_6_3_6_18_3_18_18_5_5_18_5_5_5_5_5_5_5_5_5_18_3_5_3_18_3_3_3_3_18_18_18_18_3_5_5_18_3_18_6_3_6_3_18_3_3_18_18_5_5_3_18_3_5_34_34_3_3_18_5_18_3_2_3_2_18_5_34_18_3_5_5_3_5_3_3_5_18_3_34_3_5_18_18_18_18_18_18_18_18_18_18_18_18_18_18_18_18_18
6578,63,1331155500,18,19,34,1331566200,410700,4304040,6232860,1928820,16_16_16_16_16_16_16_16_16_0_0_16_16_0_16_16_0_16_16_0_0_16_16_16_0_0_16_0_0_16_0_16_0_0_0_16_1_1_1_16_16_16_0_1_1_1_16_0_0_16_16_0_16_0_16_0_0_2_2_1_1_0_0_0_0_2_2_2_2_2_2_0_1_0_1_1_0_0_0_1_1_0_0_1_1_1_0_0_0_0_0_2_2_2_2_0_0_0_0_0_0_1_1_1_1_0_0_16_0_16_16_16_16_16_0_0_1_1_2_2_1_1_16_0_2_16_2_2_2_0_1_1_1_1_1_16_16_1_1_1_3_3_18_3_18_3_3_3_3_3_18_18_18_18_3_3_3_3_18_18_18_18_18_18_18_5_5_5_18_5_18_18_18_18_18_5_5_5_18_18_18_5_6_6_5_5_5_5_3_5_18_3_3_3_18_16_18_16_5_18_18_6_3_6_18_3_18_18_5_5_18_5_5_5_5_5_5_5_5_5_18_3_5_3_18_3_3_3_3_18_18_18_18_3_5_5_18_3_18_6_3_6_3_18_3_3_18_18_5_5_3_18_3_5_34_34_3_3_18_5_18_3_2_3_2_18_5_34_18_3_5_5_3_5_3_3_5_18_3_34_3_5_18_18_18_18_18_18_18_18_18_18_18_18_18_18_18_18_18_18
6579,131,1331155560,18,5,18,1331165160,9600,4895460,6825900,1930440,16_16_16_16_16_16_16_16_16_16_16_16_16_16_16_16_16_16_16_16_16_16_16_16_16_16_1_1_1_1_2_2_3_3_3_3_18_18_18_18_18_3_3_3_3_18_18_18_18_18_18_18_18_18_18_18_18_18_18_18_18_18_18_18_5_5_5_5_5_5_5_5_5_5_5_5_6_6_5_5_6_6_5_5_5_5_5_5_5_5_5_5_6_6_5_5_34_34_34_34_3_3_18
6580,61,1331156100,34,15,34,1331183220,27120,5700900,6225300,524400,4_4_18_18_34_34_34_3_3_34_3_3_34_35_34_35_35_35_36_36_35_35_35_35_34_34_34_34_34_34_34_34_34_34_34_34_34_34_34_34_34_34_34_34
6581,34,1331156700,19,14,19,1331161680,4980,0,4980,4980,19
6582,181,1331157600,6,7,6,1331161200,3600,145200,189540,44340,26_26_26_6
6583,188,1331157600,3,4,3,1331162100,4500,2485560,4327560,1842000,0_0_0_0_0_1_1_0_0_0_0_0_0_0_0_0_1_1_2_2_2_2_3_3_3
6584,64,1331157600,6,7,6,1331161200,3600,5057520,6845160,1787640,1_1_11_11_5_5_1_1_6
6585,173,1331157600,6,7,6,1331161200,3600,3166380,3215700,49320,0_0_0_0_0_0_1_1_0_0_1_1_2_2_3_3_14_14_14_14_14_14_14_18_14_18_18_14_18_18_18_18_13_13_13_14_13_14_18_18_18_14_13_18_13_18_6_6_5_13_5_13_6_6_5_5_34_34_6
6586,75,1331157600,3,4,3,1331162100,4500,5049060,6135000,1085940,16_16_16_16_16_16_1_16_16_1_16_16_16_16_16_16_16_16_1_1_2_2_39_39_1_1_3_3_3_3_3_3_3_3_3
6587,81,1331157600,6,7,6,1331161200,3600,108000,111600,3600,14_14_14_14_5_5_6
6588,81,1331161200,6,7,99,1331161200,0,111600,111600,0,14_14_14_14_5_5_6_6
6589,173,1331161200,6,7,5,1331202420,41220,3169980,3215700,45720,0_0_0_0_0_0_1_1_0_0_1_1_2_2_3_3_14_14_14_14_14_14_14_18_14_18_18_14_18_18_18_18_13_13_13_14_13_14_18_18_18_14_13_18_13_18_6_6_5_13_5_13_6_6_5_5_34_34_6_6
6590,64,1331161200,6,7,1,1331888460,727260,5061120,6845160,1784040,1_1_11_11_5_5_1_1_6_6
6591,181,1331161200,6,7,26,1331165280,4080,148800,189540,40740,26_26_26_6_6
6592,13,1331161680,19,14,19,1331173020,11340,595140,2525940,1930800,19_19_19_1_1_19_19_19_19_19_19_19_19_19_19_19_1_1_1_19_1_19_19
6593,34,1331161680,19,14,99,1331161680,0,4980,4980,0,19_19
6594,188,1331162100,3,4,21,1331190360,28260,2490060,4327560,1837500,0_0_0_0_0_1_1_0_0_0_0_0_0_0_0_0_1_1_2_2_2_2_3_3_3_3
6595,75,1331162100,3,4,2,1331187720,25620,5053560,6135000,1081440,16_16_16_16_16_16_1_16_16_1_16_16_16_16_16_16_16_16_1_1_2_2_39_39_1_1_3_3_3_3_3_3_3_3_3_3
6596,131,1331165160,18,5,18,1331165220,60,4905060,6825900,1920840,16_16_16_16_16_16_16_16_16_16_16_16_16_16_16_16_16_16_16_16_16_16_16_16_16_16_1_1_1_1_2_2_3_3_3_3_18_18_18_18_18_3_3_3_3_18_18_18_18_18_18_18_18_18_18_18_18_18_18_18_18_18_18_18_5_5_5_5_5_5_5_5_5_5_5_5_6_6_5_5_6_6_5_5_5_5_5_5_5_5_5_5_6_6_5_5_34_34_34_34_3_3_18_18
6597,131,1331165220,18,19,18,1331182140,16920,4905120,6825900,1920780,16_16_16_16_16_16_16_16_16_16_16_16_16_16_16_16_16_16_16_16_16_16_16_16_16_16_1_1_1_1_2_2_3_3_3_3_18_18_18_18_18_3_3_3_3_18_18_18_18_18_18_18_18_18_18_18_18_18_18_18_18_18_18_18_5_5_5_5_5_5_5_5_5_5_5_5_6_6_5_5_6_6_5_5_5_5_5_5_5_5_5_5_6_6_5_5_34_34_34_34_3_3_18_18_18
6598,181,1331165280,26,16,26,1331173080,7800,152880,189540,36660,26_26_26_6_6_26_26
6599,181,1331165280,26,16,26,1331165280,0,152880,189540,36660,26_26_26_6_6_26
6600,26,1331166060,18,5,15,1331622000,455940,317220,2036760,1719540,16_16_16_16_16_16_16_1_1_16_1_1_2_2_25_9_25_9_3_3_18_18_18_18
6601,151,1331166120,4,5,4,1331172660,6540,3043920,3643800,599880,19_19_19_19_19_1_1_19_1_1_19_19_19_19_1_19_1_19_19_19_19_19_19_19_19_19_1_19_19_1_1_1_1_1_19_19_19_19_19_19_1_1_19_19_1_1_19_1_1_19_19_19_19_19_19_19_19_19_19_19_19_19_19_19_1_1_47_47_3_3_3_3_2_3_3_2_3_3_3_3_3_3_4
6602,151,1331172660,4,5,4,1331172720,60,3050460,3643800,593340,19_19_19_19_19_1_1_19_1_1_19_19_19_19_1_19_1_19_19_19_19_19_19_19_19_19_1_19_19_1_1_1_1_1_19_19_19_19_19_19_1_1_19_19_1_1_19_1_1_19_19_19_19_19_19_19_19_19_19_19_19_19_19_19_1_1_47_47_3_3_3_3_2_3_3_2_3_3_3_3_3_3_4_4
6603,151,1331172720,4,5,4,1331182080,9360,3050520,3643800,593280,19_19_19_19_19_1_1_19_1_1_19_19_19_19_1_19_1_19_19_19_19_19_19_19_19_19_1_19_19_1_1_1_1_1_19_19_19_19_19_19_1_1_19_19_1_1_19_1_1_19_19_19_19_19_19_19_19_19_19_19_19_19_19_19_1_1_47_47_3_3_3_3_2_3_3_2_3_3_3_3_3_3_4_4_4
6604,13,1331173020,19,14,19,1331183460,10440,606480,2525940,1919460,19_19_19_1_1_19_19_19_19_19_19_19_19_19_19_19_1_1_1_19_1_19_19_19
6605,181,1331173080,26,16,8,1331183520,10440,160680,189540,28860,26_26_26_6_6_26_26_26
6606,5,1331173140,10,16,10,1331182260,9120,155340,748200,592860,10_10_10
6607,191,1331173800,28,27,28,1331182800,9000,1534320,1811280,276960,26_26_26_26_8_8_9_9_3_3_28
6608,46,1331173800,28,27,8,1331202420,28620,1754760,2027040,272280,26_26_26_26_26_26_26_26_8_8_9_9_3_3_5_5_27_27_28_28_28_28
6609,208,1331177400,16,14,1,1331269200,91800,73140,1620480,1547340,16_16_16_16_16_16_16_16
6610,15,1331179980,7,12,7,1331182260,2280,0,1822860,1822860,7
6611,151,1331182080,4,5,4,1331182800,720,3059880,3643800,583920,19_19_19_19_19_1_1_19_1_1_19_19_19_19_1_19_1_19_19_19_19_19_19_19_19_19_1_19_19_1_1_1_1_1_19_19_19_19_19_19_1_1_19_19_1_1_19_1_1_19_19_19_19_19_19_19_19_19_19_19_19_19_19_19_1_1_47_47_3_3_3_3_2_3_3_2_3_3_3_3_3_3_4_4_4_4
6612,131,1331182140,18,19,18,1331183160,1020,4922040,6825900,1903860,16_16_16_16_16_16_16_16_16_16_16_16_16_16_16_16_16_16_16_16_16_16_16_16_16_16_1_1_1_1_2_2_3_3_3_3_18_18_18_18_18_3_3_3_3_18_18_18_18_18_18_18_18_18_18_18_18_18_18_18_18_18_18_18_5_5_5_5_5_5_5_5_5_5_5_5_6_6_5_5_6_6_5_5_5_5_5_5_5_5_5_5_6_6_5_5_34_34_34_34_3_3_18_18_18_18
6613,90,1331182200,5,9,5,1331201340,19140,1467540,1532940,65400,19_19_19_19_19_19_19_19_1_1_19_19_19_19_19_19_19_19_1_1_1_1_9_9_9_9_2_2_2_2_3_3_3_3_5
6614,5,1331182260,10,16,10,1331193840,11580,164460,748200,583740,10_10_10_10
6615,15,1331182260,7,12,7,1331640060,457800,2280,1822860,1820580,7_7
6616,204,1331182800,1,6,16,1331184180,1380,649740,2567700,1917960,16_16_16_16_16_16_16_16_16_16_16_16_16_16_16_16_16_16_16_16_16_16_1_1_1_1_1
6617,32,1331182800,1,18,1,1331188800,6000,160920,1205580,1044660,10_1_1_10_10_10_10_10_1
6618,151,1331182800,4,22,4,1331216040,33240,3060600,3643800,583200,19_19_19_19_19_1_1_19_1_1_19_19_19_19_1_19_1_19_19_19_19_19_19_19_19_19_1_19_19_1_1_1_1_1_19_19_19_19_19_19_1_1_19_19_1_1_19_1_1_19_19_19_19_19_19_19_19_19_19_19_19_19_19_19_1_1_47_47_3_3_3_3_2_3_3_2_3_3_3_3_3_3_4_4_4_4_4
6619,191,1331182800,28,27,8,1331202480,19680,1543320,1811280,267960,26_26_26_26_8_8_9_9_3_3_28_28
6620,131,1331183160,18,22,18,1331184420,1260,4923060,6825900,1902840,16_16_16_16_16_16_16_16_16_16_16_16_16_16_16_16_16_16_16_16_16_16_16_16_16_16_1_1_1_1_2_2_3_3_3_3_18_18_18_18_18_3_3_3_3_18_18_18_18_18_18_18_18_18_18_18_18_18_18_18_18_18_18_18_5_5_5_5_5_5_5_5_5_5_5_5_6_6_5_5_6_6_5_5_5_5_5_5_5_5_5_5_6_6_5_5_34_34_34_34_3_3_18_18_18_18_18
6621,61,1331183220,34,17,34,1331214900,31680,5728020,6225300,497280,4_4_18_18_34_34_34_3_3_34_3_3_34_35_34_35_35_35_36_36_35_35_35_35_34_34_34_34_34_34_34_34_34_34_34_34_34_34_34_34_34_34_34_34_34
6622,13,1331183460,19,11,19,1331199420,15960,616920,2525940,1909020,19_19_19_1_1_19_19_19_19_19_19_19_19_19_19_19_1_1_1_19_1_19_19_19_19
6623,181,1331183520,8,9,8,1331185560,2040,171120,189540,18420,26_26_26_6_6_26_26_26_8
6624,204,1331184180,16,20,1,1331184420,240,651120,2567700,1916580,16_16_16_16_16_16_16_16_16_16_16_16_16_16_16_16_16_16_16_16_16_16_1_1_1_1_1_16
6625,131,1331184420,18,22,6,1332021600,837180,4924320,6825900,1901580,16_16_16_16_16_16_16_16_16_16_16_16_16_16_16_16_16_16_16_16_16_16_16_16_16_16_1_1_1_1_2_2_3_3_3_3_18_18_18_18_18_3_3_3_3_18_18_18_18_18_18_18_18_18_18_18_18_18_18_18_18_18_18_18_5_5_5_5_5_5_5_5_5_5_5_5_6_6_5_5_6_6_5_5_5_5_5_5_5_5_5_5_6_6_5_5_34_34_34_34_3_3_18_18_18_18_18_18
6626,204,1331184420,1,6,2,1331184900,480,651360,2567700,1916340,16_16_16_16_16_16_16_16_16_16_16_16_16_16_16_16_16_16_16_16_16_16_1_1_1_1_1_16_1
6627,204,1331184900,2,4,2,1331189400,4500,651840,2567700,1915860,16_16_16_16_16_16_16_16_16_16_16_16_16_16_16_16_16_16_16_16_16_16_1_1_1_1_1_16_1_2
6628,181,1331185560,8,9,3,1331194320,8760,173160,189540,16380,26_26_26_6_6_26_26_26_8_8
6629,75,1331187720,3,3,3,1331187720,0,5079180,6135000,1055820,16_16_16_16_16_16_1_16_16_1_16_16_16_16_16_16_16_16_1_1_2_2_39_39_1_1_3_3_3_3_3_3_3_3_3_3_2_3
6630,75,1331187720,3,3,2,1331192220,4500,5079180,6135000,1055820,16_16_16_16_16_16_1_16_16_1_16_16_16_16_16_16_16_16_1_1_2_2_39_39_1_1_3_3_3_3_3_3_3_3_3_3_2_3_3
6631,75,1331187720,2,3,3,1331187720,0,5079180,6135000,1055820,16_16_16_16_16_16_1_16_16_1_16_16_16_16_16_16_16_16_1_1_2_2_39_39_1_1_3_3_3_3_3_3_3_3_3_3_2
6632,24,1331188500,1,6,1,1331192220,3720,940560,1547520,606960,16_16_16_16_16_16_1
6633,32,1331188800,1,18,3,1331282640,93840,166920,1205580,1038660,10_1_1_10_10_10_10_10_1_1
6634,204,1331189400,2,4,16,1331211840,22440,656340,2567700,1911360,16_16_16_16_16_16_16_16_16_16_16_16_16_16_16_16_16_16_16_16_16_16_1_1_1_1_1_16_1_2_2
6635,57,1331190120,8,18,8,1331197380,7260,922380,2756640,1834260,26_26_26_26_26_26_26_26_26_26_26_26_26_26_26_26_26_26_26_26_26_26_26_26_26_8_8_8_8_2_2_26_8_8_26_26_26_26_26_26_26_26_8_8_26_26_26_26_26_26_8_8_8
6636,188,1331190360,21,4,21,1331204100,13740,2518320,4327560,1809240,0_0_0_0_0_1_1_0_0_0_0_0_0_0_0_0_1_1_2_2_2_2_3_3_3_3_21
6637,157,1331190780,1,9,1,1331195340,4560,1302600,1993260,690660,19_19_1_19_1_19_19_19_19_19_19_19_1_1_1_1_9_9_1
6638,75,1331192220,2,3,18,1331212380,20160,5083680,6135000,1051320,16_16_16_16_16_16_1_16_16_1_16_16_16_16_16_16_16_16_1_1_2_2_39_39_1_1_3_3_3_3_3_3_3_3_3_3_2_3_3_2
6639,24,1331192220,1,6,2,1331206320,14100,944280,1547520,603240,16_16_16_16_16_16_1_1
6640,5,1331193840,10,13,10,1331217480,23640,176040,748200,572160,10_10_10_10_10
6641,181,1331194320,3,3,3,1331198700,4380,181920,189540,7620,26_26_26_6_6_26_26_26_8_8_3
6642,89,1331195220,2,3,2,1331197020,1800,1394100,1736340,342240,19_19_19_19_19_1_19_1_19_19_19_19_1_1_1_1_2
6643,157,1331195340,1,9,2,1331197020,1680,1307160,1993260,686100,19_19_1_19_1_19_19_19_19_19_19_19_1_1_1_1_9_9_1_1
6644,157,1331197020,2,3,2,1331198640,1620,1308840,1993260,684420,19_19_1_19_1_19_19_19_19_19_19_19_1_1_1_1_9_9_1_1_2
6645,89,1331197020,2,3,3,1331216880,19860,1395900,1736340,340440,19_19_19_19_19_1_19_1_19_19_19_19_1_1_1_1_2_2
6646,10,1331197200,5,18,5,1331214720,17520,898920,979740,80820,0_0_0_1_1_0_0_0_1_1_2_2_9_9_9_9_3_3_3_3_4_4_4_4_4_4_4_4_5
6647,57,1331197380,8,18,26,1331214480,17100,929640,2756640,1827000,26_26_26_26_26_26_26_26_26_26_26_26_26_26_26_26_26_26_26_26_26_26_26_26_26_8_8_8_8_2_2_26_8_8_26_26_26_26_26_26_26_26_8_8_26_26_26_26_26_26_8_8_8_8
6648,157,1331198640,2,3,3,1331199180,540,1310460,1993260,682800,19_19_1_19_1_19_19_19_19_19_19_19_1_1_1_1_9_9_1_1_2_2
6649,181,1331198700,3,3,2,1331198760,60,186300,189540,3240,26_26_26_6_6_26_26_26_8_8_3_3
6650,181,1331198760,2,3,5,1331199000,240,186360,189540,3180,26_26_26_6_6_26_26_26_8_8_3_3_2
6651,181,1331199000,5,9,2,1331199840,840,186600,189540,2940,26_26_26_6_6_26_26_26_8_8_3_3_2_5
6652,157,1331199180,3,3,3,1331206200,7020,1311000,1993260,682260,19_19_1_19_1_19_19_19_19_19_19_19_1_1_1_1_9_9_1_1_2_2_3
6653,13,1331199420,19,11,19,1331199420,0,632880,2525940,1893060,19_19_19_1_1_19_19_19_19_19_19_19_19_19_19_19_1_1_1_19_1_19_19_19_19_19
6654,13,1331199420,19,11,19,1331214720,15300,632880,2525940,1893060,19_19_19_1_1_19_19_19_19_19_19_19_19_19_19_19_1_1_1_19_1_19_19_19_19_19_19
6655,181,1331199840,2,3,5,1331201940,2100,187440,189540,2100,26_26_26_6_6_26_26_26_8_8_3_3_2_5_2
6656,146,1331200980,5,6,5,1331201100,120,5673780,6670800,997020,16_16_16_16_16_16_16_1_16_1_16_1_1_16_1_16_16_2_1_1_16_1_2_16_2_2_3_3_3_3_21_21_3_3_3_3_3_21_3_21_3_3_3_3_21_3_21_3_18_18_18_18_18_18_3_3_3_3_4_4_4_4_4_4_4_4_4_4_4_4_4_4_4_4_4_4_18_18_4_4_4_4_4_3_3_4_4_4_5_5_6_6_5_5_6_6_5_5_34_34_34_34_34_34_5
6657,146,1331201100,5,6,5,1331208060,6960,5673900,6670800,996900,16_16_16_16_16_16_16_1_16_1_16_1_1_16_1_16_16_2_1_1_16_1_2_16_2_2_3_3_3_3_21_21_3_3_3_3_3_21_3_21_3_3_3_3_21_3_21_3_18_18_18_18_18_18_3_3_3_3_4_4_4_4_4_4_4_4_4_4_4_4_4_4_4_4_4_4_18_18_4_4_4_4_4_3_3_4_4_4_5_5_6_6_5_5_6_6_5_5_34_34_34_34_34_34_5_5
6658,90,1331201340,5,9,6,1331244000,42660,1486680,1532940,46260,19_19_19_19_19_19_19_19_1_1_19_19_19_19_19_19_19_19_1_1_1_1_9_9_9_9_2_2_2_2_3_3_3_3_5_5
6659,98,1331201580,35,23,35,1331212380,10800,5462160,7319880,1857720,34_34_2_2_35_35_34_34_2_2_3_3_3_3_3_3_18_18_3_3_3_18_3_3_3_18_18_18_18_3_3_18_18_18_18_18_18_18_18_3_3_18_39_3_3_39_3_3_3_3_4_4_5_5_5_5_5_5_4_4_4_5_3_5_5_3_5_4_4_4_5_5_5_5_6_6_6_6_5_5_5_5_5_5_5_5_5_5_5_5_6_6_5_5_34_34_6_6_5_5_5_5_5_5_5_5_5_5_5_5_2_2_5_18_5_18_18_18_6_6_5_5_5_5_5_5_6_6_34_34_34_34_35
6660,181,1331201940,5,9,99,1331201940,0,189540,189540,0,26_26_26_6_6_26_26_26_8_8_3_3_2_5_2_5
6661,46,1331202420,8,9,8,1331214840,12420,1783380,2027040,243660,26_26_26_26_26_26_26_26_8_8_9_9_3_3_5_5_27_27_28_28_28_28_8
6662,173,1331202420,5,6,5,1331206920,4500,3211200,3215700,4500,0_0_0_0_0_0_1_1_0_0_1_1_2_2_3_3_14_14_14_14_14_14_14_18_14_18_18_14_18_18_18_18_13_13_13_14_13_14_18_18_18_14_13_18_13_18_6_6_5_13_5_13_6_6_5_5_34_34_6_6_5
6663,191,1331202480,8,9,8,1331214780,12300,1563000,1811280,248280,26_26_26_26_8_8_9_9_3_3_28_28_8
6664,188,1331204100,21,4,3,1331470200,266100,2532060,4327560,1795500,0_0_0_0_0_1_1_0_0_0_0_0_0_0_0_0_1_1_2_2_2_2_3_3_3_3_21_21
6665,157,1331206200,3,3,18,1331542680,336480,1318020,1993260,675240,19_19_1_19_1_19_19_19_19_19_19_19_1_1_1_1_9_9_1_1_2_2_3_3
6666,4,1331206320,2,3,2,1331210460,4140,852720,1326000,473280,10_10_10_10_10_10_10_1_1_10_10_10_10_10_10_10_10_10_10_1_10_1_10_1_1_10_10_10_10_10_1_1_1_1_2
6667,24,1331206320,2,3,2,1331210460,4140,958380,1547520,589140,16_16_16_16_16_16_1_1_2
6668,173,1331206920,5,6,99,1331206920,0,3215700,3215700,0,0_0_0_0_0_0_1_1_0_0_1_1_2_2_3_3_14_14_14_14_14_14_14_18_14_18_18_14_18_18_18_18_13_13_13_14_13_14_18_18_18_14_13_18_13_18_6_6_5_13_5_13_6_6_5_5_34_34_6_6_5_5
6669,146,1331208060,5,6,5,1331212560,4500,5680860,6670800,989940,16_16_16_16_16_16_16_1_16_1_16_1_1_16_1_16_16_2_1_1_16_1_2_16_2_2_3_3_3_3_21_21_3_3_3_3_3_21_3_21_3_3_3_3_21_3_21_3_18_18_18_18_18_18_3_3_3_3_4_4_4_4_4_4_4_4_4_4_4_4_4_4_4_4_4_4_18_18_4_4_4_4_4_3_3_4_4_4_5_5_6_6_5_5_6_6_5_5_34_34_34_34_34_34_5_5_5
6670,4,1331210460,2,3,3,1331244000,33540,856860,1326000,469140,10_10_10_10_10_10_10_1_1_10_10_10_10_10_10_10_10_10_10_1_10_1_10_1_1_10_10_10_10_10_1_1_1_1_2_2
6671,24,1331210460,2,3,3,1331646720,436260,962520,1547520,585000,16_16_16_16_16_16_1_1_2_2
6672,31,1331210520,3,3,3,1331214900,4380,364500,1374660,1010160,19_19_19_19_19_19_19_19_1_1_19_19_19_19_19_3_19_19_3_19_1_19_1_19_19_1_3_1_3_19_19_2_6_6_2_19_19_1_1_5_5_19_5_1_1_5_3
6673,18,1331210760,9,4,9,1331214720,3960,277500,1779540,1502040,0_0_0_0_0_0_0_0_0_1_1_1_1_0_9
6674,204,1331211840,16,20,16,1331214960,3120,678780,2567700,1888920,16_16_16_16_16_16_16_16_16_16_16_16_16_16_16_16_16_16_16_16_16_16_1_1_1_1_1_16_1_2_2_16
6675,98,1331212380,35,23,6,1332021600,809220,5472960,7319880,1846920,34_34_2_2_35_35_34_34_2_2_3_3_3_3_3_3_18_18_3_3_3_18_3_3_3_18_18_18_18_3_3_18_18_18_18_18_18_18_18_3_3_18_39_3_3_39_3_3_3_3_4_4_5_5_5_5_5_5_4_4_4_5_3_5_5_3_5_4_4_4_5_5_5_5_6_6_6_6_5_5_5_5_5_5_5_5_5_5_5_5_6_6_5_5_34_34_6_6_5_5_5_5_5_5_5_5_5_5_5_5_2_2_5_18_5_18_18_18_6_6_5_5_5_5_5_5_6_6_34_34_34_34_35_35
6676,75,1331212380,18,23,18,1331223060,10680,5103840,6135000,1031160,16_16_16_16_16_16_1_16_16_1_16_16_16_16_16_16_16_16_1_1_2_2_39_39_1_1_3_3_3_3_3_3_3_3_3_3_2_3_3_2_18
6677,146,1331212560,5,6,6,1331244000,31440,5685360,6670800,985440,16_16_16_16_16_16_16_1_16_1_16_1_1_16_1_16_16_2_1_1_16_1_2_16_2_2_3_3_3_3_21_21_3_3_3_3_3_21_3_21_3_3_3_3_21_3_21_3_18_18_18_18_18_18_3_3_3_3_4_4_4_4_4_4_4_4_4_4_4_4_4_4_4_4_4_4_18_18_4_4_4_4_4_3_3_4_4_4_5_5_6_6_5_5_6_6_5_5_34_34_34_34_34_34_5_5_5_5
6678,57,1331214480,26,32,26,1331222700,8220,946740,2756640,1809900,26_26_26_26_26_26_26_26_26_26_26_26_26_26_26_26_26_26_26_26_26_26_26_26_26_8_8_8_8_2_2_26_8_8_26_26_26_26_26_26_26_26_8_8_26_26_26_26_26_26_8_8_8_8_26
6679,10,1331214720,5,18,6,1331244000,29280,916440,979740,63300,0_0_0_1_1_0_0_0_1_1_2_2_9_9_9_9_3_3_3_3_4_4_4_4_4_4_4_4_5_5
6680,18,1331214720,9,4,9,1331244000,29280,281460,1779540,1498080,0_0_0_0_0_0_0_0_0_1_1_1_1_0_9_9
6681,13,1331214720,19,11,19,1331214840,120,648180,2525940,1877760,19_19_19_1_1_19_19_19_19_19_19_19_19_19_19_19_1_1_1_19_1_19_19_19_19_19_19_19
6682,191,1331214780,8,9,3,1331290500,75720,1575300,1811280,235980,26_26_26_26_8_8_9_9_3_3_28_28_8_8
6683,46,1331214840,8,9,3,1331288400,73560,1795800,2027040,231240,26_26_26_26_26_26_26_26_8_8_9_9_3_3_5_5_27_27_28_28_28_28_8_8
6684,13,1331214840,19,1,19,1331242800,27960,648300,2525940,1877640,19_19_19_1_1_19_19_19_19_19_19_19_19_19_19_19_1_1_1_19_1_19_19_19_19_19_19_19_19
6685,61,1331214900,34,17,34,1331215080,180,5759700,6225300,465600,4_4_18_18_34_34_34_3_3_34_3_3_34_35_34_35_35_35_36_36_35_35_35_35_34_34_34_34_34_34_34_34_34_34_34_34_34_34_34_34_34_34_34_34_34_34
6686,31,1331214900,3,3,2,1331231160,16260,368880,1374660,1005780,19_19_19_19_19_19_19_19_1_1_19_19_19_19_19_3_19_19_3_19_1_19_1_19_19_1_3_1_3_19_19_2_6_6_2_19_19_1_1_5_5_19_5_1_1_5_3_3
6687,204,1331214960,16,1,16,1331222100,7140,681900,2567700,1885800,16_16_16_16_16_16_16_16_16_16_16_16_16_16_16_16_16_16_16_16_16_16_1_1_1_1_1_16_1_2_2_16_16
6688,61,1331215080,34,15,34,1331239560,24480,5759880,6225300,465420,4_4_18_18_34_34_34_3_3_34_3_3_34_35_34_35_35_35_36_36_35_35_35_35_34_34_34_34_34_34_34_34_34_34_34_34_34_34_34_34_34_34_34_34_34_34_34
6689,151,1331216040,4,22,4,1331231220,15180,3093840,3643800,549960,19_19_19_19_19_1_1_19_1_1_19_19_19_19_1_19_1_19_19_19_19_19_19_19_19_19_1_19_19_1_1_1_1_1_19_19_19_19_19_19_1_1_19_19_1_1_19_1_1_19_19_19_19_19_19_19_19_19_19_19_19_19_19_19_1_1_47_47_3_3_3_3_2_3_3_2_3_3_3_3_3_3_4_4_4_4_4_4
6690,89,1331216880,3,3,3,1331222880,6000,1415760,1736340,320580,19_19_19_19_19_1_19_1_19_19_19_19_1_1_1_1_2_2_3
6691,5,1331217480,10,13,10,1331231040,13560,199680,748200,548520,10_10_10_10_10_10
6692,204,1331222100,16,1,16,1331222160,60,689040,2567700,1878660,16_16_16_16_16_16_16_16_16_16_16_16_16_16_16_16_16_16_16_16_16_16_1_1_1_1_1_16_1_2_2_16_16_16
6693,204,1331222160,16,1,16,1331230260,8100,689100,2567700,1878600,16_16_16_16_16_16_16_16_16_16_16_16_16_16_16_16_16_16_16_16_16_16_1_1_1_1_1_16_1_2_2_16_16_16_16
6694,57,1331222700,26,32,26,1331410020,187320,954960,2756640,1801680,26_26_26_26_26_26_26_26_26_26_26_26_26_26_26_26_26_26_26_26_26_26_26_26_26_8_8_8_8_2_2_26_8_8_26_26_26_26_26_26_26_26_8_8_26_26_26_26_26_26_8_8_8_8_26_26
6695,89,1331222880,3,3,3,1331274840,51960,1421760,1736340,314580,19_19_19_19_19_1_19_1_19_19_19_19_1_1_1_1_2_2_3_3
6696,75,1331223060,18,23,18,1331223060,0,5114520,6135000,1020480,16_16_16_16_16_16_1_16_16_1_16_16_16_16_16_16_16_16_1_1_2_2_39_39_1_1_3_3_3_3_3_3_3_3_3_3_2_3_3_2_18_18
6697,75,1331223060,18,23,18,1331230620,7560,5114520,6135000,1020480,16_16_16_16_16_16_1_16_16_1_16_16_16_16_16_16_16_16_1_1_2_2_39_39_1_1_3_3_3_3_3_3_3_3_3_3_2_3_3_2_18_18_18
6698,204,1331230260,16,14,16,1331231820,1560,697200,2567700,1870500,16_16_16_16_16_16_16_16_16_16_16_16_16_16_16_16_16_16_16_16_16_16_1_1_1_1_1_16_1_2_2_16_16_16_16_16
6699,75,1331230620,18,23,18,1331230980,360,5122080,6135000,1012920,16_16_16_16_16_16_1_16_16_1_16_16_16_16_16_16_16_16_1_1_2_2_39_39_1_1_3_3_3_3_3_3_3_3_3_3_2_3_3_2_18_18_18_18
6700,75,1331230980,18,19,18,1331242860,11880,5122440,6135000,1012560,16_16_16_16_16_16_1_16_16_1_16_16_16_16_16_16_16_16_1_1_2_2_39_39_1_1_3_3_3_3_3_3_3_3_3_3_2_3_3_2_18_18_18_18_18
6701,5,1331231040,10,16,10,1331260500,29460,213240,748200,534960,10_10_10_10_10_10_10
6702,31,1331231160,2,5,2,1331237340,6180,385140,1374660,989520,19_19_19_19_19_19_19_19_1_1_19_19_19_19_19_3_19_19_3_19_1_19_1_19_19_1_3_1_3_19_19_2_6_6_2_19_19_1_1_5_5_19_5_1_1_5_3_3_2
6703,151,1331231220,4,19,4,1331236800,5580,3109020,3643800,534780,19_19_19_19_19_1_1_19_1_1_19_19_19_19_1_19_1_19_19_19_19_19_19_19_19_19_1_19_19_1_1_1_1_1_19_19_19_19_19_19_1_1_19_19_1_1_19_1_1_19_19_19_19_19_19_19_19_19_19_19_19_19_19_19_1_1_47_47_3_3_3_3_2_3_3_2_3_3_3_3_3_3_4_4_4_4_4_4_4
6704,204,1331231820,16,1,16,1331250420,18600,698760,2567700,1868940,16_16_16_16_16_16_16_16_16_16_16_16_16_16_16_16_16_16_16_16_16_16_1_1_1_1_1_16_1_2_2_16_16_16_16_16_16
6705,151,1331236800,4,19,4,1331238180,1380,3114600,3643800,529200,19_19_19_19_19_1_1_19_1_1_19_19_19_19_1_19_1_19_19_19_19_19_19_19_19_19_1_19_19_1_1_1_1_1_19_19_19_19_19_19_1_1_19_19_1_1_19_1_1_19_19_19_19_19_19_19_19_19_19_19_19_19_19_19_1_1_47_47_3_3_3_3_2_3_3_2_3_3_3_3_3_3_4_4_4_4_4_4_4_4
6706,31,1331237340,2,5,1,1331530500,293160,391320,1374660,983340,19_19_19_19_19_19_19_19_1_1_19_19_19_19_19_3_19_19_3_19_1_19_1_19_19_1_3_1_3_19_19_2_6_6_2_19_19_1_1_5_5_19_5_1_1_5_3_3_2_2
6707,151,1331238180,4,19,4,1331242860,4680,3115980,3643800,527820,19_19_19_19_19_1_1_19_1_1_19_19_19_19_1_19_1_19_19_19_19_19_19_19_19_19_1_19_19_1_1_1_1_1_19_19_19_19_19_19_1_1_19_19_1_1_19_1_1_19_19_19_19_19_19_19_19_19_19_19_19_19_19_19_1_1_47_47_3_3_3_3_2_3_3_2_3_3_3_3_3_3_4_4_4_4_4_4_4_4_4
6708,61,1331239560,34,15,34,1331269800,30240,5784360,6225300,440940,4_4_18_18_34_34_34_3_3_34_3_3_34_35_34_35_35_35_36_36_35_35_35_35_34_34_34_34_34_34_34_34_34_34_34_34_34_34_34_34_34_34_34_34_34_34_34_34
6709,174,1331240100,9,15,9,1331242500,2400,660960,1300440,639480,10_1_10_1_10_10_19_19_1_1_9
6710,174,1331242500,9,15,1,1331283600,41100,663360,1300440,637080,10_1_10_1_10_10_19_19_1_1_9_9
6711,13,1331242800,19,1,19,1331250480,7680,676260,2525940,1849680,19_19_19_1_1_19_19_19_19_19_19_19_19_19_19_19_1_1_1_19_1_19_19_19_19_19_19_19_19_19
6712,75,1331242860,18,19,18,1331244420,1560,5134320,6135000,1000680,16_16_16_16_16_16_1_16_16_1_16_16_16_16_16_16_16_16_1_1_2_2_39_39_1_1_3_3_3_3_3_3_3_3_3_3_2_3_3_2_18_18_18_18_18_18
6713,151,1331242860,4,19,4,1331244360,1500,3120660,3643800,523140,19_19_19_19_19_1_1_19_1_1_19_19_19_19_1_19_1_19_19_19_19_19_19_19_19_19_1_19_19_1_1_1_1_1_19_19_19_19_19_19_1_1_19_19_1_1_19_1_1_19_19_19_19_19_19_19_19_19_19_19_19_19_19_19_1_1_47_47_3_3_3_3_2_3_3_2_3_3_3_3_3_3_4_4_4_4_4_4_4_4_4_4
6714,146,1331244000,6,7,6,1331247600,3600,5716800,6670800,954000,16_16_16_16_16_16_16_1_16_1_16_1_1_16_1_16_16_2_1_1_16_1_2_16_2_2_3_3_3_3_21_21_3_3_3_3_3_21_3_21_3_3_3_3_21_3_21_3_18_18_18_18_18_18_3_3_3_3_4_4_4_4_4_4_4_4_4_4_4_4_4_4_4_4_4_4_18_18_4_4_4_4_4_3_3_4_4_4_5_5_6_6_5_5_6_6_5_5_34_34_34_34_34_34_5_5_5_5_6
6715,4,1331244000,3,4,3,1331248500,4500,890400,1326000,435600,10_10_10_10_10_10_10_1_1_10_10_10_10_10_10_10_10_10_10_1_10_1_10_1_1_10_10_10_10_10_1_1_1_1_2_2_3
6716,18,1331244000,9,4,9,1331248500,4500,310740,1779540,1468800,0_0_0_0_0_0_0_0_0_1_1_1_1_0_9_9_9
6717,90,1331244000,6,7,6,1331247600,3600,1529340,1532940,3600,19_19_19_19_19_19_19_19_1_1_19_19_19_19_19_19_19_19_1_1_1_1_9_9_9_9_2_2_2_2_3_3_3_3_5_5_6
6718,10,1331244000,6,7,6,1331247600,3600,945720,979740,34020,0_0_0_1_1_0_0_0_1_1_2_2_9_9_9_9_3_3_3_3_4_4_4_4_4_4_4_4_5_5_6
6719,151,1331244360,4,5,4,1331268360,24000,3122160,3643800,521640,19_19_19_19_19_1_1_19_1_1_19_19_19_19_1_19_1_19_19_19_19_19_19_19_19_19_1_19_19_1_1_1_1_1_19_19_19_19_19_19_1_1_19_19_1_1_19_1_1_19_19_19_19_19_19_19_19_19_19_19_19_19_19_19_1_1_47_47_3_3_3_3_2_3_3_2_3_3_3_3_3_3_4_4_4_4_4_4_4_4_4_4_4
6720,75,1331244420,18,5,18,1331268300,23880,5135880,6135000,999120,16_16_16_16_16_16_1_16_16_1_16_16_16_16_16_16_16_16_1_1_2_2_39_39_1_1_3_3_3_3_3_3_3_3_3_3_2_3_3_2_18_18_18_18_18_18_18
6721,90,1331247600,6,7,99,1331247600,0,1532940,1532940,0,19_19_19_19_19_19_19_19_1_1_19_19_19_19_19_19_19_19_1_1_1_1_9_9_9_9_2_2_2_2_3_3_3_3_5_5_6_6
6722,146,1331247600,6,7,5,1331546340,298740,5720400,6670800,950400,16_16_16_16_16_16_16_1_16_1_16_1_1_16_1_16_16_2_1_1_16_1_2_16_2_2_3_3_3_3_21_21_3_3_3_3_3_21_3_21_3_3_3_3_21_3_21_3_18_18_18_18_18_18_3_3_3_3_4_4_4_4_4_4_4_4_4_4_4_4_4_4_4_4_4_4_18_18_4_4_4_4_4_3_3_4_4_4_5_5_6_6_5_5_6_6_5_5_34_34_34_34_34_34_5_5_5_5_6_6
6723,10,1331247600,6,7,5,1331276400,28800,949320,979740,30420,0_0_0_1_1_0_0_0_1_1_2_2_9_9_9_9_3_3_3_3_4_4_4_4_4_4_4_4_5_5_6_6
6724,4,1331248500,3,4,3,1331451480,202980,894900,1326000,431100,10_10_10_10_10_10_10_1_1_10_10_10_10_10_10_10_10_10_10_1_10_1_10_1_1_10_10_10_10_10_1_1_1_1_2_2_3_3
6725,18,1331248500,9,4,9,1331276700,28200,315240,1779540,1464300,0_0_0_0_0_0_0_0_0_1_1_1_1_0_9_9_9_9
6726,204,1331250420,16,14,16,1331250480,60,717360,2567700,1850340,16_16_16_16_16_16_16_16_16_16_16_16_16_16_16_16_16_16_16_16_16_16_1_1_1_1_1_16_1_2_2_16_16_16_16_16_16_16
6727,204,1331250480,16,14,16,1331268720,18240,717420,2567700,1850280,16_16_16_16_16_16_16_16_16_16_16_16_16_16_16_16_16_16_16_16_16_16_1_1_1_1_1_16_1_2_2_16_16_16_16_16_16_16_16
6728,13,1331250480,19,14,1,1331268600,18120,683940,2525940,1842000,19_19_19_1_1_19_19_19_19_19_19_19_19_19_19_19_1_1_1_19_1_19_19_19_19_19_19_19_19_19_19
6729,5,1331260500,10,16,10,1331270820,10320,242700,748200,505500,10_10_10_10_10_10_10_10_10
6730,5,1331260500,10,16,10,1331260500,0,242700,748200,505500,10_10_10_10_10_10_10_10
6731,75,1331268300,18,5,18,1331270160,1860,5159760,6135000,975240,16_16_16_16_16_16_1_16_16_1_16_16_16_16_16_16_16_16_1_1_2_2_39_39_1_1_3_3_3_3_3_3_3_3_3_3_2_3_3_2_18_18_18_18_18_18_18_18
6732,151,1331268360,4,5,4,1331270220,1860,3146160,3643800,497640,19_19_19_19_19_1_1_19_1_1_19_19_19_19_1_19_1_19_19_19_19_19_19_19_19_19_1_19_19_1_1_1_1_1_19_19_19_19_19_19_1_1_19_19_1_1_19_1_1_19_19_19_19_19_19_19_19_19_19_19_19_19_19_19_1_1_47_47_3_3_3_3_2_3_3_2_3_3_3_3_3_3_4_4_4_4_4_4_4_4_4_4_4_4
6733,13,1331268600,1,9,19,1331268660,60,702060,2525940,1823880,19_19_19_1_1_19_19_19_19_19_19_19_19_19_19_19_1_1_1_19_1_19_19_19_19_19_19_19_19_19_19_1
6734,13,1331268660,19,14,1,1331271120,2460,702120,2525940,1823820,19_19_19_1_1_19_19_19_19_19_19_19_19_19_19_19_1_1_1_19_1_19_19_19_19_19_19_19_19_19_19_1_19
6735,204,1331268720,16,14,16,1331270880,2160,735660,2567700,1832040,16_16_16_16_16_16_16_16_16_16_16_16_16_16_16_16_16_16_16_16_16_16_1_1_1_1_1_16_1_2_2_16_16_16_16_16_16_16_16_16
6736,208,1331269200,1,18,1,1331283120,13920,164940,1620480,1455540,16_16_16_16_16_16_16_16_1
6737,61,1331269800,34,17,34,1331288400,18600,5814600,6225300,410700,4_4_18_18_34_34_34_3_3_34_3_3_34_35_34_35_35_35_36_36_35_35_35_35_34_34_34_34_34_34_34_34_34_34_34_34_34_34_34_34_34_34_34_34_34_34_34_34_34
6738,75,1331270160,18,23,18,1331286540,16380,5161620,6135000,973380,16_16_16_16_16_16_1_16_16_1_16_16_16_16_16_16_16_16_1_1_2_2_39_39_1_1_3_3_3_3_3_3_3_3_3_3_2_3_3_2_18_18_18_18_18_18_18_18_18
6739,151,1331270220,4,23,4,1331286540,16320,3148020,3643800,495780,19_19_19_19_19_1_1_19_1_1_19_19_19_19_1_19_1_19_19_19_19_19_19_19_19_19_1_19_19_1_1_1_1_1_19_19_19_19_19_19_1_1_19_19_1_1_19_1_1_19_19_19_19_19_19_19_19_19_19_19_19_19_19_19_1_1_47_47_3_3_3_3_2_3_3_2_3_3_3_3_3_3_4_4_4_4_4_4_4_4_4_4_4_4_4
6740,162,1331270700,5,6,5,1331287380,16680,3182160,4836120,1653960,0_0_16_16_0_0_0_0_0_0_0_0_16_0_0_16_0_0_16_16_0_0_1_1_2_2_3_3_3_4_3_4_4_4_4_4_5
6741,5,1331270820,10,16,1,1331271120,300,253020,748200,495180,10_10_10_10_10_10_10_10_10_10
6742,204,1331270880,16,20,1,1331287560,16680,737820,2567700,1829880,16_16_16_16_16_16_16_16_16_16_16_16_16_16_16_16_16_16_16_16_16_16_1_1_1_1_1_16_1_2_2_16_16_16_16_16_16_16_16_16_16
6743,13,1331271120,1,9,19,1331272740,1620,704580,2525940,1821360,19_19_19_1_1_19_19_19_19_19_19_19_19_19_19_19_1_1_1_19_1_19_19_19_19_19_19_19_19_19_19_1_19_1
6744,5,1331271120,10,13,10,1331281620,10500,253320,748200,494880,10_10_10_10_10_10_10_10_10_10_1_10
6745,5,1331271120,1,9,10,1331271120,0,253320,748200,494880,10_10_10_10_10_10_10_10_10_10_1
6746,13,1331272740,19,20,19,1331288820,16080,706200,2525940,1819740,19_19_19_1_1_19_19_19_19_19_19_19_19_19_19_19_1_1_1_19_1_19_19_19_19_19_19_19_19_19_19_1_19_1_19
6747,89,1331274840,3,3,3,1331287980,13140,1473720,1736340,262620,19_19_19_19_19_1_19_1_19_19_19_19_1_1_1_1_2_2_3_3_3
6748,10,1331276400,5,18,5,1331278020,1620,978120,979740,1620,0_0_0_1_1_0_0_0_1_1_2_2_9_9_9_9_3_3_3_3_4_4_4_4_4_4_4_4_5_5_6_6_5
6749,18,1331276700,9,4,9,1331281020,4320,343440,1779540,1436100,0_0_0_0_0_0_0_0_0_1_1_1_1_0_9_9_9_9_9
6750,10,1331278020,5,18,99,1331278020,0,979740,979740,0,0_0_0_1_1_0_0_0_1_1_2_2_9_9_9_9_3_3_3_3_4_4_4_4_4_4_4_4_5_5_6_6_5_5
6751,18,1331281020,9,4,1,1331442000,160980,347760,1779540,1431780,0_0_0_0_0_0_0_0_0_1_1_1_1_0_9_9_9_9_9_9
6752,5,1331281620,10,13,1,1331282280,660,263820,748200,484380,10_10_10_10_10_10_10_10_10_10_1_10_10
6753,5,1331282280,1,9,1,1331444520,162240,264480,748200,483720,10_10_10_10_10_10_10_10_10_10_1_10_10_1
6754,32,1331282640,3,3,3,1331287140,4500,260760,1205580,944820,10_1_1_10_10_10_10_10_1_1_3
6755,208,1331283120,1,18,2,1331447820,164700,178860,1620480,1441620,16_16_16_16_16_16_16_16_1_1
6756,174,1331283600,1,9,1,1331290620,7020,704460,1300440,595980,10_1_10_1_10_10_19_19_1_1_9_9_1
6757,222,1331285400,1,18,1,1331289900,4500,0,1113000,1113000,1
6758,151,1331286540,4,23,4,1331410080,123540,3164340,3643800,479460,19_19_19_19_19_1_1_19_1_1_19_19_19_19_1_19_1_19_19_19_19_19_19_19_19_19_1_19_19_1_1_1_1_1_19_19_19_19_19_19_1_1_19_19_1_1_19_1_1_19_19_19_19_19_19_19_19_19_19_19_19_19_19_19_1_1_47_47_3_3_3_3_2_3_3_2_3_3_3_3_3_3_4_4_4_4_4_4_4_4_4_4_4_4_4_4
6759,75,1331286540,18,23,18,1331410140,123600,5178000,6135000,957000,16_16_16_16_16_16_1_16_16_1_16_16_16_16_16_16_16_16_1_1_2_2_39_39_1_1_3_3_3_3_3_3_3_3_3_3_2_3_3_2_18_18_18_18_18_18_18_18_18_18
6760,32,1331287140,3,3,3,1331287200,60,265260,1205580,940320,10_1_1_10_10_10_10_10_1_1_3_3
6761,32,1331287200,3,18,3,1331288100,900,265320,1205580,940260,10_1_1_10_10_10_10_10_1_1_3_3_3
6762,162,1331287380,5,6,5,1331649840,362460,3198840,4836120,1637280,0_0_16_16_0_0_0_0_0_0_0_0_16_0_0_16_0_0_16_16_0_0_1_1_2_2_3_3_3_4_3_4_4_4_4_4_5_5
6763,204,1331287560,1,6,16,1331288820,1260,754500,2567700,1813200,16_16_16_16_16_16_16_16_16_16_16_16_16_16_16_16_16_16_16_16_16_16_1_1_1_1_1_16_1_2_2_16_16_16_16_16_16_16_16_16_16_1
6764,89,1331287980,3,3,5,1331464800,176820,1486860,1736340,249480,19_19_19_19_19_1_19_1_19_19_19_19_1_1_1_1_2_2_3_3_3_3
6765,32,1331288100,3,18,6,1332108000,819900,266220,1205580,939360,10_1_1_10_10_10_10_10_1_1_3_3_3_3
6766,46,1331288400,3,3,2,1331288460,60,1869360,2027040,157680,26_26_26_26_26_26_26_26_8_8_9_9_3_3_5_5_27_27_28_28_28_28_8_8_3
6767,61,1331288400,34,17,34,1331445720,157320,5833200,6225300,392100,4_4_18_18_34_34_34_3_3_34_3_3_34_35_34_35_35_35_36_36_35_35_35_35_34_34_34_34_34_34_34_34_34_34_34_34_34_34_34_34_34_34_34_34_34_34_34_34_34_34
6768,46,1331288460,2,3,2,1331290440,1980,1869420,2027040,157620,26_26_26_26_26_26_26_26_8_8_9_9_3_3_5_5_27_27_28_28_28_28_8_8_3_2
6769,204,1331288820,16,20,1,1331289780,960,755760,2567700,1811940,16_16_16_16_16_16_16_16_16_16_16_16_16_16_16_16_16_16_16_16_16_16_1_1_1_1_1_16_1_2_2_16_16_16_16_16_16_16_16_16_16_1_16
6770,13,1331288820,19,20,19,1331377200,88380,722280,2525940,1803660,19_19_19_1_1_19_19_19_19_19_19_19_19_19_19_19_1_1_1_19_1_19_19_19_19_19_19_19_19_19_19_1_19_1_19_19
6771,204,1331289780,1,6,16,1331373780,84000,756720,2567700,1810980,16_16_16_16_16_16_16_16_16_16_16_16_16_16_16_16_16_16_16_16_16_16_1_1_1_1_1_16_1_2_2_16_16_16_16_16_16_16_16_16_16_1_16_1
6772,222,1331289900,1,18,2,1331470560,180660,4500,1113000,1108500,1_1
6773,46,1331290440,2,3,3,1331292900,2460,1871400,2027040,155640,26_26_26_26_26_26_26_26_8_8_9_9_3_3_5_5_27_27_28_28_28_28_8_8_3_2_2
6774,191,1331290500,3,3,2,1331290500,0,1651020,1811280,160260,26_26_26_26_8_8_9_9_3_3_28_28_8_8_3
6775,191,1331290500,2,3,3,1331295000,4500,1651020,1811280,160260,26_26_26_26_8_8_9_9_3_3_28_28_8_8_3_2
6776,174,1331290620,1,9,2,1331805480,514860,711480,1300440,588960,10_1_10_1_10_10_19_19_1_1_9_9_1_1
6777,46,1331292900,3,3,6,1331416800,123900,1873860,2027040,153180,26_26_26_26_26_26_26_26_8_8_9_9_3_3_5_5_27_27_28_28_28_28_8_8_3_2_2_3
6778,191,1331295000,2,3,6,1331416800,121800,1655520,1811280,155760,26_26_26_26_8_8_9_9_3_3_28_28_8_8_3_2_3_2
6779,191,1331295000,3,3,2,1331295000,0,1655520,1811280,155760,26_26_26_26_8_8_9_9_3_3_28_28_8_8_3_2_3
6780,204,1331373780,16,11,16,1331377200,3420,840720,2567700,1726980,16_16_16_16_16_16_16_16_16_16_16_16_16_16_16_16_16_16_16_16_16_16_1_1_1_1_1_16_1_2_2_16_16_16_16_16_16_16_16_16_16_1_16_1_16
6781,204,1331377200,16,0,16,1331391780,14580,844140,2567700,1723560,16_16_16_16_16_16_16_16_16_16_16_16_16_16_16_16_16_16_16_16_16_16_1_1_1_1_1_16_1_2_2_16_16_16_16_16_16_16_16_16_16_1_16_1_16_16
6782,13,1331377200,19,0,19,1331414760,37560,810660,2525940,1715280,19_19_19_1_1_19_19_19_19_19_19_19_19_19_19_19_1_1_1_19_1_19_19_19_19_19_19_19_19_19_19_1_19_1_19_19_19
6783,204,1331391780,16,11,16,1331414820,23040,858720,2567700,1708980,16_16_16_16_16_16_16_16_16_16_16_16_16_16_16_16_16_16_16_16_16_16_1_1_1_1_1_16_1_2_2_16_16_16_16_16_16_16_16_16_16_1_16_1_16_16_16
6784,57,1331410020,26,32,26,1331438880,28860,1142280,2756640,1614360,26_26_26_26_26_26_26_26_26_26_26_26_26_26_26_26_26_26_26_26_26_26_26_26_26_8_8_8_8_2_2_26_8_8_26_26_26_26_26_26_26_26_8_8_26_26_26_26_26_26_8_8_8_8_26_26_26
6785,151,1331410080,4,17,4,1331440440,30360,3287880,3643800,355920,19_19_19_19_19_1_1_19_1_1_19_19_19_19_1_19_1_19_19_19_19_19_19_19_19_19_1_19_19_1_1_1_1_1_19_19_19_19_19_19_1_1_19_19_1_1_19_1_1_19_19_19_19_19_19_19_19_19_19_19_19_19_19_19_1_1_47_47_3_3_3_3_2_3_3_2_3_3_3_3_3_3_4_4_4_4_4_4_4_4_4_4_4_4_4_4_4
6786,75,1331410140,18,17,18,1331440380,30240,5301600,6135000,833400,16_16_16_16_16_16_1_16_16_1_16_16_16_16_16_16_16_16_1_1_2_2_39_39_1_1_3_3_3_3_3_3_3_3_3_3_2_3_3_2_18_18_18_18_18_18_18_18_18_18_18
6787,13,1331414760,19,11,19,1331440500,25740,848220,2525940,1677720,19_19_19_1_1_19_19_19_19_19_19_19_19_19_19_19_1_1_1_19_1_19_19_19_19_19_19_19_19_19_19_1_19_1_19_19_19_19
6788,204,1331414820,16,11,16,1331440500,25680,881760,2567700,1685940,16_16_16_16_16_16_16_16_16_16_16_16_16_16_16_16_16_16_16_16_16_16_1_1_1_1_1_16_1_2_2_16_16_16_16_16_16_16_16_16_16_1_16_1_16_16_16_16
6789,46,1331416800,6,7,6,1331420400,3600,1997760,2027040,29280,26_26_26_26_26_26_26_26_8_8_9_9_3_3_5_5_27_27_28_28_28_28_8_8_3_2_2_3_6
6790,191,1331416800,6,7,6,1331420400,3600,1777320,1811280,33960,26_26_26_26_8_8_9_9_3_3_28_28_8_8_3_2_3_2_6
6791,191,1331420400,6,7,5,1331446260,25860,1780920,1811280,30360,26_26_26_26_8_8_9_9_3_3_28_28_8_8_3_2_3_2_6_6
6792,46,1331420400,6,7,5,1331445600,25200,2001360,2027040,25680,26_26_26_26_26_26_26_26_8_8_9_9_3_3_5_5_27_27_28_28_28_28_8_8_3_2_2_3_6_6
6793,57,1331438880,26,32,6,1332367200,928320,1171140,2756640,1585500,26_26_26_26_26_26_26_26_26_26_26_26_26_26_26_26_26_26_26_26_26_26_26_26_26_8_8_8_8_2_2_26_8_8_26_26_26_26_26_26_26_26_8_8_26_26_26_26_26_26_8_8_8_8_26_26_26_26
6794,75,1331440380,18,17,18,1331441040,660,5331840,6135000,803160,16_16_16_16_16_16_1_16_16_1_16_16_16_16_16_16_16_16_1_1_2_2_39_39_1_1_3_3_3_3_3_3_3_3_3_3_2_3_3_2_18_18_18_18_18_18_18_18_18_18_18_18
6795,151,1331440440,4,17,4,1331445360,4920,3318240,3643800,325560,19_19_19_19_19_1_1_19_1_1_19_19_19_19_1_19_1_19_19_19_19_19_19_19_19_19_1_19_19_1_1_1_1_1_19_19_19_19_19_19_1_1_19_19_1_1_19_1_1_19_19_19_19_19_19_19_19_19_19_19_19_19_19_19_1_1_47_47_3_3_3_3_2_3_3_2_3_3_3_3_3_3_4_4_4_4_4_4_4_4_4_4_4_4_4_4_4_4
6796,204,1331440500,16,11,16,1331441700,1200,907440,2567700,1660260,16_16_16_16_16_16_16_16_16_16_16_16_16_16_16_16_16_16_16_16_16_16_1_1_1_1_1_16_1_2_2_16_16_16_16_16_16_16_16_16_16_1_16_1_16_16_16_16_16
6797,13,1331440500,19,11,19,1331441700,1200,873960,2525940,1651980,19_19_19_1_1_19_19_19_19_19_19_19_19_19_19_19_1_1_1_19_1_19_19_19_19_19_19_19_19_19_19_1_19_1_19_19_19_19_19
6798,75,1331441040,18,19,18,1331441520,480,5332500,6135000,802500,16_16_16_16_16_16_1_16_16_1_16_16_16_16_16_16_16_16_1_1_2_2_39_39_1_1_3_3_3_3_3_3_3_3_3_3_2_3_3_2_18_18_18_18_18_18_18_18_18_18_18_18_18
6799,75,1331441520,18,19,18,1331445480,3960,5332980,6135000,802020,16_16_16_16_16_16_1_16_16_1_16_16_16_16_16_16_16_16_1_1_2_2_39_39_1_1_3_3_3_3_3_3_3_3_3_3_2_3_3_2_18_18_18_18_18_18_18_18_18_18_18_18_18_18
6800,13,1331441700,19,14,1,1331441880,180,875160,2525940,1650780,19_19_19_1_1_19_19_19_19_19_19_19_19_19_19_19_1_1_1_19_1_19_19_19_19_19_19_19_19_19_19_1_19_1_19_19_19_19_19_19
6801,204,1331441700,16,14,1,1331446980,5280,908640,2567700,1659060,16_16_16_16_16_16_16_16_16_16_16_16_16_16_16_16_16_16_16_16_16_16_1_1_1_1_1_16_1_2_2_16_16_16_16_16_16_16_16_16_16_1_16_1_16_16_16_16_16_16
6802,13,1331441880,1,9,1,1331444520,2640,875340,2525940,1650600,19_19_19_1_1_19_19_19_19_19_19_19_19_19_19_19_1_1_1_19_1_19_19_19_19_19_19_19_19_19_19_1_19_1_19_19_19_19_19_19_1
6803,18,1331442000,1,18,1,1331445600,3600,508740,1779540,1270800,0_0_0_0_0_0_0_0_0_1_1_1_1_0_9_9_9_9_9_9_1
6804,213,1331442120,2,4,2,1331447280,5160,2405700,3206820,801120,0_0_0_0_0_1_0_1_0_0_0_0_0_0_0_0_1_1_0_0_0_0_0_0_0_1_1_0_0_0_0_0_0_0_0_0_0_0_0_0_0_1_1_1_0_1_0_0_0_0_0_0_0_0_0_0_1_0_1_0_0_0_0_0_0_0_0_0_0_0_0_0_0_0_0_0_0_0_0_1_1_0_0_0_0_0_0_0_0_0_0_0_0_0_1_1_0_0_2_2_3_3_4_3_3_4_2_2_4_4_4_4_4_4_4_4_5_2_3_4_5_2_3_4_6_6_5_5_0_1_0_1_2
6805,13,1331444520,1,9,1,1331445720,1200,877980,2525940,1647960,19_19_19_1_1_19_19_19_19_19_19_19_19_19_19_19_1_1_1_19_1_19_19_19_19_19_19_19_19_19_19_1_19_1_19_19_19_19_19_19_1_1
6806,5,1331444520,1,9,1,1331446560,2040,426720,748200,321480,10_10_10_10_10_10_10_10_10_10_1_10_10_1_1
6807,151,1331445360,4,5,5,1331446680,1320,3323160,3643800,320640,19_19_19_19_19_1_1_19_1_1_19_19_19_19_1_19_1_19_19_19_19_19_19_19_19_19_1_19_19_1_1_1_1_1_19_19_19_19_19_19_1_1_19_19_1_1_19_1_1_19_19_19_19_19_19_19_19_19_19_19_19_19_19_19_1_1_47_47_3_3_3_3_2_3_3_2_3_3_3_3_3_3_4_4_4_4_4_4_4_4_4_4_4_4_4_4_4_4_4
6808,75,1331445480,18,19,18,1331474220,28740,5336940,6135000,798060,16_16_16_16_16_16_1_16_16_1_16_16_16_16_16_16_16_16_1_1_2_2_39_39_1_1_3_3_3_3_3_3_3_3_3_3_2_3_3_2_18_18_18_18_18_18_18_18_18_18_18_18_18_18_18
6809,46,1331445600,5,9,5,1331446080,480,2026560,2027040,480,26_26_26_26_26_26_26_26_8_8_9_9_3_3_5_5_27_27_28_28_28_28_8_8_3_2_2_3_6_6_5
6810,18,1331445600,1,18,3,1331451960,6360,512340,1779540,1267200,0_0_0_0_0_0_0_0_0_1_1_1_1_0_9_9_9_9_9_9_1_1
6811,13,1331445720,1,9,1,1331450220,4500,879180,2525940,1646760,19_19_19_1_1_19_19_19_19_19_19_19_19_19_19_19_1_1_1_19_1_19_19_19_19_19_19_19_19_19_19_1_19_1_19_19_19_19_19_19_1_1_1
6812,61,1331445720,34,15,34,1331473260,27540,5990520,6225300,234780,4_4_18_18_34_34_34_3_3_34_3_3_34_35_34_35_35_35_36_36_35_35_35_35_34_34_34_34_34_34_34_34_34_34_34_34_34_34_34_34_34_34_34_34_34_34_34_34_34_34_34
6813,46,1331446080,5,9,99,1331446080,0,2027040,2027040,0,26_26_26_26_26_26_26_26_8_8_9_9_3_3_5_5_27_27_28_28_28_28_8_8_3_2_2_3_6_6_5_5
6814,191,1331446260,5,9,5,1331450760,4500,1806780,1811280,4500,26_26_26_26_8_8_9_9_3_3_28_28_8_8_3_2_3_2_6_6_5
6815,5,1331446560,1,9,10,1331449380,2820,428760,748200,319440,10_10_10_10_10_10_10_10_10_10_1_10_10_1_1_1
6816,151,1331446680,5,9,4,1331458560,11880,3324480,3643800,319320,19_19_19_19_19_1_1_19_1_1_19_19_19_19_1_19_1_19_19_19_19_19_19_19_19_19_1_19_19_1_1_1_1_1_19_19_19_19_19_19_1_1_19_19_1_1_19_1_1_19_19_19_19_19_19_19_19_19_19_19_19_19_19_19_1_1_47_47_3_3_3_3_2_3_3_2_3_3_3_3_3_3_4_4_4_4_4_4_4_4_4_4_4_4_4_4_4_4_4_5
6817,204,1331446980,1,6,1,1331450640,3660,913920,2567700,1653780,16_16_16_16_16_16_16_16_16_16_16_16_16_16_16_16_16_16_16_16_16_16_1_1_1_1_1_16_1_2_2_16_16_16_16_16_16_16_16_16_16_1_16_1_16_16_16_16_16_16_1
6818,213,1331447280,2,4,2,1331458980,11700,2410860,3206820,795960,0_0_0_0_0_1_0_1_0_0_0_0_0_0_0_0_1_1_0_0_0_0_0_0_0_1_1_0_0_0_0_0_0_0_0_0_0_0_0_0_0_1_1_1_0_1_0_0_0_0_0_0_0_0_0_0_1_0_1_0_0_0_0_0_0_0_0_0_0_0_0_0_0_0_0_0_0_0_0_1_1_0_0_0_0_0_0_0_0_0_0_0_0_0_1_1_0_0_2_2_3_3_4_3_3_4_2_2_4_4_4_4_4_4_4_4_5_2_3_4_5_2_3_4_6_6_5_5_0_1_0_1_2_2
6819,208,1331447820,2,3,2,1331451420,3600,343560,1620480,1276920,16_16_16_16_16_16_16_16_1_1_2
6820,5,1331449380,10,16,10,1331455020,5640,431580,748200,316620,10_10_10_10_10_10_10_10_10_10_1_10_10_1_1_1_10
6821,13,1331450220,1,9,19,1331456040,5820,883680,2525940,1642260,19_19_19_1_1_19_19_19_19_19_19_19_19_19_19_19_1_1_1_19_1_19_19_19_19_19_19_19_19_19_19_1_19_1_19_19_19_19_19_19_1_1_1_1
6822,204,1331450640,1,6,16,1331456100,5460,917580,2567700,1650120,16_16_16_16_16_16_16_16_16_16_16_16_16_16_16_16_16_16_16_16_16_16_1_1_1_1_1_16_1_2_2_16_16_16_16_16_16_16_16_16_16_1_16_1_16_16_16_16_16_16_1_1
6823,191,1331450760,5,9,99,1331450760,0,1811280,1811280,0,26_26_26_26_8_8_9_9_3_3_28_28_8_8_3_2_3_2_6_6_5_5
6824,208,1331451420,2,3,21,1332419340,967920,347160,1620480,1273320,16_16_16_16_16_16_16_16_1_1_2_2
6825,4,1331451480,3,3,3,1331456640,5160,1097880,1326000,228120,10_10_10_10_10_10_10_1_1_10_10_10_10_10_10_10_10_10_10_1_10_1_10_1_1_10_10_10_10_10_1_1_1_1_2_2_3_3_3
6826,18,1331451960,3,4,3,1331457240,5280,518700,1779540,1260840,0_0_0_0_0_0_0_0_0_1_1_1_1_0_9_9_9_9_9_9_1_1_3
6827,5,1331455020,10,16,10,1331459280,4260,437220,748200,310980,10_10_10_10_10_10_10_10_10_10_1_10_10_1_1_1_10_10_10
6828,5,1331455020,10,16,10,1331455020,0,437220,748200,310980,10_10_10_10_10_10_10_10_10_10_1_10_10_1_1_1_10_10
6829,13,1331456040,19,0,19,1331474940,18900,889500,2525940,1636440,19_19_19_1_1_19_19_19_19_19_19_19_19_19_19_19_1_1_1_19_1_19_19_19_19_19_19_19_19_19_19_1_19_1_19_19_19_19_19_19_1_1_1_1_19
6830,204,1331456100,16,0,16,1331474880,18780,923040,2567700,1644660,16_16_16_16_16_16_16_16_16_16_16_16_16_16_16_16_16_16_16_16_16_16_1_1_1_1_1_16_1_2_2_16_16_16_16_16_16_16_16_16_16_1_16_1_16_16_16_16_16_16_1_1_16
6831,187,1331456640,2,3,9,1331458380,1740,1805820,2496960,691140,10_10_10_10_10_10_10_10_10_10_10_10_1_1_1_1_2
6832,4,1331456640,3,3,14,1331486700,30060,1103040,1326000,222960,10_10_10_10_10_10_10_1_1_10_10_10_10_10_10_10_10_10_10_1_10_1_10_1_1_10_10_10_10_10_1_1_1_1_2_2_3_3_3_3
6833,2,1331456700,2,3,2,1331456760,60,1706160,2555640,849480,10_10_10_10_10_10_10_10_1_1_2
6834,2,1331456760,2,3,9,1331461380,4620,1706220,2555640,849420,10_10_10_10_10_10_10_10_1_1_2_2
6835,18,1331457240,3,4,18,1331491260,34020,523980,1779540,1255560,0_0_0_0_0_0_0_0_0_1_1_1_1_0_9_9_9_9_9_9_1_1_3_3
6836,187,1331458380,9,3,2,1331461140,2760,1807560,2496960,689400,10_10_10_10_10_10_10_10_10_10_10_10_1_1_1_1_2_9
6837,151,1331458560,4,5,4,1331458980,420,3336360,3643800,307440,19_19_19_19_19_1_1_19_1_1_19_19_19_19_1_19_1_19_19_19_19_19_19_19_19_19_1_19_19_1_1_1_1_1_19_19_19_19_19_19_1_1_19_19_1_1_19_1_1_19_19_19_19_19_19_19_19_19_19_19_19_19_19_19_1_1_47_47_3_3_3_3_2_3_3_2_3_3_3_3_3_3_4_4_4_4_4_4_4_4_4_4_4_4_4_4_4_4_4_5_4
6838,151,1331458980,4,19,5,1331465640,6660,3336780,3643800,307020,19_19_19_19_19_1_1_19_1_1_19_19_19_19_1_19_1_19_19_19_19_19_19_19_19_19_1_19_19_1_1_1_1_1_19_19_19_19_19_19_1_1_19_19_1_1_19_1_1_19_19_19_19_19_19_19_19_19_19_19_19_19_19_19_1_1_47_47_3_3_3_3_2_3_3_2_3_3_3_3_3_3_4_4_4_4_4_4_4_4_4_4_4_4_4_4_4_4_4_5_4_4
6839,213,1331458980,2,5,2,1331469840,10860,2422560,3206820,784260,0_0_0_0_0_1_0_1_0_0_0_0_0_0_0_0_1_1_0_0_0_0_0_0_0_1_1_0_0_0_0_0_0_0_0_0_0_0_0_0_0_1_1_1_0_1_0_0_0_0_0_0_0_0_0_0_1_0_1_0_0_0_0_0_0_0_0_0_0_0_0_0_0_0_0_0_0_0_0_1_1_0_0_0_0_0_0_0_0_0_0_0_0_0_1_1_0_0_2_2_3_3_4_3_3_4_2_2_4_4_4_4_4_4_4_4_5_2_3_4_5_2_3_4_6_6_5_5_0_1_0_1_2_2_2
6840,5,1331459280,10,16,10,1331459340,60,441480,748200,306720,10_10_10_10_10_10_10_10_10_10_1_10_10_1_1_1_10_10_10_10
6841,195,1331459280,0,1,0,1331487300,28020,0,393120,393120,0
6842,5,1331459340,10,16,10,1331474940,15600,441540,748200,306660,10_10_10_10_10_10_10_10_10_10_1_10_10_1_1_1_10_10_10_10_10
6843,187,1331461140,2,3,9,1331461200,60,1810320,2496960,686640,10_10_10_10_10_10_10_10_10_10_10_10_1_1_1_1_2_9_2
6844,187,1331461200,9,3,3,1331461260,60,1810380,2496960,686580,10_10_10_10_10_10_10_10_10_10_10_10_1_1_1_1_2_9_2_9
6845,187,1331461260,3,4,3,1331465760,4500,1810440,2496960,686520,10_10_10_10_10_10_10_10_10_10_10_10_1_1_1_1_2_9_2_9_3
6846,2,1331461380,9,3,9,1331462700,1320,1710840,2555640,844800,10_10_10_10_10_10_10_10_1_1_2_2_9
6847,2,1331462700,9,3,3,1331462760,60,1712160,2555640,843480,10_10_10_10_10_10_10_10_1_1_2_2_9_9
6848,2,1331462760,3,4,3,1331464680,1920,1712220,2555640,843420,10_10_10_10_10_10_10_10_1_1_2_2_9_9_3
6849,2,1331464680,3,4,4,1331627640,162960,1714140,2555640,841500,10_10_10_10_10_10_10_10_1_1_2_2_9_9_3_3
6850,89,1331464800,5,9,5,1331481600,16800,1663680,1736340,72660,19_19_19_19_19_1_19_1_19_19_19_19_1_1_1_1_2_2_3_3_3_3_5
6851,151,1331465640,5,9,4,1331474220,8580,3343440,3643800,300360,19_19_19_19_19_1_1_19_1_1_19_19_19_19_1_19_1_19_19_19_19_19_19_19_19_19_1_19_19_1_1_1_1_1_19_19_19_19_19_19_1_1_19_19_1_1_19_1_1_19_19_19_19_19_19_19_19_19_19_19_19_19_19_19_1_1_47_47_3_3_3_3_2_3_3_2_3_3_3_3_3_3_4_4_4_4_4_4_4_4_4_4_4_4_4_4_4_4_4_5_4_4_5
6852,187,1331465760,3,4,4,1331614860,149100,1814940,2496960,682020,10_10_10_10_10_10_10_10_10_10_10_10_1_1_1_1_2_9_2_9_3_3
6853,213,1331469840,2,5,3,1331562120,92280,2433420,3206820,773400,0_0_0_0_0_1_0_1_0_0_0_0_0_0_0_0_1_1_0_0_0_0_0_0_0_1_1_0_0_0_0_0_0_0_0_0_0_0_0_0_0_1_1_1_0_1_0_0_0_0_0_0_0_0_0_0_1_0_1_0_0_0_0_0_0_0_0_0_0_0_0_0_0_0_0_0_0_0_0_1_1_0_0_0_0_0_0_0_0_0_0_0_0_0_1_1_0_0_2_2_3_3_4_3_3_4_2_2_4_4_4_4_4_4_4_4_5_2_3_4_5_2_3_4_6_6_5_5_0_1_0_1_2_2_2_2
6854,188,1331470200,3,3,3,1331473200,3000,2798160,4327560,1529400,0_0_0_0_0_1_1_0_0_0_0_0_0_0_0_0_1_1_2_2_2_2_3_3_3_3_21_21_3
6855,222,1331470560,2,5,2,1331473980,3420,185160,1113000,927840,1_1_2
6856,169,1331470800,5,18,3,1331471280,480,1809060,2190660,381600,50_50_50_50_50_50_50_50_50_50_50_50_50_50_50_50_50_1_1_50_50_50_50_1_1_50_50_50_50_50_50_50_50_1_1_50_3_3_50_2_50_2_50_50_50_6_6_3_3_50_5_2_2_2_2_5_50_50_1_1_2_2_3_3_3_3_3_3_3_3_5
6857,169,1331471280,3,3,5,1331474100,2820,1809540,2190660,381120,50_50_50_50_50_50_50_50_50_50_50_50_50_50_50_50_50_1_1_50_50_50_50_1_1_50_50_50_50_50_50_50_50_1_1_50_3_3_50_2_50_2_50_50_50_6_6_3_3_50_5_2_2_2_2_5_50_50_1_1_2_2_3_3_3_3_3_3_3_3_5_3
6858,188,1331473200,3,4,3,1331473260,60,2801160,4327560,1526400,0_0_0_0_0_1_1_0_0_0_0_0_0_0_0_0_1_1_2_2_2_2_3_3_3_3_21_21_3_3
6859,188,1331473260,3,4,3,1331474700,1440,2801220,4327560,1526340,0_0_0_0_0_1_1_0_0_0_0_0_0_0_0_0_1_1_2_2_2_2_3_3_3_3_21_21_3_3_3
6860,61,1331473260,34,15,34,1331474880,1620,6018060,6225300,207240,4_4_18_18_34_34_34_3_3_34_3_3_34_35_34_35_35_35_36_36_35_35_35_35_34_34_34_34_34_34_34_34_34_34_34_34_34_34_34_34_34_34_34_34_34_34_34_34_34_34_34_34
6861,222,1331473980,2,5,2,1331474520,540,188580,1113000,924420,1_1_2_2
6862,169,1331474100,5,18,3,1331480280,6180,1812360,2190660,378300,50_50_50_50_50_50_50_50_50_50_50_50_50_50_50_50_50_1_1_50_50_50_50_1_1_50_50_50_50_50_50_50_50_1_1_50_3_3_50_2_50_2_50_50_50_6_6_3_3_50_5_2_2_2_2_5_50_50_1_1_2_2_3_3_3_3_3_3_3_3_5_3_5
6863,75,1331474220,18,19,18,1331475480,1260,5365680,6135000,769320,16_16_16_16_16_16_1_16_16_1_16_16_16_16_16_16_16_16_1_1_2_2_39_39_1_1_3_3_3_3_3_3_3_3_3_3_2_3_3_2_18_18_18_18_18_18_18_18_18_18_18_18_18_18_18_18
6864,151,1331474220,4,19,4,1331475780,1560,3352020,3643800,291780,19_19_19_19_19_1_1_19_1_1_19_19_19_19_1_19_1_19_19_19_19_19_19_19_19_19_1_19_19_1_1_1_1_1_19_19_19_19_19_19_1_1_19_19_1_1_19_1_1_19_19_19_19_19_19_19_19_19_19_19_19_19_19_19_1_1_47_47_3_3_3_3_2_3_3_2_3_3_3_3_3_3_4_4_4_4_4_4_4_4_4_4_4_4_4_4_4_4_4_5_4_4_5_4
6865,222,1331474520,2,4,2,1331477280,2760,189120,1113000,923880,1_1_2_2_2
6866,188,1331474700,3,3,3,1331503200,28500,2802660,4327560,1524900,0_0_0_0_0_1_1_0_0_0_0_0_0_0_0_0_1_1_2_2_2_2_3_3_3_3_21_21_3_3_3_3
6867,204,1331474880,16,14,16,1331475120,240,941820,2567700,1625880,16_16_16_16_16_16_16_16_16_16_16_16_16_16_16_16_16_16_16_16_16_16_1_1_1_1_1_16_1_2_2_16_16_16_16_16_16_16_16_16_16_1_16_1_16_16_16_16_16_16_1_1_16_16
6868,61,1331474880,34,17,34,1331486700,11820,6019680,6225300,205620,4_4_18_18_34_34_34_3_3_34_3_3_34_35_34_35_35_35_36_36_35_35_35_35_34_34_34_34_34_34_34_34_34_34_34_34_34_34_34_34_34_34_34_34_34_34_34_34_34_34_34_34_34
6869,5,1331474940,10,16,10,1331476500,1560,457140,748200,291060,10_10_10_10_10_10_10_10_10_10_1_10_10_1_1_1_10_10_10_10_10_10
6870,13,1331474940,19,14,19,1331475060,120,908400,2525940,1617540,19_19_19_1_1_19_19_19_19_19_19_19_19_19_19_19_1_1_1_19_1_19_19_19_19_19_19_19_19_19_19_1_19_1_19_19_19_19_19_19_1_1_1_1_19_19
6871,13,1331475060,19,20,19,1331489520,14460,908520,2525940,1617420,19_19_19_1_1_19_19_19_19_19_19_19_19_19_19_19_1_1_1_19_1_19_19_19_19_19_19_19_19_19_19_1_19_1_19_19_19_19_19_19_1_1_1_1_19_19_19
6872,204,1331475120,16,20,16,1331478900,3780,942060,2567700,1625640,16_16_16_16_16_16_16_16_16_16_16_16_16_16_16_16_16_16_16_16_16_16_1_1_1_1_1_16_1_2_2_16_16_16_16_16_16_16_16_16_16_1_16_1_16_16_16_16_16_16_1_1_16_16_16
6873,75,1331475480,18,23,18,1331491200,15720,5366940,6135000,768060,16_16_16_16_16_16_1_16_16_1_16_16_16_16_16_16_16_16_1_1_2_2_39_39_1_1_3_3_3_3_3_3_3_3_3_3_2_3_3_2_18_18_18_18_18_18_18_18_18_18_18_18_18_18_18_18_18
6874,151,1331475780,4,23,4,1331483100,7320,3353580,3643800,290220,19_19_19_19_19_1_1_19_1_1_19_19_19_19_1_19_1_19_19_19_19_19_19_19_19_19_1_19_19_1_1_1_1_1_19_19_19_19_19_19_1_1_19_19_1_1_19_1_1_19_19_19_19_19_19_19_19_19_19_19_19_19_19_19_1_1_47_47_3_3_3_3_2_3_3_2_3_3_3_3_3_3_4_4_4_4_4_4_4_4_4_4_4_4_4_4_4_4_4_5_4_4_5_4_4
6875,5,1331476500,10,13,10,1331483700,7200,458700,748200,289500,10_10_10_10_10_10_10_10_10_10_1_10_10_1_1_1_10_10_10_10_10_10_10
6876,222,1331477280,2,4,3,1331503200,25920,191880,1113000,921120,1_1_2_2_2_2
6877,204,1331478900,16,20,16,1331479140,240,945840,2567700,1621860,16_16_16_16_16_16_16_16_16_16_16_16_16_16_16_16_16_16_16_16_16_16_1_1_1_1_1_16_1_2_2_16_16_16_16_16_16_16_16_16_16_1_16_1_16_16_16_16_16_16_1_1_16_16_16_16
6878,204,1331479140,16,20,16,1331502000,22860,946080,2567700,1621620,16_16_16_16_16_16_16_16_16_16_16_16_16_16_16_16_16_16_16_16_16_16_1_1_1_1_1_16_1_2_2_16_16_16_16_16_16_16_16_16_16_1_16_1_16_16_16_16_16_16_1_1_16_16_16_16_16
6879,169,1331480280,3,3,5,1331544000,63720,1818540,2190660,372120,50_50_50_50_50_50_50_50_50_50_50_50_50_50_50_50_50_1_1_50_50_50_50_1_1_50_50_50_50_50_50_50_50_1_1_50_3_3_50_2_50_2_50_50_50_6_6_3_3_50_5_2_2_2_2_5_50_50_1_1_2_2_3_3_3_3_3_3_3_3_5_3_5_3
6880,89,1331481600,5,9,6,1331503200,21600,1680480,1736340,55860,19_19_19_19_19_1_19_1_19_19_19_19_1_1_1_1_2_2_3_3_3_3_5_5
6881,151,1331483100,4,23,4,1331489520,6420,3360900,3643800,282900,19_19_19_19_19_1_1_19_1_1_19_19_19_19_1_19_1_19_19_19_19_19_19_19_19_19_1_19_19_1_1_1_1_1_19_19_19_19_19_19_1_1_19_19_1_1_19_1_1_19_19_19_19_19_19_19_19_19_19_19_19_19_19_19_1_1_47_47_3_3_3_3_2_3_3_2_3_3_3_3_3_3_4_4_4_4_4_4_4_4_4_4_4_4_4_4_4_4_4_5_4_4_5_4_4_4
6882,5,1331483700,10,13,1,1331533620,49920,465900,748200,282300,10_10_10_10_10_10_10_10_10_10_1_10_10_1_1_1_10_10_10_10_10_10_10_10
6883,48,1331483760,26,13,26,1331500320,16560,0,156420,156420,26
6884,61,1331486700,34,17,34,1331529660,42960,6031500,6225300,193800,4_4_18_18_34_34_34_3_3_34_3_3_34_35_34_35_35_35_36_36_35_35_35_35_34_34_34_34_34_34_34_34_34_34_34_34_34_34_34_34_34_34_34_34_34_34_34_34_34_34_34_34_34_34
6885,4,1331486700,14,17,14,1331488800,2100,1133100,1326000,192900,10_10_10_10_10_10_10_1_1_10_10_10_10_10_10_10_10_10_10_1_10_1_10_1_1_10_10_10_10_10_1_1_1_1_2_2_3_3_3_3_14
6886,195,1331487300,0,1,54,1331487420,120,28020,393120,365100,0_0
6887,195,1331487420,54,0,54,1331494200,6780,28140,393120,364980,0_0_54
6888,4,1331488800,14,17,14,1331488800,0,1135200,1326000,190800,10_10_10_10_10_10_10_1_1_10_10_10_10_10_10_10_10_10_10_1_10_1_10_1_1_10_10_10_10_10_1_1_1_1_2_2_3_3_3_3_14_14
6889,4,1331488800,14,17,14,1331502000,13200,1135200,1326000,190800,10_10_10_10_10_10_10_1_1_10_10_10_10_10_10_10_10_10_10_1_10_1_10_1_1_10_10_10_10_10_1_1_1_1_2_2_3_3_3_3_14_14_14
6890,151,1331489520,4,22,6,1331503200,13680,3367320,3643800,276480,19_19_19_19_19_1_1_19_1_1_19_19_19_19_1_19_1_19_19_19_19_19_19_19_19_19_1_19_19_1_1_1_1_1_19_19_19_19_19_19_1_1_19_19_1_1_19_1_1_19_19_19_19_19_19_19_19_19_19_19_19_19_19_19_1_1_47_47_3_3_3_3_2_3_3_2_3_3_3_3_3_3_4_4_4_4_4_4_4_4_4_4_4_4_4_4_4_4_4_5_4_4_5_4_4_4_4
6891,13,1331489520,19,20,1,1331532000,42480,922980,2525940,1602960,19_19_19_1_1_19_19_19_19_19_19_19_19_19_19_19_1_1_1_19_1_19_19_19_19_19_19_19_19_19_19_1_19_1_19_19_19_19_19_19_1_1_1_1_19_19_19_19
6892,167,1331490300,19,11,19,1331501340,11040,0,534900,534900,19
6893,75,1331491200,18,23,5,1331803140,311940,5382660,6135000,752340,16_16_16_16_16_16_1_16_16_1_16_16_16_16_16_16_16_16_1_1_2_2_39_39_1_1_3_3_3_3_3_3_3_3_3_3_2_3_3_2_18_18_18_18_18_18_18_18_18_18_18_18_18_18_18_18_18_18
6894,18,1331491260,18,23,18,1331498940,7680,558000,1779540,1221540,0_0_0_0_0_0_0_0_0_1_1_1_1_0_9_9_9_9_9_9_1_1_3_3_18
6895,195,1331494200,54,0,0,1331531580,37380,34920,393120,358200,0_0_54_54
6896,18,1331498940,18,23,18,1331499000,60,565680,1779540,1213860,0_0_0_0_0_0_0_0_0_1_1_1_1_0_9_9_9_9_9_9_1_1_3_3_18_18
6897,18,1331499000,18,23,18,1331502600,3600,565740,1779540,1213800,0_0_0_0_0_0_0_0_0_1_1_1_1_0_9_9_9_9_9_9_1_1_3_3_18_18_18
6898,48,1331500320,26,13,26,1331528400,28080,16560,156420,139860,26_26
6899,167,1331501340,19,11,19,1331528400,27060,11040,534900,523860,19_19_19
6900,167,1331501340,19,11,19,1331501340,0,11040,534900,523860,19_19
6901,204,1331502000,16,20,2,1331503200,1200,968940,2567700,1598760,16_16_16_16_16_16_16_16_16_16_16_16_16_16_16_16_16_16_16_16_16_16_1_1_1_1_1_16_1_2_2_16_16_16_16_16_16_16_16_16_16_1_16_1_16_16_16_16_16_16_1_1_16_16_16_16_16_16
6902,4,1331502000,14,17,4,1331528580,26580,1148400,1326000,177600,10_10_10_10_10_10_10_1_1_10_10_10_10_10_10_10_10_10_10_1_10_1_10_1_1_10_10_10_10_10_1_1_1_1_2_2_3_3_3_3_14_14_14_14
6903,18,1331502600,18,23,18,1331502660,60,569340,1779540,1210200,0_0_0_0_0_0_0_0_0_1_1_1_1_0_9_9_9_9_9_9_1_1_3_3_18_18_18_18
6904,18,1331502660,18,22,18,1331528400,25740,569400,1779540,1210140,0_0_0_0_0_0_0_0_0_1_1_1_1_0_9_9_9_9_9_9_1_1_3_3_18_18_18_18_18
6905,188,1331503200,3,4,3,1331507700,4500,2831160,4327560,1496400,0_0_0_0_0_1_1_0_0_0_0_0_0_0_0_0_1_1_2_2_2_2_3_3_3_3_21_21_3_3_3_3_3
6906,222,1331503200,3,4,3,1331507700,4500,217800,1113000,895200,1_1_2_2_2_2_3_3
6907,222,1331503200,3,4,3,1331503200,0,217800,1113000,895200,1_1_2_2_2_2_3
6908,204,1331503200,2,4,16,1331503320,120,970140,2567700,1597560,16_16_16_16_16_16_16_16_16_16_16_16_16_16_16_16_16_16_16_16_16_16_1_1_1_1_1_16_1_2_2_16_16_16_16_16_16_16_16_16_16_1_16_1_16_16_16_16_16_16_1_1_16_16_16_16_16_16_2
6909,151,1331503200,6,7,6,1331503200,0,3381000,3643800,262800,19_19_19_19_19_1_1_19_1_1_19_19_19_19_1_19_1_19_19_19_19_19_19_19_19_19_1_19_19_1_1_1_1_1_19_19_19_19_19_19_1_1_19_19_1_1_19_1_1_19_19_19_19_19_19_19_19_19_19_19_19_19_19_19_1_1_47_47_3_3_3_3_2_3_3_2_3_3_3_3_3_3_4_4_4_4_4_4_4_4_4_4_4_4_4_4_4_4_4_5_4_4_5_4_4_4_4_6
6910,151,1331503200,6,7,6,1331506800,3600,3381000,3643800,262800,19_19_19_19_19_1_1_19_1_1_19_19_19_19_1_19_1_19_19_19_19_19_19_19_19_19_1_19_19_1_1_1_1_1_19_19_19_19_19_19_1_1_19_19_1_1_19_1_1_19_19_19_19_19_19_19_19_19_19_19_19_19_19_19_1_1_47_47_3_3_3_3_2_3_3_2_3_3_3_3_3_3_4_4_4_4_4_4_4_4_4_4_4_4_4_4_4_4_4_5_4_4_5_4_4_4_4_6_6
6911,89,1331503200,6,7,6,1331506800,3600,1702080,1736340,34260,19_19_19_19_19_1_19_1_19_19_19_19_1_1_1_1_2_2_3_3_3_3_5_5_6
6912,204,1331503320,16,11,2,1331507700,4380,970260,2567700,1597440,16_16_16_16_16_16_16_16_16_16_16_16_16_16_16_16_16_16_16_16_16_16_1_1_1_1_1_16_1_2_2_16_16_16_16_16_16_16_16_16_16_1_16_1_16_16_16_16_16_16_1_1_16_16_16_16_16_16_2_16
6913,151,1331506800,6,7,4,1331510880,4080,3384600,3643800,259200,19_19_19_19_19_1_1_19_1_1_19_19_19_19_1_19_1_19_19_19_19_19_19_19_19_19_1_19_19_1_1_1_1_1_19_19_19_19_19_19_1_1_19_19_1_1_19_1_1_19_19_19_19_19_19_19_19_19_19_19_19_19_19_19_1_1_47_47_3_3_3_3_2_3_3_2_3_3_3_3_3_3_4_4_4_4_4_4_4_4_4_4_4_4_4_4_4_4_4_5_4_4_5_4_4_4_4_6_6_6_6
6914,151,1331506800,6,7,6,1331506800,0,3384600,3643800,259200,19_19_19_19_19_1_1_19_1_1_19_19_19_19_1_19_1_19_19_19_19_19_19_19_19_19_1_19_19_1_1_1_1_1_19_19_19_19_19_19_1_1_19_19_1_1_19_1_1_19_19_19_19_19_19_19_19_19_19_19_19_19_19_19_1_1_47_47_3_3_3_3_2_3_3_2_3_3_3_3_3_3_4_4_4_4_4_4_4_4_4_4_4_4_4_4_4_4_4_5_4_4_5_4_4_4_4_6_6_6
6915,89,1331506800,6,7,5,1331532960,26160,1705680,1736340,30660,19_19_19_19_19_1_19_1_19_19_19_19_1_1_1_1_2_2_3_3_3_3_5_5_6_6
6916,222,1331507700,3,4,3,1331507700,0,222300,1113000,890700,1_1_2_2_2_2_3_3_3
6917,222,1331507700,3,4,9,1331543880,36180,222300,1113000,890700,1_1_2_2_2_2_3_3_3_3
6918,188,1331507700,3,4,3,1331537100,29400,2835660,4327560,1491900,0_0_0_0_0_1_1_0_0_0_0_0_0_0_0_0_1_1_2_2_2_2_3_3_3_3_21_21_3_3_3_3_3_3
6919,204,1331507700,2,4,16,1331528400,20700,974640,2567700,1593060,16_16_16_16_16_16_16_16_16_16_16_16_16_16_16_16_16_16_16_16_16_16_1_1_1_1_1_16_1_2_2_16_16_16_16_16_16_16_16_16_16_1_16_1_16_16_16_16_16_16_1_1_16_16_16_16_16_16_2_16_2
6920,151,1331510880,4,22,5,1331548020,37140,3388680,3643800,255120,19_19_19_19_19_1_1_19_1_1_19_19_19_19_1_19_1_19_19_19_19_19_19_19_19_19_1_19_19_1_1_1_1_1_19_19_19_19_19_19_1_1_19_19_1_1_19_1_1_19_19_19_19_19_19_19_19_19_19_19_19_19_19_19_1_1_47_47_3_3_3_3_2_3_3_2_3_3_3_3_3_3_4_4_4_4_4_4_4_4_4_4_4_4_4_4_4_4_4_5_4_4_5_4_4_4_4_6_6_6_6_4
6921,204,1331528400,16,11,1,1331531520,3120,995340,2567700,1572360,16_16_16_16_16_16_16_16_16_16_16_16_16_16_16_16_16_16_16_16_16_16_1_1_1_1_1_16_1_2_2_16_16_16_16_16_16_16_16_16_16_1_16_1_16_16_16_16_16_16_1_1_16_16_16_16_16_16_2_16_2_16
6922,18,1331528400,18,22,15,1331528400,0,595140,1779540,1184400,0_0_0_0_0_0_0_0_0_1_1_1_1_0_9_9_9_9_9_9_1_1_3_3_18_18_18_18_18_18
6923,18,1331528400,18,19,15,1331531460,3060,595140,1779540,1184400,0_0_0_0_0_0_0_0_0_1_1_1_1_0_9_9_9_9_9_9_1_1_3_3_18_18_18_18_18_18_15_18
6924,18,1331528400,15,18,18,1331528400,0,595140,1779540,1184400,0_0_0_0_0_0_0_0_0_1_1_1_1_0_9_9_9_9_9_9_1_1_3_3_18_18_18_18_18_18_15
6925,48,1331528400,26,16,26,1331542800,14400,44640,156420,111780,26_26_26
6926,167,1331528400,19,11,1,1331529240,840,38100,534900,496800,19_19_19_19
6927,4,1331528580,4,5,15,1331531400,2820,1174980,1326000,151020,10_10_10_10_10_10_10_1_1_10_10_10_10_10_10_10_10_10_10_1_10_1_10_1_1_10_10_10_10_10_1_1_1_1_2_2_3_3_3_3_14_14_14_14_4
6928,167,1331529240,1,9,1,1331531820,2580,38940,534900,495960,19_19_19_19_1
6929,61,1331529660,34,15,34,1331535840,6180,6074460,6225300,150840,4_4_18_18_34_34_34_3_3_34_3_3_34_35_34_35_35_35_36_36_35_35_35_35_34_34_34_34_34_34_34_34_34_34_34_34_34_34_34_34_34_34_34_34_34_34_34_34_34_34_34_34_34_34_34
6930,31,1331530500,1,9,1,1331530920,420,684480,1374660,690180,19_19_19_19_19_19_19_19_1_1_19_19_19_19_19_3_19_19_3_19_1_19_1_19_19_1_3_1_3_19_19_2_6_6_2_19_19_1_1_5_5_19_5_1_1_5_3_3_2_2_1
6931,31,1331530920,1,9,1,1331532540,1620,684900,1374660,689760,19_19_19_19_19_19_19_19_1_1_19_19_19_19_19_3_19_19_3_19_1_19_1_19_19_1_3_1_3_19_19_2_6_6_2_19_19_1_1_5_5_19_5_1_1_5_3_3_2_2_1_1
6932,4,1331531400,15,18,4,1331532120,720,1177800,1326000,148200,10_10_10_10_10_10_10_1_1_10_10_10_10_10_10_10_10_10_10_1_10_1_10_1_1_10_10_10_10_10_1_1_1_1_2_2_3_3_3_3_14_14_14_14_4_15
6933,18,1331531460,15,18,18,1331559900,28440,598200,1779540,1181340,0_0_0_0_0_0_0_0_0_1_1_1_1_0_9_9_9_9_9_9_1_1_3_3_18_18_18_18_18_18_15_18_15
6934,204,1331531520,1,6,1,1331531640,120,998460,2567700,1569240,16_16_16_16_16_16_16_16_16_16_16_16_16_16_16_16_16_16_16_16_16_16_1_1_1_1_1_16_1_2_2_16_16_16_16_16_16_16_16_16_16_1_16_1_16_16_16_16_16_16_1_1_16_16_16_16_16_16_2_16_2_16_1
6935,195,1331531580,0,1,0,1331560920,29340,72300,393120,320820,0_0_54_54_0
6936,204,1331531640,1,6,1,1331536020,4380,998580,2567700,1569120,16_16_16_16_16_16_16_16_16_16_16_16_16_16_16_16_16_16_16_16_16_16_1_1_1_1_1_16_1_2_2_16_16_16_16_16_16_16_16_16_16_1_16_1_16_16_16_16_16_16_1_1_16_16_16_16_16_16_2_16_2_16_1_1
6937,167,1331531820,1,9,19,1331533020,1200,41520,534900,493380,19_19_19_19_1_1
6938,13,1331532000,1,9,1,1331532480,480,965460,2525940,1560480,19_19_19_1_1_19_19_19_19_19_19_19_19_19_19_19_1_1_1_19_1_19_19_19_19_19_19_19_19_19_19_1_19_1_19_19_19_19_19_19_1_1_1_1_19_19_19_19_1
6939,4,1331532120,4,5,4,1331532240,120,1178520,1326000,147480,10_10_10_10_10_10_10_1_1_10_10_10_10_10_10_10_10_10_10_1_10_1_10_1_1_10_10_10_10_10_1_1_1_1_2_2_3_3_3_3_14_14_14_14_4_15_4
6940,4,1331532240,4,5,4,1331532540,300,1178640,1326000,147360,10_10_10_10_10_10_10_1_1_10_10_10_10_10_10_10_10_10_10_1_10_1_10_1_1_10_10_10_10_10_1_1_1_1_2_2_3_3_3_3_14_14_14_14_4_15_4_4
6941,13,1331532480,1,9,1,1331532780,300,965940,2525940,1560000,19_19_19_1_1_19_19_19_19_19_19_19_19_19_19_19_1_1_1_19_1_19_19_19_19_19_19_19_19_19_19_1_19_1_19_19_19_19_19_19_1_1_1_1_19_19_19_19_1_1
6942,4,1331532540,4,5,15,1331532540,0,1178940,1326000,147060,10_10_10_10_10_10_10_1_1_10_10_10_10_10_10_10_10_10_10_1_10_1_10_1_1_10_10_10_10_10_1_1_1_1_2_2_3_3_3_3_14_14_14_14_4_15_4_4_4
6943,31,1331532540,1,9,1,1331532660,120,686520,1374660,688140,19_19_19_19_19_19_19_19_1_1_19_19_19_19_19_3_19_19_3_19_1_19_1_19_19_1_3_1_3_19_19_2_6_6_2_19_19_1_1_5_5_19_5_1_1_5_3_3_2_2_1_1_1
6944,4,1331532540,15,18,4,1331532600,60,1178940,1326000,147060,10_10_10_10_10_10_10_1_1_10_10_10_10_10_10_10_10_10_10_1_10_1_10_1_1_10_10_10_10_10_1_1_1_1_2_2_3_3_3_3_14_14_14_14_4_15_4_4_4_15
6945,4,1331532600,4,5,15,1331539200,6600,1179000,1326000,147000,10_10_10_10_10_10_10_1_1_10_10_10_10_10_10_10_10_10_10_1_10_1_10_1_1_10_10_10_10_10_1_1_1_1_2_2_3_3_3_3_14_14_14_14_4_15_4_4_4_15_4
6946,31,1331532660,1,9,5,1331537580,4920,686640,1374660,688020,19_19_19_19_19_19_19_19_1_1_19_19_19_19_19_3_19_19_3_19_1_19_1_19_19_1_3_1_3_19_19_2_6_6_2_19_19_1_1_5_5_19_5_1_1_5_3_3_2_2_1_1_1_1
6947,13,1331532780,1,9,1,1331537280,4500,966240,2525940,1559700,19_19_19_1_1_19_19_19_19_19_19_19_19_19_19_19_1_1_1_19_1_19_19_19_19_19_19_19_19_19_19_1_19_1_19_19_19_19_19_19_1_1_1_1_19_19_19_19_1_1_1
6948,160,1331532840,16,14,16,1331551320,18480,0,1564260,1564260,16
6949,89,1331532960,5,9,5,1331537460,4500,1731840,1736340,4500,19_19_19_19_19_1_19_1_19_19_19_19_1_1_1_1_2_2_3_3_3_3_5_5_6_6_5
6950,159,1331532960,3,3,3,1331562060,29100,1180140,2480580,1300440,16_16_16_16_16_16_16_16_1_1_1_1_2_2_3
6951,167,1331533020,19,1,19,1331560860,27840,42720,534900,492180,19_19_19_19_1_1_19
6952,5,1331533620,1,9,1,1331533680,60,515820,748200,232380,10_10_10_10_10_10_10_10_10_10_1_10_10_1_1_1_10_10_10_10_10_10_10_10_1
6953,5,1331533680,1,9,2,1331625240,91560,515880,748200,232320,10_10_10_10_10_10_10_10_10_10_1_10_10_1_1_1_10_10_10_10_10_10_10_10_1_1
6954,61,1331535840,34,15,34,1331548740,12900,6080640,6225300,144660,4_4_18_18_34_34_34_3_3_34_3_3_34_35_34_35_35_35_36_36_35_35_35_35_34_34_34_34_34_34_34_34_34_34_34_34_34_34_34_34_34_34_34_34_34_34_34_34_34_34_34_34_34_34_34_34
6955,204,1331536020,1,6,1,1331536140,120,1002960,2567700,1564740,16_16_16_16_16_16_16_16_16_16_16_16_16_16_16_16_16_16_16_16_16_16_1_1_1_1_1_16_1_2_2_16_16_16_16_16_16_16_16_16_16_1_16_1_16_16_16_16_16_16_1_1_16_16_16_16_16_16_2_16_2_16_1_1_1
6956,204,1331536140,1,6,1,1331541840,5700,1003080,2567700,1564620,16_16_16_16_16_16_16_16_16_16_16_16_16_16_16_16_16_16_16_16_16_16_1_1_1_1_1_16_1_2_2_16_16_16_16_16_16_16_16_16_16_1_16_1_16_16_16_16_16_16_1_1_16_16_16_16_16_16_2_16_2_16_1_1_1_1
6957,188,1331537100,3,4,3,1331542560,5460,2865060,4327560,1462500,0_0_0_0_0_1_1_0_0_0_0_0_0_0_0_0_1_1_2_2_2_2_3_3_3_3_21_21_3_3_3_3_3_3_3
6958,13,1331537280,1,9,1,1331537580,300,970740,2525940,1555200,19_19_19_1_1_19_19_19_19_19_19_19_19_19_19_19_1_1_1_19_1_19_19_19_19_19_19_19_19_19_19_1_19_1_19_19_19_19_19_19_1_1_1_1_19_19_19_19_1_1_1_1_1
6959,13,1331537280,1,9,1,1331537280,0,970740,2525940,1555200,19_19_19_1_1_19_19_19_19_19_19_19_19_19_19_19_1_1_1_19_1_19_19_19_19_19_19_19_19_19_19_1_19_1_19_19_19_19_19_19_1_1_1_1_19_19_19_19_1_1_1_1
6960,89,1331537460,5,9,99,1331537460,0,1736340,1736340,0,19_19_19_19_19_1_19_1_19_19_19_19_1_1_1_1_2_2_3_3_3_3_5_5_6_6_5_5
6961,31,1331537580,5,9,5,1331542800,5220,691560,1374660,683100,19_19_19_19_19_19_19_19_1_1_19_19_19_19_19_3_19_19_3_19_1_19_1_19_19_1_3_1_3_19_19_2_6_6_2_19_19_1_1_5_5_19_5_1_1_5_3_3_2_2_1_1_1_1_5
6962,13,1331537580,1,9,19,1331845800,308220,971040,2525940,1554900,19_19_19_1_1_19_19_19_19_19_19_19_19_19_19_19_1_1_1_19_1_19_19_19_19_19_19_19_19_19_19_1_19_1_19_19_19_19_19_19_1_1_1_1_19_19_19_19_1_1_1_1_1_1
6963,4,1331539200,15,18,15,1331542620,3420,1185600,1326000,140400,10_10_10_10_10_10_10_1_1_10_10_10_10_10_10_10_10_10_10_1_10_1_10_1_1_10_10_10_10_10_1_1_1_1_2_2_3_3_3_3_14_14_14_14_4_15_4_4_4_15_4_15
6964,204,1331541840,1,6,2,1331551860,10020,1008780,2567700,1558920,16_16_16_16_16_16_16_16_16_16_16_16_16_16_16_16_16_16_16_16_16_16_1_1_1_1_1_16_1_2_2_16_16_16_16_16_16_16_16_16_16_1_16_1_16_16_16_16_16_16_1_1_16_16_16_16_16_16_2_16_2_16_1_1_1_1_1
6965,188,1331542560,3,4,18,1331575560,33000,2870520,4327560,1457040,0_0_0_0_0_1_1_0_0_0_0_0_0_0_0_0_1_1_2_2_2_2_3_3_3_3_21_21_3_3_3_3_3_3_3_3
6966,4,1331542620,15,18,4,1331542680,60,1189020,1326000,136980,10_10_10_10_10_10_10_1_1_10_10_10_10_10_10_10_10_10_10_1_10_1_10_1_1_10_10_10_10_10_1_1_1_1_2_2_3_3_3_3_14_14_14_14_4_15_4_4_4_15_4_15_15
6967,157,1331542680,18,5,18,1331551920,9240,1654500,1993260,338760,19_19_1_19_1_19_19_19_19_19_19_19_1_1_1_1_9_9_1_1_2_2_3_3_18
6968,4,1331542680,4,5,5,1331553600,10920,1189080,1326000,136920,10_10_10_10_10_10_10_1_1_10_10_10_10_10_10_10_10_10_10_1_10_1_10_1_1_10_10_10_10_10_1_1_1_1_2_2_3_3_3_3_14_14_14_14_4_15_4_4_4_15_4_15_15_4
6969,31,1331542800,5,9,5,1331544840,2040,696780,1374660,677880,19_19_19_19_19_19_19_19_1_1_19_19_19_19_19_3_19_19_3_19_1_19_1_19_19_1_3_1_3_19_19_2_6_6_2_19_19_1_1_5_5_19_5_1_1_5_3_3_2_2_1_1_1_1_5_5
6970,48,1331542800,26,16,26,1331560440,17640,59040,156420,97380,26_26_26_26_26
6971,48,1331542800,26,16,26,1331542800,0,59040,156420,97380,26_26_26_26
6972,222,1331543880,9,3,9,1331543940,60,258480,1113000,854520,1_1_2_2_2_2_3_3_3_3_9
6973,222,1331543940,3,3,3,1331554200,10260,258540,1113000,854460,1_1_2_2_2_2_3_3_3_3_9_9_3
6974,222,1331543940,9,3,3,1331543940,0,258540,1113000,854460,1_1_2_2_2_2_3_3_3_3_9_9
6975,169,1331544000,5,18,5,1331553600,9600,1882260,2190660,308400,50_50_50_50_50_50_50_50_50_50_50_50_50_50_50_50_50_1_1_50_50_50_50_1_1_50_50_50_50_50_50_50_50_1_1_50_3_3_50_2_50_2_50_50_50_6_6_3_3_50_5_2_2_2_2_5_50_50_1_1_2_2_3_3_3_3_3_3_3_3_5_3_5_3_5
6976,31,1331544840,5,9,5,1331547420,2580,698820,1374660,675840,19_19_19_19_19_19_19_19_1_1_19_19_19_19_19_3_19_19_3_19_1_19_1_19_19_1_3_1_3_19_19_2_6_6_2_19_19_1_1_5_5_19_5_1_1_5_3_3_2_2_1_1_1_1_5_5_5
6977,146,1331546340,5,6,6,1331546400,60,6019140,6670800,651660,16_16_16_16_16_16_16_1_16_1_16_1_1_16_1_16_16_2_1_1_16_1_2_16_2_2_3_3_3_3_21_21_3_3_3_3_3_21_3_21_3_3_3_3_21_3_21_3_18_18_18_18_18_18_3_3_3_3_4_4_4_4_4_4_4_4_4_4_4_4_4_4_4_4_4_4_18_18_4_4_4_4_4_3_3_4_4_4_5_5_6_6_5_5_6_6_5_5_34_34_34_34_34_34_5_5_5_5_6_6_5
6978,146,1331546400,6,6,6,1331550000,3600,6019200,6670800,651600,16_16_16_16_16_16_16_1_16_1_16_1_1_16_1_16_16_2_1_1_16_1_2_16_2_2_3_3_3_3_21_21_3_3_3_3_3_21_3_21_3_3_3_3_21_3_21_3_18_18_18_18_18_18_3_3_3_3_4_4_4_4_4_4_4_4_4_4_4_4_4_4_4_4_4_4_18_18_4_4_4_4_4_3_3_4_4_4_5_5_6_6_5_5_6_6_5_5_34_34_34_34_34_34_5_5_5_5_6_6_5_6
6979,220,1331546400,2,15,2,1331548740,2340,1202040,2714040,1512000,0_0_0_0_1_0_1_0_0_0_0_0_1_0_0_1_0_0_0_0_0_0_0_0_0_0_0_0_0_0_0_1_1_0_1_1_1_1_0_0_1_1_2
6980,31,1331547420,5,9,3,1331547540,120,701400,1374660,673260,19_19_19_19_19_19_19_19_1_1_19_19_19_19_19_3_19_19_3_19_1_19_1_19_19_1_3_1_3_19_19_2_6_6_2_19_19_1_1_5_5_19_5_1_1_5_3_3_2_2_1_1_1_1_5_5_5_5
6981,31,1331547540,3,3,3,1331547600,60,701520,1374660,673140,19_19_19_19_19_19_19_19_1_1_19_19_19_19_19_3_19_19_3_19_1_19_1_19_19_1_3_1_3_19_19_2_6_6_2_19_19_1_1_5_5_19_5_1_1_5_3_3_2_2_1_1_1_1_5_5_5_5_3
6982,31,1331547600,2,3,5,1331547660,60,701580,1374660,673080,19_19_19_19_19_19_19_19_1_1_19_19_19_19_19_3_19_19_3_19_1_19_1_19_19_1_3_1_3_19_19_2_6_6_2_19_19_1_1_5_5_19_5_1_1_5_3_3_2_2_1_1_1_1_5_5_5_5_3_3_2
6983,31,1331547600,3,3,2,1331547600,0,701580,1374660,673080,19_19_19_19_19_19_19_19_1_1_19_19_19_19_19_3_19_19_3_19_1_19_1_19_19_1_3_1_3_19_19_2_6_6_2_19_19_1_1_5_5_19_5_1_1_5_3_3_2_2_1_1_1_1_5_5_5_5_3_3
6984,31,1331547660,5,9,2,1331547660,0,701640,1374660,673020,19_19_19_19_19_19_19_19_1_1_19_19_19_19_19_3_19_19_3_19_1_19_1_19_19_1_3_1_3_19_19_2_6_6_2_19_19_1_1_5_5_19_5_1_1_5_3_3_2_2_1_1_1_1_5_5_5_5_3_3_2_5
6985,31,1331547660,2,3,5,1331549340,1680,701640,1374660,673020,19_19_19_19_19_19_19_19_1_1_19_19_19_19_19_3_19_19_3_19_1_19_1_19_19_1_3_1_3_19_19_2_6_6_2_19_19_1_1_5_5_19_5_1_1_5_3_3_2_2_1_1_1_1_5_5_5_5_3_3_2_5_2
6986,151,1331548020,5,9,5,1331560320,12300,3425820,3643800,217980,19_19_19_19_19_1_1_19_1_1_19_19_19_19_1_19_1_19_19_19_19_19_19_19_19_19_1_19_19_1_1_1_1_1_19_19_19_19_19_19_1_1_19_19_1_1_19_1_1_19_19_19_19_19_19_19_19_19_19_19_19_19_19_19_1_1_47_47_3_3_3_3_2_3_3_2_3_3_3_3_3_3_4_4_4_4_4_4_4_4_4_4_4_4_4_4_4_4_4_5_4_4_5_4_4_4_4_6_6_6_6_4_5
6987,220,1331548740,2,15,2,1331565540,16800,1204380,2714040,1509660,0_0_0_0_1_0_1_0_0_0_0_0_1_0_0_1_0_0_0_0_0_0_0_0_0_0_0_0_0_0_0_1_1_0_1_1_1_1_0_0_1_1_2_2
6988,61,1331548740,34,15,34,1331560380,11640,6093540,6225300,131760,4_4_18_18_34_34_34_3_3_34_3_3_34_35_34_35_35_35_36_36_35_35_35_35_34_34_34_34_34_34_34_34_34_34_34_34_34_34_34_34_34_34_34_34_34_34_34_34_34_34_34_34_34_34_34_34_34
6989,31,1331549340,5,9,6,1331589600,40260,703320,1374660,671340,19_19_19_19_19_19_19_19_1_1_19_19_19_19_19_3_19_19_3_19_1_19_1_19_19_1_3_1_3_19_19_2_6_6_2_19_19_1_1_5_5_19_5_1_1_5_3_3_2_2_1_1_1_1_5_5_5_5_3_3_2_5_2_5
6990,146,1331550000,6,6,5,1331550840,840,6022800,6670800,648000,16_16_16_16_16_16_16_1_16_1_16_1_1_16_1_16_16_2_1_1_16_1_2_16_2_2_3_3_3_3_21_21_3_3_3_3_3_21_3_21_3_3_3_3_21_3_21_3_18_18_18_18_18_18_3_3_3_3_4_4_4_4_4_4_4_4_4_4_4_4_4_4_4_4_4_4_18_18_4_4_4_4_4_3_3_4_4_4_5_5_6_6_5_5_6_6_5_5_34_34_34_34_34_34_5_5_5_5_6_6_5_6_6
6991,146,1331550840,5,6,6,1331589600,38760,6023640,6670800,647160,16_16_16_16_16_16_16_1_16_1_16_1_1_16_1_16_16_2_1_1_16_1_2_16_2_2_3_3_3_3_21_21_3_3_3_3_3_21_3_21_3_3_3_3_21_3_21_3_18_18_18_18_18_18_3_3_3_3_4_4_4_4_4_4_4_4_4_4_4_4_4_4_4_4_4_4_18_18_4_4_4_4_4_3_3_4_4_4_5_5_6_6_5_5_6_6_5_5_34_34_34_34_34_34_5_5_5_5_6_6_5_6_6_5
6992,160,1331551320,16,14,16,1331574360,23040,18480,1564260,1545780,16_16
6993,204,1331551860,2,4,2,1331557620,5760,1018800,2567700,1548900,16_16_16_16_16_16_16_16_16_16_16_16_16_16_16_16_16_16_16_16_16_16_1_1_1_1_1_16_1_2_2_16_16_16_16_16_16_16_16_16_16_1_16_1_16_16_16_16_16_16_1_1_16_16_16_16_16_16_2_16_2_16_1_1_1_1_1_2
6994,157,1331551920,18,5,18,1331551980,60,1663740,1993260,329520,19_19_1_19_1_19_19_19_19_19_19_19_1_1_1_1_9_9_1_1_2_2_3_3_18_18
6995,157,1331551980,18,5,18,1331566680,14700,1663800,1993260,329460,19_19_1_19_1_19_19_19_19_19_19_19_1_1_1_1_9_9_1_1_2_2_3_3_18_18_18
6996,4,1331553600,5,18,5,1331564400,10800,1200000,1326000,126000,10_10_10_10_10_10_10_1_1_10_10_10_10_10_10_10_10_10_10_1_10_1_10_1_1_10_10_10_10_10_1_1_1_1_2_2_3_3_3_3_14_14_14_14_4_15_4_4_4_15_4_15_15_4_5
6997,169,1331553600,5,18,6,1331762400,208800,1891860,2190660,298800,50_50_50_50_50_50_50_50_50_50_50_50_50_50_50_50_50_1_1_50_50_50_50_1_1_50_50_50_50_50_50_50_50_1_1_50_3_3_50_2_50_2_50_50_50_6_6_3_3_50_5_2_2_2_2_5_50_50_1_1_2_2_3_3_3_3_3_3_3_3_5_3_5_3_5_5
6998,222,1331554200,3,3,5,1332071640,517440,268800,1113000,844200,1_1_2_2_2_2_3_3_3_3_9_9_3_3
6999,204,1331557620,2,4,2,1331558340,720,1024560,2567700,1543140,16_16_16_16_16_16_16_16_16_16_16_16_16_16_16_16_16_16_16_16_16_16_1_1_1_1_1_16_1_2_2_16_16_16_16_16_16_16_16_16_16_1_16_1_16_16_16_16_16_16_1_1_16_16_16_16_16_16_2_16_2_16_1_1_1_1_1_2_2
7000,204,1331558340,2,4,2,1331559240,900,1025280,2567700,1542420,16_16_16_16_16_16_16_16_16_16_16_16_16_16_16_16_16_16_16_16_16_16_1_1_1_1_1_16_1_2_2_16_16_16_16_16_16_16_16_16_16_1_16_1_16_16_16_16_16_16_1_1_16_16_16_16_16_16_2_16_2_16_1_1_1_1_1_2_2_2
7001,204,1331559240,2,4,1,1331559960,720,1026180,2567700,1541520,16_16_16_16_16_16_16_16_16_16_16_16_16_16_16_16_16_16_16_16_16_16_1_1_1_1_1_16_1_2_2_16_16_16_16_16_16_16_16_16_16_1_16_1_16_16_16_16_16_16_1_1_16_16_16_16_16_16_2_16_2_16_1_1_1_1_1_2_2_2_2
7002,18,1331559900,18,19,18,1331561220,1320,626640,1779540,1152900,0_0_0_0_0_0_0_0_0_1_1_1_1_0_9_9_9_9_9_9_1_1_3_3_18_18_18_18_18_18_15_18_15_18
7003,204,1331559960,1,6,1,1331560020,60,1026900,2567700,1540800,16_16_16_16_16_16_16_16_16_16_16_16_16_16_16_16_16_16_16_16_16_16_1_1_1_1_1_16_1_2_2_16_16_16_16_16_16_16_16_16_16_1_16_1_16_16_16_16_16_16_1_1_16_16_16_16_16_16_2_16_2_16_1_1_1_1_1_2_2_2_2_1
7004,204,1331560020,1,6,1,1331560380,360,1026960,2567700,1540740,16_16_16_16_16_16_16_16_16_16_16_16_16_16_16_16_16_16_16_16_16_16_1_1_1_1_1_16_1_2_2_16_16_16_16_16_16_16_16_16_16_1_16_1_16_16_16_16_16_16_1_1_16_16_16_16_16_16_2_16_2_16_1_1_1_1_1_2_2_2_2_1_1
7005,151,1331560320,5,9,6,1331589600,29280,3438120,3643800,205680,19_19_19_19_19_1_1_19_1_1_19_19_19_19_1_19_1_19_19_19_19_19_19_19_19_19_1_19_19_1_1_1_1_1_19_19_19_19_19_19_1_1_19_19_1_1_19_1_1_19_19_19_19_19_19_19_19_19_19_19_19_19_19_19_1_1_47_47_3_3_3_3_2_3_3_2_3_3_3_3_3_3_4_4_4_4_4_4_4_4_4_4_4_4_4_4_4_4_4_5_4_4_5_4_4_4_4_6_6_6_6_4_5_5
7006,204,1331560380,1,6,1,1331716260,155880,1027320,2567700,1540380,16_16_16_16_16_16_16_16_16_16_16_16_16_16_16_16_16_16_16_16_16_16_1_1_1_1_1_16_1_2_2_16_16_16_16_16_16_16_16_16_16_1_16_1_16_16_16_16_16_16_1_1_16_16_16_16_16_16_2_16_2_16_1_1_1_1_1_2_2_2_2_1_1_1
7007,61,1331560380,34,15,1,1331563020,2640,6105180,6225300,120120,4_4_18_18_34_34_34_3_3_34_3_3_34_35_34_35_35_35_36_36_35_35_35_35_34_34_34_34_34_34_34_34_34_34_34_34_34_34_34_34_34_34_34_34_34_34_34_34_34_34_34_34_34_34_34_34_34_34
7008,48,1331560440,26,16,26,1331573100,12660,76680,156420,79740,26_26_26_26_26_26
7009,167,1331560860,19,1,19,1331568240,7380,70560,534900,464340,19_19_19_19_1_1_19_19
7010,195,1331560920,0,1,0,1331565420,4500,101640,393120,291480,0_0_54_54_0_0
7011,18,1331561220,18,23,18,1331564700,3480,627960,1779540,1151580,0_0_0_0_0_0_0_0_0_1_1_1_1_0_9_9_9_9_9_9_1_1_3_3_18_18_18_18_18_18_15_18_15_18_18
7012,159,1331562060,3,3,3,1332338700,776640,1209240,2480580,1271340,16_16_16_16_16_16_16_16_1_1_1_1_2_2_3_3
7013,213,1331562120,3,3,3,1331565480,3360,2525700,3206820,681120,0_0_0_0_0_1_0_1_0_0_0_0_0_0_0_0_1_1_0_0_0_0_0_0_0_1_1_0_0_0_0_0_0_0_0_0_0_0_0_0_0_1_1_1_0_1_0_0_0_0_0_0_0_0_0_0_1_0_1_0_0_0_0_0_0_0_0_0_0_0_0_0_0_0_0_0_0_0_0_1_1_0_0_0_0_0_0_0_0_0_0_0_0_0_1_1_0_0_2_2_3_3_4_3_3_4_2_2_4_4_4_4_4_4_4_4_5_2_3_4_5_2_3_4_6_6_5_5_0_1_0_1_2_2_2_2_3
7014,61,1331563020,1,6,1,1331563500,480,6107820,6225300,117480,4_4_18_18_34_34_34_3_3_34_3_3_34_35_34_35_35_35_36_36_35_35_35_35_34_34_34_34_34_34_34_34_34_34_34_34_34_34_34_34_34_34_34_34_34_34_34_34_34_34_34_34_34_34_34_34_34_34_1
7015,61,1331563500,1,6,3,1331676000,112500,6108300,6225300,117000,4_4_18_18_34_34_34_3_3_34_3_3_34_35_34_35_35_35_36_36_35_35_35_35_34_34_34_34_34_34_34_34_34_34_34_34_34_34_34_34_34_34_34_34_34_34_34_34_34_34_34_34_34_34_34_34_34_34_1_1
7016,205,1331564400,1,18,1,1331568060,3660,0,460800,460800,1
7017,4,1331564400,5,18,5,1331618400,54000,1210800,1326000,115200,10_10_10_10_10_10_10_1_1_10_10_10_10_10_10_10_10_10_10_1_10_1_10_1_1_10_10_10_10_10_1_1_1_1_2_2_3_3_3_3_14_14_14_14_4_15_4_4_4_15_4_15_15_4_5_5
7018,18,1331564700,18,23,18,1331564760,60,631440,1779540,1148100,0_0_0_0_0_0_0_0_0_1_1_1_1_0_9_9_9_9_9_9_1_1_3_3_18_18_18_18_18_18_15_18_15_18_18_18
7019,18,1331564760,18,23,18,1331568960,4200,631500,1779540,1148040,0_0_0_0_0_0_0_0_0_1_1_1_1_0_9_9_9_9_9_9_1_1_3_3_18_18_18_18_18_18_15_18_15_18_18_18_18
7020,195,1331565420,0,20,0,1331574240,8820,106140,393120,286980,0_0_54_54_0_0_0
7021,213,1331565480,3,3,4,1331572440,6960,2529060,3206820,677760,0_0_0_0_0_1_0_1_0_0_0_0_0_0_0_0_1_1_0_0_0_0_0_0_0_1_1_0_0_0_0_0_0_0_0_0_0_0_0_0_0_1_1_1_0_1_0_0_0_0_0_0_0_0_0_0_1_0_1_0_0_0_0_0_0_0_0_0_0_0_0_0_0_0_0_0_0_0_0_1_1_0_0_0_0_0_0_0_0_0_0_0_0_0_1_1_0_0_2_2_3_3_4_3_3_4_2_2_4_4_4_4_4_4_4_4_5_2_3_4_5_2_3_4_6_6_5_5_0_1_0_1_2_2_2_2_3_3
7022,220,1331565540,2,4,2,1331566740,1200,1221180,2714040,1492860,0_0_0_0_1_0_1_0_0_0_0_0_1_0_0_1_0_0_0_0_0_0_0_0_0_0_0_0_0_0_0_1_1_0_1_1_1_1_0_0_1_1_2_2_2
7023,63,1331566200,34,17,34,1331571480,5280,4714740,6232860,1518120,16_16_16_16_16_16_16_16_16_0_0_16_16_0_16_16_0_16_16_0_0_16_16_16_0_0_16_0_0_16_0_16_0_0_0_16_1_1_1_16_16_16_0_1_1_1_16_0_0_16_16_0_16_0_16_0_0_2_2_1_1_0_0_0_0_2_2_2_2_2_2_0_1_0_1_1_0_0_0_1_1_0_0_1_1_1_0_0_0_0_0_2_2_2_2_0_0_0_0_0_0_1_1_1_1_0_0_16_0_16_16_16_16_16_0_0_1_1_2_2_1_1_16_0_2_16_2_2_2_0_1_1_1_1_1_16_16_1_1_1_3_3_18_3_18_3_3_3_3_3_18_18_18_18_3_3_3_3_18_18_18_18_18_18_18_5_5_5_18_5_18_18_18_18_18_5_5_5_18_18_18_5_6_6_5_5_5_5_3_5_18_3_3_3_18_16_18_16_5_18_18_6_3_6_18_3_18_18_5_5_18_5_5_5_5_5_5_5_5_5_18_3_5_3_18_3_3_3_3_18_18_18_18_3_5_5_18_3_18_6_3_6_3_18_3_3_18_18_5_5_3_18_3_5_34_34_3_3_18_5_18_3_2_3_2_18_5_34_18_3_5_5_3_5_3_3_5_18_3_34_3_5_18_18_18_18_18_18_18_18_18_18_18_18_18_18_18_18_18_18_34
7024,157,1331566680,18,5,18,1331569020,2340,1678500,1993260,314760,19_19_1_19_1_19_19_19_19_19_19_19_1_1_1_1_9_9_1_1_2_2_3_3_18_18_18_18
7025,220,1331566740,2,4,2,1331601600,34860,1222380,2714040,1491660,0_0_0_0_1_0_1_0_0_0_0_0_1_0_0_1_0_0_0_0_0_0_0_0_0_0_0_0_0_0_0_1_1_0_1_1_1_1_0_0_1_1_2_2_2_2
7026,205,1331568060,1,18,2,1331628420,60360,3660,460800,457140,1_1
7027,167,1331568240,19,13,19,1331572980,4740,77940,534900,456960,19_19_19_19_1_1_19_19_19
7028,18,1331568960,18,23,15,1332320220,751260,635700,1779540,1143840,0_0_0_0_0_0_0_0_0_1_1_1_1_0_9_9_9_9_9_9_1_1_3_3_18_18_18_18_18_18_15_18_15_18_18_18_18_18
7029,157,1331569020,18,23,18,1331572380,3360,1680840,1993260,312420,19_19_1_19_1_19_19_19_19_19_19_19_1_1_1_1_9_9_1_1_2_2_3_3_18_18_18_18_18
7030,63,1331571480,34,17,5,1332069600,498120,4720020,6232860,1512840,16_16_16_16_16_16_16_16_16_0_0_16_16_0_16_16_0_16_16_0_0_16_16_16_0_0_16_0_0_16_0_16_0_0_0_16_1_1_1_16_16_16_0_1_1_1_16_0_0_16_16_0_16_0_16_0_0_2_2_1_1_0_0_0_0_2_2_2_2_2_2_0_1_0_1_1_0_0_0_1_1_0_0_1_1_1_0_0_0_0_0_2_2_2_2_0_0_0_0_0_0_1_1_1_1_0_0_16_0_16_16_16_16_16_0_0_1_1_2_2_1_1_16_0_2_16_2_2_2_0_1_1_1_1_1_16_16_1_1_1_3_3_18_3_18_3_3_3_3_3_18_18_18_18_3_3_3_3_18_18_18_18_18_18_18_5_5_5_18_5_18_18_18_18_18_5_5_5_18_18_18_5_6_6_5_5_5_5_3_5_18_3_3_3_18_16_18_16_5_18_18_6_3_6_18_3_18_18_5_5_18_5_5_5_5_5_5_5_5_5_18_3_5_3_18_3_3_3_3_18_18_18_18_3_5_5_18_3_18_6_3_6_3_18_3_3_18_18_5_5_3_18_3_5_34_34_3_3_18_5_18_3_2_3_2_18_5_34_18_3_5_5_3_5_3_3_5_18_3_34_3_5_18_18_18_18_18_18_18_18_18_18_18_18_18_18_18_18_18_18_34_34
7031,157,1331572380,18,23,6,1331848800,276420,1684200,1993260,309060,19_19_1_19_1_19_19_19_19_19_19_19_1_1_1_1_9_9_1_1_2_2_3_3_18_18_18_18_18_18
7032,213,1331572440,4,23,4,1331575560,3120,2536020,3206820,670800,0_0_0_0_0_1_0_1_0_0_0_0_0_0_0_0_1_1_0_0_0_0_0_0_0_1_1_0_0_0_0_0_0_0_0_0_0_0_0_0_0_1_1_1_0_1_0_0_0_0_0_0_0_0_0_0_1_0_1_0_0_0_0_0_0_0_0_0_0_0_0_0_0_0_0_0_0_0_0_1_1_0_0_0_0_0_0_0_0_0_0_0_0_0_1_1_0_0_2_2_3_3_4_3_3_4_2_2_4_4_4_4_4_4_4_4_5_2_3_4_5_2_3_4_6_6_5_5_0_1_0_1_2_2_2_2_3_3_4
7033,167,1331572980,19,13,19,1331579700,6720,82680,534900,452220,19_19_19_19_1_1_19_19_19_19
7034,48,1331573100,26,13,6,1331589600,16500,89340,156420,67080,26_26_26_26_26_26_26
7035,195,1331574240,0,20,0,1331574480,240,114960,393120,278160,0_0_54_54_0_0_0_0
7036,160,1331574360,16,20,16,1331588160,13800,41520,1564260,1522740,16_16_16
7037,195,1331574480,0,0,0,1331576640,2160,115200,393120,277920,0_0_54_54_0_0_0_0_0
7038,188,1331575560,18,23,18,1331586540,10980,2903520,4327560,1424040,0_0_0_0_0_1_1_0_0_0_0_0_0_0_0_0_1_1_2_2_2_2_3_3_3_3_21_21_3_3_3_3_3_3_3_3_18
7039,213,1331575560,4,23,4,1331575860,300,2539140,3206820,667680,0_0_0_0_0_1_0_1_0_0_0_0_0_0_0_0_1_1_0_0_0_0_0_0_0_1_1_0_0_0_0_0_0_0_0_0_0_0_0_0_0_1_1_1_0_1_0_0_0_0_0_0_0_0_0_0_1_0_1_0_0_0_0_0_0_0_0_0_0_0_0_0_0_0_0_0_0_0_0_1_1_0_0_0_0_0_0_0_0_0_0_0_0_0_1_1_0_0_2_2_3_3_4_3_3_4_2_2_4_4_4_4_4_4_4_4_5_2_3_4_5_2_3_4_6_6_5_5_0_1_0_1_2_2_2_2_3_3_4_4
7040,213,1331575860,4,22,3,1331589600,13740,2539440,3206820,667380,0_0_0_0_0_1_0_1_0_0_0_0_0_0_0_0_1_1_0_0_0_0_0_0_0_1_1_0_0_0_0_0_0_0_0_0_0_0_0_0_0_1_1_1_0_1_0_0_0_0_0_0_0_0_0_0_1_0_1_0_0_0_0_0_0_0_0_0_0_0_0_0_0_0_0_0_0_0_0_1_1_0_0_0_0_0_0_0_0_0_0_0_0_0_1_1_0_0_2_2_3_3_4_3_3_4_2_2_4_4_4_4_4_4_4_4_5_2_3_4_5_2_3_4_6_6_5_5_0_1_0_1_2_2_2_2_3_3_4_4_4
7041,195,1331576640,0,0,0,1331576700,60,117360,393120,275760,0_0_54_54_0_0_0_0_0_0
7042,195,1331576700,0,0,0,1331579400,2700,117420,393120,275700,0_0_54_54_0_0_0_0_0_0_0
7043,195,1331579400,0,0,1,1331623140,43740,120120,393120,273000,0_0_54_54_0_0_0_0_0_0_0_0
7044,14,1331579400,20,0,20,1331590380,10980,0,1327560,1327560,20
7045,167,1331579700,19,11,1,1331614380,34680,89400,534900,445500,19_19_19_19_1_1_19_19_19_19_19
7046,188,1331586540,18,23,18,1331586600,60,2914500,4327560,1413060,0_0_0_0_0_1_1_0_0_0_0_0_0_0_0_0_1_1_2_2_2_2_3_3_3_3_21_21_3_3_3_3_3_3_3_3_18_18
7047,188,1331586600,18,23,18,1331588940,2340,2914560,4327560,1413000,0_0_0_0_0_1_1_0_0_0_0_0_0_0_0_0_1_1_2_2_2_2_3_3_3_3_21_21_3_3_3_3_3_3_3_3_18_18_18
7048,160,1331588160,16,20,0,1331590500,2340,55320,1564260,1508940,16_16_16_16
7049,188,1331588940,18,23,18,1331589060,120,2916900,4327560,1410660,0_0_0_0_0_1_1_0_0_0_0_0_0_0_0_0_1_1_2_2_2_2_3_3_3_3_21_21_3_3_3_3_3_3_3_3_18_18_18_18
7050,188,1331589060,18,22,18,1331613840,24780,2917020,4327560,1410540,0_0_0_0_0_1_1_0_0_0_0_0_0_0_0_0_1_1_2_2_2_2_3_3_3_3_21_21_3_3_3_3_3_3_3_3_18_18_18_18_18
7051,213,1331589600,3,4,3,1331589600,0,2553180,3206820,653640,0_0_0_0_0_1_0_1_0_0_0_0_0_0_0_0_1_1_0_0_0_0_0_0_0_1_1_0_0_0_0_0_0_0_0_0_0_0_0_0_0_1_1_1_0_1_0_0_0_0_0_0_0_0_0_0_1_0_1_0_0_0_0_0_0_0_0_0_0_0_0_0_0_0_0_0_0_0_0_1_1_0_0_0_0_0_0_0_0_0_0_0_0_0_1_1_0_0_2_2_3_3_4_3_3_4_2_2_4_4_4_4_4_4_4_4_5_2_3_4_5_2_3_4_6_6_5_5_0_1_0_1_2_2_2_2_3_3_4_4_4_3
7052,151,1331589600,6,7,6,1331593200,3600,3467400,3643800,176400,19_19_19_19_19_1_1_19_1_1_19_19_19_19_1_19_1_19_19_19_19_19_19_19_19_19_1_19_19_1_1_1_1_1_19_19_19_19_19_19_1_1_19_19_1_1_19_1_1_19_19_19_19_19_19_19_19_19_19_19_19_19_19_19_1_1_47_47_3_3_3_3_2_3_3_2_3_3_3_3_3_3_4_4_4_4_4_4_4_4_4_4_4_4_4_4_4_4_4_5_4_4_5_4_4_4_4_6_6_6_6_4_5_5_6
7053,31,1331589600,6,7,6,1331593200,3600,743580,1374660,631080,19_19_19_19_19_19_19_19_1_1_19_19_19_19_19_3_19_19_3_19_1_19_1_19_19_1_3_1_3_19_19_2_6_6_2_19_19_1_1_5_5_19_5_1_1_5_3_3_2_2_1_1_1_1_5_5_5_5_3_3_2_5_2_5_6
7054,48,1331589600,6,7,6,1331593200,3600,105840,156420,50580,26_26_26_26_26_26_26_6
7055,209,1331589600,16,20,16,1331594100,4500,0,1091400,1091400,16
7056,146,1331589600,6,7,6,1331593200,3600,6062400,6670800,608400,16_16_16_16_16_16_16_1_16_1_16_1_1_16_1_16_16_2_1_1_16_1_2_16_2_2_3_3_3_3_21_21_3_3_3_3_3_21_3_21_3_3_3_3_21_3_21_3_18_18_18_18_18_18_3_3_3_3_4_4_4_4_4_4_4_4_4_4_4_4_4_4_4_4_4_4_18_18_4_4_4_4_4_3_3_4_4_4_5_5_6_6_5_5_6_6_5_5_34_34_34_34_34_34_5_5_5_5_6_6_5_6_6_5_6
7057,213,1331589600,3,4,3,1331594100,4500,2553180,3206820,653640,0_0_0_0_0_1_0_1_0_0_0_0_0_0_0_0_1_1_0_0_0_0_0_0_0_1_1_0_0_0_0_0_0_0_0_0_0_0_0_0_0_1_1_1_0_1_0_0_0_0_0_0_0_0_0_0_1_0_1_0_0_0_0_0_0_0_0_0_0_0_0_0_0_0_0_0_0_0_0_1_1_0_0_0_0_0_0_0_0_0_0_0_0_0_1_1_0_0_2_2_3_3_4_3_3_4_2_2_4_4_4_4_4_4_4_4_5_2_3_4_5_2_3_4_6_6_5_5_0_1_0_1_2_2_2_2_3_3_4_4_4_3_3
7058,14,1331590380,20,0,20,1331613540,23160,10980,1327560,1316580,20_20_20
7059,14,1331590380,20,0,20,1331590380,0,10980,1327560,1316580,20_20
7060,160,1331590500,0,0,16,1331590560,60,57660,1564260,1506600,16_16_16_16_0
7061,160,1331590560,16,0,0,1331595000,4440,57720,1564260,1506540,16_16_16_16_0_16
7062,48,1331593200,6,7,26,1331597040,3840,109440,156420,46980,26_26_26_26_26_26_26_6_6
7063,31,1331593200,6,7,2,1331642640,49440,747180,1374660,627480,19_19_19_19_19_19_19_19_1_1_19_19_19_19_19_3_19_19_3_19_1_19_1_19_19_1_3_1_3_19_19_2_6_6_2_19_19_1_1_5_5_19_5_1_1_5_3_3_2_2_1_1_1_1_5_5_5_5_3_3_2_5_2_5_6_6
7064,146,1331593200,6,7,6,1332194400,601200,6066000,6670800,604800,16_16_16_16_16_16_16_1_16_1_16_1_1_16_1_16_16_2_1_1_16_1_2_16_2_2_3_3_3_3_21_21_3_3_3_3_3_21_3_21_3_3_3_3_21_3_21_3_18_18_18_18_18_18_3_3_3_3_4_4_4_4_4_4_4_4_4_4_4_4_4_4_4_4_4_4_18_18_4_4_4_4_4_3_3_4_4_4_5_5_6_6_5_5_6_6_5_5_34_34_34_34_34_34_5_5_5_5_6_6_5_6_6_5_6_6
7065,151,1331593200,6,7,5,1331623260,30060,3471000,3643800,172800,19_19_19_19_19_1_1_19_1_1_19_19_19_19_1_19_1_19_19_19_19_19_19_19_19_19_1_19_19_1_1_1_1_1_19_19_19_19_19_19_1_1_19_19_1_1_19_1_1_19_19_19_19_19_19_19_19_19_19_19_19_19_19_19_1_1_47_47_3_3_3_3_2_3_3_2_3_3_3_3_3_3_4_4_4_4_4_4_4_4_4_4_4_4_4_4_4_4_4_5_4_4_5_4_4_4_4_6_6_6_6_4_5_5_6_6
7066,213,1331594100,3,4,4,1331601360,7260,2557680,3206820,649140,0_0_0_0_0_1_0_1_0_0_0_0_0_0_0_0_1_1_0_0_0_0_0_0_0_1_1_0_0_0_0_0_0_0_0_0_0_0_0_0_0_1_1_1_0_1_0_0_0_0_0_0_0_0_0_0_1_0_1_0_0_0_0_0_0_0_0_0_0_0_0_0_0_0_0_0_0_0_0_1_1_0_0_0_0_0_0_0_0_0_0_0_0_0_1_1_0_0_2_2_3_3_4_3_3_4_2_2_4_4_4_4_4_4_4_4_5_2_3_4_5_2_3_4_6_6_5_5_0_1_0_1_2_2_2_2_3_3_4_4_4_3_3_3_3
7067,213,1331594100,3,4,3,1331594100,0,2557680,3206820,649140,0_0_0_0_0_1_0_1_0_0_0_0_0_0_0_0_1_1_0_0_0_0_0_0_0_1_1_0_0_0_0_0_0_0_0_0_0_0_0_0_0_1_1_1_0_1_0_0_0_0_0_0_0_0_0_0_1_0_1_0_0_0_0_0_0_0_0_0_0_0_0_0_0_0_0_0_0_0_0_1_1_0_0_0_0_0_0_0_0_0_0_0_0_0_1_1_0_0_2_2_3_3_4_3_3_4_2_2_4_4_4_4_4_4_4_4_5_2_3_4_5_2_3_4_6_6_5_5_0_1_0_1_2_2_2_2_3_3_4_4_4_3_3_3
7068,209,1331594100,16,20,16,1332234480,640380,4500,1091400,1086900,16_16
7069,160,1331595000,0,0,16,1331595480,480,62160,1564260,1502100,16_16_16_16_0_16_0
7070,160,1331595480,16,0,1,1331614200,18720,62640,1564260,1501620,16_16_16_16_0_16_0_16
7071,48,1331597040,26,13,8,1331614800,17760,113280,156420,43140,26_26_26_26_26_26_26_6_6_26
7072,213,1331601360,4,22,3,1331622300,20940,2564940,3206820,641880,0_0_0_0_0_1_0_1_0_0_0_0_0_0_0_0_1_1_0_0_0_0_0_0_0_1_1_0_0_0_0_0_0_0_0_0_0_0_0_0_0_1_1_1_0_1_0_0_0_0_0_0_0_0_0_0_1_0_1_0_0_0_0_0_0_0_0_0_0_0_0_0_0_0_0_0_0_0_0_1_1_0_0_0_0_0_0_0_0_0_0_0_0_0_1_1_0_0_2_2_3_3_4_3_3_4_2_2_4_4_4_4_4_4_4_4_5_2_3_4_5_2_3_4_6_6_5_5_0_1_0_1_2_2_2_2_3_3_4_4_4_3_3_3_3_4
7073,220,1331601600,2,22,2,1331606880,5280,1257240,2714040,1456800,0_0_0_0_1_0_1_0_0_0_0_0_1_0_0_1_0_0_0_0_0_0_0_0_0_0_0_0_0_0_0_1_1_0_1_1_1_1_0_0_1_1_2_2_2_2_2
7074,220,1331606880,2,22,2,1331615940,9060,1262520,2714040,1451520,0_0_0_0_1_0_1_0_0_0_0_0_1_0_0_1_0_0_0_0_0_0_0_0_0_0_0_0_0_0_0_1_1_0_1_1_1_1_0_0_1_1_2_2_2_2_2_2
7075,14,1331613540,20,0,20,1331615400,1860,34140,1327560,1293420,20_20_20_20
7076,188,1331613840,18,22,18,1331614800,960,2941800,4327560,1385760,0_0_0_0_0_1_1_0_0_0_0_0_0_0_0_0_1_1_2_2_2_2_3_3_3_3_21_21_3_3_3_3_3_3_3_3_18_18_18_18_18_18
7077,160,1331614200,1,6,16,1331616300,2100,81360,1564260,1482900,16_16_16_16_0_16_0_16_1
7078,167,1331614380,1,9,19,1331614860,480,124080,534900,410820,19_19_19_19_1_1_19_19_19_19_19_1
7079,188,1331614800,18,19,18,1331622660,7860,2942760,4327560,1384800,0_0_0_0_0_1_1_0_0_0_0_0_0_0_0_0_1_1_2_2_2_2_3_3_3_3_21_21_3_3_3_3_3_3_3_3_18_18_18_18_18_18_18
7080,48,1331614800,8,18,8,1331618400,3600,131040,156420,25380,26_26_26_26_26_26_26_6_6_26_8
7081,187,1331614860,4,5,4,1331622660,7800,1964040,2496960,532920,10_10_10_10_10_10_10_10_10_10_10_10_1_1_1_1_2_9_2_9_3_3_4
7082,167,1331614860,19,11,19,1331616180,1320,124560,534900,410340,19_19_19_19_1_1_19_19_19_19_19_1_19
7083,14,1331615400,20,1,20,1331647800,32400,36000,1327560,1291560,20_20_20_20_20
7084,220,1331615940,2,4,2,1331618580,2640,1271580,2714040,1442460,0_0_0_0_1_0_1_0_0_0_0_0_1_0_0_1_0_0_0_0_0_0_0_0_0_0_0_0_0_0_0_1_1_0_1_1_1_1_0_0_1_1_2_2_2_2_2_2_2
7085,167,1331616180,19,1,1,1331620080,3900,125880,534900,409020,19_19_19_19_1_1_19_19_19_19_19_1_19_19
7086,160,1331616300,16,14,1,1331618880,2580,83460,1564260,1480800,16_16_16_16_0_16_0_16_1_16
7087,194,1331618280,53,16,53,1331647020,28740,0,615600,615600,53
7088,4,1331618400,5,18,5,1331618760,360,1264800,1326000,61200,10_10_10_10_10_10_10_1_1_10_10_10_10_10_10_10_10_10_10_1_10_1_10_1_1_10_10_10_10_10_1_1_1_1_2_2_3_3_3_3_14_14_14_14_4_15_4_4_4_15_4_15_15_4_5_5_5
7089,48,1331618400,8,18,25,1331626980,8580,134640,156420,21780,26_26_26_26_26_26_26_6_6_26_8_8
7090,220,1331618580,2,4,27,1331636400,17820,1274220,2714040,1439820,0_0_0_0_1_0_1_0_0_0_0_0_1_0_0_1_0_0_0_0_0_0_0_0_0_0_0_0_0_0_0_1_1_0_1_1_1_1_0_0_1_1_2_2_2_2_2_2_2_2
7091,4,1331618760,5,18,6,1331676000,57240,1265160,1326000,60840,10_10_10_10_10_10_10_1_1_10_10_10_10_10_10_10_10_10_10_1_10_1_10_1_1_10_10_10_10_10_1_1_1_1_2_2_3_3_3_3_14_14_14_14_4_15_4_4_4_15_4_15_15_4_5_5_5_5
7092,160,1331618880,1,6,16,1331622780,3900,86040,1564260,1478220,16_16_16_16_0_16_0_16_1_16_1
7093,167,1331620080,1,9,1,1331620140,60,129780,534900,405120,19_19_19_19_1_1_19_19_19_19_19_1_19_19_1
7094,167,1331620140,2,3,2,1331620200,60,129840,534900,405060,19_19_19_19_1_1_19_19_19_19_19_1_19_19_1_1_1_2
7095,167,1331620140,1,9,2,1331620140,0,129840,534900,405060,19_19_19_19_1_1_19_19_19_19_19_1_19_19_1_1_1
7096,167,1331620140,1,9,1,1331620140,0,129840,534900,405060,19_19_19_19_1_1_19_19_19_19_19_1_19_19_1_1
7097,167,1331620200,9,3,3,1331620260,60,129900,534900,405000,19_19_19_19_1_1_19_19_19_19_19_1_19_19_1_1_1_2_2_9
7098,167,1331620200,2,3,9,1331620200,0,129900,534900,405000,19_19_19_19_1_1_19_19_19_19_19_1_19_19_1_1_1_2_2
7099,167,1331620260,3,3,13,1331620320,60,129960,534900,404940,19_19_19_19_1_1_19_19_19_19_19_1_19_19_1_1_1_2_2_9_3
7100,167,1331620320,9,3,2,1331622780,2460,130020,534900,404880,19_19_19_19_1_1_19_19_19_19_19_1_19_19_1_1_1_2_2_9_3_13_9
7101,167,1331620320,13,15,9,1331620320,0,130020,534900,404880,19_19_19_19_1_1_19_19_19_19_19_1_19_19_1_1_1_2_2_9_3_13
7102,26,1331622000,15,18,15,1331635800,13800,773160,2036760,1263600,16_16_16_16_16_16_16_1_1_16_1_1_2_2_25_9_25_9_3_3_18_18_18_18_15
7103,213,1331622300,3,4,3,1331637780,15480,2585880,3206820,620940,0_0_0_0_0_1_0_1_0_0_0_0_0_0_0_0_1_1_0_0_0_0_0_0_0_1_1_0_0_0_0_0_0_0_0_0_0_0_0_0_0_1_1_1_0_1_0_0_0_0_0_0_0_0_0_0_1_0_1_0_0_0_0_0_0_0_0_0_0_0_0_0_0_0_0_0_0_0_0_1_1_0_0_0_0_0_0_0_0_0_0_0_0_0_1_1_0_0_2_2_3_3_4_3_3_4_2_2_4_4_4_4_4_4_4_4_5_2_3_4_5_2_3_4_6_6_5_5_0_1_0_1_2_2_2_2_3_3_4_4_4_3_3_3_3_4_3
7104,188,1331622660,18,19,18,1331622660,0,2950620,4327560,1376940,0_0_0_0_0_1_1_0_0_0_0_0_0_0_0_0_1_1_2_2_2_2_3_3_3_3_21_21_3_3_3_3_3_3_3_3_18_18_18_18_18_18_18_18
7105,187,1331622660,4,5,4,1331622720,60,1971840,2496960,525120,10_10_10_10_10_10_10_10_10_10_10_10_1_1_1_1_2_9_2_9_3_3_4_4
7106,188,1331622660,18,5,18,1331653200,30540,2950620,4327560,1376940,0_0_0_0_0_1_1_0_0_0_0_0_0_0_0_0_1_1_2_2_2_2_3_3_3_3_21_21_3_3_3_3_3_3_3_3_18_18_18_18_18_18_18_18_18
7107,187,1331622720,4,5,4,1331627580,4860,1971900,2496960,525060,10_10_10_10_10_10_10_10_10_10_10_10_1_1_1_1_2_9_2_9_3_3_4_4_4
7108,160,1331622780,16,14,16,1331643360,20580,89940,1564260,1474320,16_16_16_16_0_16_0_16_1_16_1_16
7109,167,1331622780,2,19,2,1331624520,1740,132480,534900,402420,19_19_19_19_1_1_19_19_19_19_19_1_19_19_1_1_1_2_2_9_3_13_9_2
7110,195,1331623140,1,9,1,1331623200,60,163860,393120,229260,0_0_54_54_0_0_0_0_0_0_0_0_1
7111,195,1331623200,1,9,9,1331733480,110280,163920,393120,229200,0_0_54_54_0_0_0_0_0_0_0_0_1_1
7112,151,1331623260,5,9,5,1331640060,16800,3501060,3643800,142740,19_19_19_19_19_1_1_19_1_1_19_19_19_19_1_19_1_19_19_19_19_19_19_19_19_19_1_19_19_1_1_1_1_1_19_19_19_19_19_19_1_1_19_19_1_1_19_1_1_19_19_19_19_19_19_19_19_19_19_19_19_19_19_19_1_1_47_47_3_3_3_3_2_3_3_2_3_3_3_3_3_3_4_4_4_4_4_4_4_4_4_4_4_4_4_4_4_4_4_5_4_4_5_4_4_4_4_6_6_6_6_4_5_5_6_6_5
7113,167,1331624520,2,19,9,1331624700,180,134220,534900,400680,19_19_19_19_1_1_19_19_19_19_19_1_19_19_1_1_1_2_2_9_3_13_9_2_2
7114,167,1331624700,9,3,3,1331624760,60,134400,534900,400500,19_19_19_19_1_1_19_19_19_19_19_1_19_19_1_1_1_2_2_9_3_13_9_2_2_9
7115,167,1331624760,3,3,9,1331626560,1800,134460,534900,400440,19_19_19_19_1_1_19_19_19_19_19_1_19_19_1_1_1_2_2_9_3_13_9_2_2_9_3
7116,5,1331625240,2,19,2,1331628360,3120,607440,748200,140760,10_10_10_10_10_10_10_10_10_10_1_10_10_1_1_1_10_10_10_10_10_10_10_10_1_1_2
7117,167,1331626560,13,15,19,1331643780,17220,136260,534900,398640,19_19_19_19_1_1_19_19_19_19_19_1_19_19_1_1_1_2_2_9_3_13_9_2_2_9_3_9_13
7118,167,1331626560,9,3,13,1331626560,0,136260,534900,398640,19_19_19_19_1_1_19_19_19_19_19_1_19_19_1_1_1_2_2_9_3_13_9_2_2_9_3_9
7119,48,1331626980,25,28,5,1331637600,10620,143220,156420,13200,26_26_26_26_26_26_26_6_6_26_8_8_25
7120,219,1331627220,17,12,17,1331646900,19680,2343960,3797940,1453980,26_26_26_26_26_26_26_26_26_26_8_8_38_38_17
7121,187,1331627580,4,5,11,1331882400,254820,1976760,2496960,520200,10_10_10_10_10_10_10_10_10_10_10_10_1_1_1_1_2_9_2_9_3_3_4_4_4_4
7122,2,1331627640,4,5,4,1331628060,420,1877100,2555640,678540,10_10_10_10_10_10_10_10_1_1_2_2_9_9_3_3_4
7123,2,1331628060,4,5,4,1331644320,16260,1877520,2555640,678120,10_10_10_10_10_10_10_10_1_1_2_2_9_9_3_3_4_4_4
7124,2,1331628060,4,5,4,1331628060,0,1877520,2555640,678120,10_10_10_10_10_10_10_10_1_1_2_2_9_9_3_3_4_4
7125,5,1331628360,2,19,9,1331638020,9660,610560,748200,137640,10_10_10_10_10_10_10_10_10_10_1_10_10_1_1_1_10_10_10_10_10_10_10_10_1_1_2_2
7126,205,1331628420,2,19,2,1331642160,13740,64020,460800,396780,1_1_2
7127,26,1331635800,15,18,15,1331640000,4200,786960,2036760,1249800,16_16_16_16_16_16_16_1_1_16_1_1_2_2_25_9_25_9_3_3_18_18_18_18_15_15
7128,220,1331636400,27,26,27,1331641800,5400,1292040,2714040,1422000,0_0_0_0_1_0_1_0_0_0_0_0_1_0_0_1_0_0_0_0_0_0_0_0_0_0_0_0_0_0_0_1_1_0_1_1_1_1_0_0_1_1_2_2_2_2_2_2_2_2_27
7129,48,1331637600,5,18,25,1331640000,2400,153840,156420,2580,26_26_26_26_26_26_26_6_6_26_8_8_25_5
7130,213,1331637780,3,4,4,1331644320,6540,2601360,3206820,605460,0_0_0_0_0_1_0_1_0_0_0_0_0_0_0_0_1_1_0_0_0_0_0_0_0_1_1_0_0_0_0_0_0_0_0_0_0_0_0_0_0_1_1_1_0_1_0_0_0_0_0_0_0_0_0_0_1_0_1_0_0_0_0_0_0_0_0_0_0_0_0_0_0_0_0_0_0_0_0_1_1_0_0_0_0_0_0_0_0_0_0_0_0_0_1_1_0_0_2_2_3_3_4_3_3_4_2_2_4_4_4_4_4_4_4_4_5_2_3_4_5_2_3_4_6_6_5_5_0_1_0_1_2_2_2_2_3_3_4_4_4_3_3_3_3_4_3_3
7131,5,1331638020,9,3,9,1331640240,2220,620220,748200,127980,10_10_10_10_10_10_10_10_10_10_1_10_10_1_1_1_10_10_10_10_10_10_10_10_1_1_2_2_9
7132,48,1331640000,25,28,5,1331640180,180,156240,156420,180,26_26_26_26_26_26_26_6_6_26_8_8_25_5_25
7133,26,1331640000,15,18,15,1331642640,2640,791160,2036760,1245600,16_16_16_16_16_16_16_1_1_16_1_1_2_2_25_9_25_9_3_3_18_18_18_18_15_15_15
7134,151,1331640060,5,9,6,1331676000,35940,3517860,3643800,125940,19_19_19_19_19_1_1_19_1_1_19_19_19_19_1_19_1_19_19_19_19_19_19_19_19_19_1_19_19_1_1_1_1_1_19_19_19_19_19_19_1_1_19_19_1_1_19_1_1_19_19_19_19_19_19_19_19_19_19_19_19_19_19_19_1_1_47_47_3_3_3_3_2_3_3_2_3_3_3_3_3_3_4_4_4_4_4_4_4_4_4_4_4_4_4_4_4_4_4_5_4_4_5_4_4_4_4_6_6_6_6_4_5_5_6_6_5_5
7135,15,1331640060,7,8,7,1331653680,13620,460080,1822860,1362780,7_7_7
7136,48,1331640180,5,18,99,1331640180,0,156420,156420,0,26_26_26_26_26_26_26_6_6_26_8_8_25_5_25_5
7137,5,1331640240,9,3,5,1331640420,180,622440,748200,125760,10_10_10_10_10_10_10_10_10_10_1_10_10_1_1_1_10_10_10_10_10_10_10_10_1_1_2_2_9_9
7138,5,1331640420,5,9,5,1331654220,13800,622620,748200,125580,10_10_10_10_10_10_10_10_10_10_1_10_10_1_1_1_10_10_10_10_10_10_10_10_1_1_2_2_9_9_5
7139,220,1331641800,27,26,27,1331641800,0,1297440,2714040,1416600,0_0_0_0_1_0_1_0_0_0_0_0_1_0_0_1_0_0_0_0_0_0_0_0_0_0_0_0_0_0_0_1_1_0_1_1_1_1_0_0_1_1_2_2_2_2_2_2_2_2_27_27
7140,220,1331641800,27,26,27,1331647200,5400,1297440,2714040,1416600,0_0_0_0_1_0_1_0_0_0_0_0_1_0_0_1_0_0_0_0_0_0_0_0_0_0_0_0_0_0_0_1_1_0_1_1_1_1_0_0_1_1_2_2_2_2_2_2_2_2_27_27_27
7141,205,1331642160,2,19,3,1331676000,33840,77760,460800,383040,1_1_2_2
7142,31,1331642640,2,19,2,1331644500,1860,796620,1374660,578040,19_19_19_19_19_19_19_19_1_1_19_19_19_19_19_3_19_19_3_19_1_19_1_19_19_1_3_1_3_19_19_2_6_6_2_19_19_1_1_5_5_19_5_1_1_5_3_3_2_2_1_1_1_1_5_5_5_5_3_3_2_5_2_5_6_6_2
7143,26,1331642640,15,18,3,1332280800,638160,793800,2036760,1242960,16_16_16_16_16_16_16_1_1_16_1_1_2_2_25_9_25_9_3_3_18_18_18_18_15_15_15_15
7144,160,1331643360,16,14,16,1331647620,4260,110520,1564260,1453740,16_16_16_16_0_16_0_16_1_16_1_16_16
7145,155,1331643360,5,18,2,1331645640,2280,3053160,3225180,172020,0_0_0_0_0_0_0_0_1_1_1_1_2_2_9_9_9_9_9_9_9_9_9_9_9_9_4_4_4_4_4_4_4_4_4_3_3_4_4_3_4_3_4_4_4_4_4_4_5
7146,167,1331643780,19,1,13,1331646660,2880,153480,534900,381420,19_19_19_19_1_1_19_19_19_19_19_1_19_19_1_1_1_2_2_9_3_13_9_2_2_9_3_9_13_19
7147,2,1331644320,4,5,11,1331890200,245880,1893780,2555640,661860,10_10_10_10_10_10_10_10_1_1_2_2_9_9_3_3_4_4_4_4
7148,213,1331644320,4,5,4,1331645700,1380,2607900,3206820,598920,0_0_0_0_0_1_0_1_0_0_0_0_0_0_0_0_1_1_0_0_0_0_0_0_0_1_1_0_0_0_0_0_0_0_0_0_0_0_0_0_0_1_1_1_0_1_0_0_0_0_0_0_0_0_0_0_1_0_1_0_0_0_0_0_0_0_0_0_0_0_0_0_0_0_0_0_0_0_0_1_1_0_0_0_0_0_0_0_0_0_0_0_0_0_1_1_0_0_2_2_3_3_4_3_3_4_2_2_4_4_4_4_4_4_4_4_5_2_3_4_5_2_3_4_6_6_5_5_0_1_0_1_2_2_2_2_3_3_4_4_4_3_3_3_3_4_3_3_4
7149,31,1331644500,2,19,3,1331762400,117900,798480,1374660,576180,19_19_19_19_19_19_19_19_1_1_19_19_19_19_19_3_19_19_3_19_1_19_1_19_19_1_3_1_3_19_19_2_6_6_2_19_19_1_1_5_5_19_5_1_1_5_3_3_2_2_1_1_1_1_5_5_5_5_3_3_2_5_2_5_6_6_2_2
7150,155,1331645640,2,19,2,1331646900,1260,3055440,3225180,169740,0_0_0_0_0_0_0_0_1_1_1_1_2_2_9_9_9_9_9_9_9_9_9_9_9_9_4_4_4_4_4_4_4_4_4_3_3_4_4_3_4_3_4_4_4_4_4_4_5_2
7151,213,1331645700,4,5,4,1331645760,60,2609280,3206820,597540,0_0_0_0_0_1_0_1_0_0_0_0_0_0_0_0_1_1_0_0_0_0_0_0_0_1_1_0_0_0_0_0_0_0_0_0_0_0_0_0_0_1_1_1_0_1_0_0_0_0_0_0_0_0_0_0_1_0_1_0_0_0_0_0_0_0_0_0_0_0_0_0_0_0_0_0_0_0_0_1_1_0_0_0_0_0_0_0_0_0_0_0_0_0_1_1_0_0_2_2_3_3_4_3_3_4_2_2_4_4_4_4_4_4_4_4_5_2_3_4_5_2_3_4_6_6_5_5_0_1_0_1_2_2_2_2_3_3_4_4_4_3_3_3_3_4_3_3_4_4
7152,213,1331645760,4,5,4,1331646960,1200,2609340,3206820,597480,0_0_0_0_0_1_0_1_0_0_0_0_0_0_0_0_1_1_0_0_0_0_0_0_0_1_1_0_0_0_0_0_0_0_0_0_0_0_0_0_0_1_1_1_0_1_0_0_0_0_0_0_0_0_0_0_1_0_1_0_0_0_0_0_0_0_0_0_0_0_0_0_0_0_0_0_0_0_0_1_1_0_0_0_0_0_0_0_0_0_0_0_0_0_1_1_0_0_2_2_3_3_4_3_3_4_2_2_4_4_4_4_4_4_4_4_5_2_3_4_5_2_3_4_6_6_5_5_0_1_0_1_2_2_2_2_3_3_4_4_4_3_3_3_3_4_3_3_4_4_4
7153,167,1331646660,3,3,3,1331646720,60,156360,534900,378540,19_19_19_19_1_1_19_19_19_19_19_1_19_19_1_1_1_2_2_9_3_13_9_2_2_9_3_9_13_19_13_3
7154,167,1331646660,13,15,3,1331646660,0,156360,534900,378540,19_19_19_19_1_1_19_19_19_19_19_1_19_19_1_1_1_2_2_9_3_13_9_2_2_9_3_9_13_19_13
7155,24,1331646720,3,3,3,1331651460,4740,1398780,1547520,148740,16_16_16_16_16_16_1_1_2_2_3
7156,167,1331646720,3,3,13,1331646780,60,156420,534900,378480,19_19_19_19_1_1_19_19_19_19_19_1_19_19_1_1_1_2_2_9_3_13_9_2_2_9_3_9_13_19_13_3_3
7157,167,1331646780,13,15,5,1331716380,69600,156480,534900,378420,19_19_19_19_1_1_19_19_19_19_19_1_19_19_1_1_1_2_2_9_3_13_9_2_2_9_3_9_13_19_13_3_3_13
7158,155,1331646900,2,19,5,1331647140,240,3056700,3225180,168480,0_0_0_0_0_0_0_0_1_1_1_1_2_2_9_9_9_9_9_9_9_9_9_9_9_9_4_4_4_4_4_4_4_4_4_3_3_4_4_3_4_3_4_4_4_4_4_4_5_2_2
7159,219,1331646900,17,12,17,1331647500,600,2363640,3797940,1434300,26_26_26_26_26_26_26_26_26_26_8_8_38_38_17_17
7160,213,1331646960,4,5,4,1331647020,60,2610540,3206820,596280,0_0_0_0_0_1_0_1_0_0_0_0_0_0_0_0_1_1_0_0_0_0_0_0_0_1_1_0_0_0_0_0_0_0_0_0_0_0_0_0_0_1_1_1_0_1_0_0_0_0_0_0_0_0_0_0_1_0_1_0_0_0_0_0_0_0_0_0_0_0_0_0_0_0_0_0_0_0_0_1_1_0_0_0_0_0_0_0_0_0_0_0_0_0_1_1_0_0_2_2_3_3_4_3_3_4_2_2_4_4_4_4_4_4_4_4_5_2_3_4_5_2_3_4_6_6_5_5_0_1_0_1_2_2_2_2_3_3_4_4_4_3_3_3_3_4_3_3_4_4_4_4
7161,213,1331647020,4,23,4,1331674740,27720,2610600,3206820,596220,0_0_0_0_0_1_0_1_0_0_0_0_0_0_0_0_1_1_0_0_0_0_0_0_0_1_1_0_0_0_0_0_0_0_0_0_0_0_0_0_0_1_1_1_0_1_0_0_0_0_0_0_0_0_0_0_1_0_1_0_0_0_0_0_0_0_0_0_0_0_0_0_0_0_0_0_0_0_0_1_1_0_0_0_0_0_0_0_0_0_0_0_0_0_1_1_0_0_2_2_3_3_4_3_3_4_2_2_4_4_4_4_4_4_4_4_5_2_3_4_5_2_3_4_6_6_5_5_0_1_0_1_2_2_2_2_3_3_4_4_4_3_3_3_3_4_3_3_4_4_4_4_4
7162,194,1331647020,53,16,6,1332194400,547380,28740,615600,586860,53_53
7163,155,1331647140,5,18,5,1331708400,61260,3056940,3225180,168240,0_0_0_0_0_0_0_0_1_1_1_1_2_2_9_9_9_9_9_9_9_9_9_9_9_9_4_4_4_4_4_4_4_4_4_3_3_4_4_3_4_3_4_4_4_4_4_4_5_2_2_5
7164,220,1331647200,27,26,27,1331647200,0,1302840,2714040,1411200,0_0_0_0_1_0_1_0_0_0_0_0_1_0_0_1_0_0_0_0_0_0_0_0_0_0_0_0_0_0_0_1_1_0_1_1_1_1_0_0_1_1_2_2_2_2_2_2_2_2_27_27_27_27
7165,220,1331647200,27,26,27,1331652600,5400,1302840,2714040,1411200,0_0_0_0_1_0_1_0_0_0_0_0_1_0_0_1_0_0_0_0_0_0_0_0_0_0_0_0_0_0_0_1_1_0_1_1_1_1_0_0_1_1_2_2_2_2_2_2_2_2_27_27_27_27_27
7166,219,1331647500,17,10,17,1331666580,19080,2364240,3797940,1433700,26_26_26_26_26_26_26_26_26_26_8_8_38_38_17_17_17
7167,160,1331647620,16,14,16,1331654100,6480,114780,1564260,1449480,16_16_16_16_0_16_0_16_1_16_1_16_16_16
7168,135,1331647680,49,13,49,1331651460,3780,5573280,5649480,76200,19_19_19_19_19_19_19_19_19_19_19_19_1_19_1_19_19_19_1_1_1_1_19_19_19_19_19_19_1_1_1_1_19_19_19_19_19_19_19_19_19_19_19_19_1_19_1_19_19_19_19_19_19_1_19_1_1_1_2_2_1_1_2_2_9_3_3_9_3_3_2_9_9_9_2_4_4_3_4_3_3_9_3_4_4_4_4_9_3_9_3_4_4_4_4_4_5_5_5_5_5_5_6_6_49
7169,14,1331647800,20,1,20,1331648040,240,68400,1327560,1259160,20_20_20_20_20_20
7170,14,1331648040,20,20,20,1331660520,12480,68640,1327560,1258920,20_20_20_20_20_20_20
7171,162,1331649840,5,6,5,1331653440,3600,3561300,4836120,1274820,0_0_16_16_0_0_0_0_0_0_0_0_16_0_0_16_0_0_16_16_0_0_1_1_2_2_3_3_3_4_3_4_4_4_4_4_5_5_5
7172,135,1331651460,49,13,49,1331651460,0,5577060,5649480,72420,19_19_19_19_19_19_19_19_19_19_19_19_1_19_1_19_19_19_1_1_1_1_19_19_19_19_19_19_1_1_1_1_19_19_19_19_19_19_19_19_19_19_19_19_1_19_1_19_19_19_19_19_19_1_19_1_1_1_2_2_1_1_2_2_9_3_3_9_3_3_2_9_9_9_2_4_4_3_4_3_3_9_3_4_4_4_4_9_3_9_3_4_4_4_4_4_5_5_5_5_5_5_6_6_49_49
7173,135,1331651460,49,13,49,1331657220,5760,5577060,5649480,72420,19_19_19_19_19_19_19_19_19_19_19_19_1_19_1_19_19_19_1_1_1_1_19_19_19_19_19_19_1_1_1_1_19_19_19_19_19_19_19_19_19_19_19_19_1_19_1_19_19_19_19_19_19_1_19_1_1_1_2_2_1_1_2_2_9_3_3_9_3_3_2_9_9_9_2_4_4_3_4_3_3_9_3_4_4_4_4_9_3_9_3_4_4_4_4_4_5_5_5_5_5_5_6_6_49_49_49
7174,24,1331651460,3,3,13,1331701200,49740,1403520,1547520,144000,16_16_16_16_16_16_1_1_2_2_3_3
7175,220,1331652600,27,26,27,1331701200,48600,1308240,2714040,1405800,0_0_0_0_1_0_1_0_0_0_0_0_1_0_0_1_0_0_0_0_0_0_0_0_0_0_0_0_0_0_0_1_1_0_1_1_1_1_0_0_1_1_2_2_2_2_2_2_2_2_27_27_27_27_27_27
7176,188,1331653200,18,5,18,1331653260,60,2981160,4327560,1346400,0_0_0_0_0_1_1_0_0_0_0_0_0_0_0_0_1_1_2_2_2_2_3_3_3_3_21_21_3_3_3_3_3_3_3_3_18_18_18_18_18_18_18_18_18_18
7177,188,1331653260,18,23,18,1331662260,9000,2981220,4327560,1346340,0_0_0_0_0_1_1_0_0_0_0_0_0_0_0_0_1_1_2_2_2_2_3_3_3_3_21_21_3_3_3_3_3_3_3_3_18_18_18_18_18_18_18_18_18_18_18
7178,162,1331653440,5,6,6,1331676000,22560,3564900,4836120,1271220,0_0_16_16_0_0_0_0_0_0_0_0_16_0_0_16_0_0_16_16_0_0_1_1_2_2_3_3_3_4_3_4_4_4_4_4_5_5_5_5
7179,15,1331653680,7,8,7,1331666880,13200,473700,1822860,1349160,7_7_7_7
7180,160,1331654100,16,20,16,1331662440,8340,121260,1564260,1443000,16_16_16_16_0_16_0_16_1_16_1_16_16_16_16
7181,5,1331654220,5,9,5,1331701080,46860,636420,748200,111780,10_10_10_10_10_10_10_10_10_10_1_10_10_1_1_1_10_10_10_10_10_10_10_10_1_1_2_2_9_9_5_5
7182,135,1331657220,49,13,6,1331676000,18780,5582820,5649480,66660,19_19_19_19_19_19_19_19_19_19_19_19_1_19_1_19_19_19_1_1_1_1_19_19_19_19_19_19_1_1_1_1_19_19_19_19_19_19_19_19_19_19_19_19_1_19_1_19_19_19_19_19_19_1_19_1_1_1_2_2_1_1_2_2_9_3_3_9_3_3_2_9_9_9_2_4_4_3_4_3_3_9_3_4_4_4_4_9_3_9_3_4_4_4_4_4_5_5_5_5_5_5_6_6_49_49_49_49
7183,3,1331657220,12,13,12,1331661780,4560,0,1055580,1055580,12
7184,14,1331660520,20,20,20,1331660640,120,81120,1327560,1246440,20_20_20_20_20_20_20_20
7185,14,1331660640,20,0,20,1331700300,39660,81240,1327560,1246320,20_20_20_20_20_20_20_20_20
7186,3,1331661780,12,13,10,1331663880,2100,4560,1055580,1051020,12_12
7187,188,1331662260,18,23,18,1331662320,60,2990220,4327560,1337340,0_0_0_0_0_1_1_0_0_0_0_0_0_0_0_0_1_1_2_2_2_2_3_3_3_3_21_21_3_3_3_3_3_3_3_3_18_18_18_18_18_18_18_18_18_18_18_18
7188,188,1331662320,18,22,18,1331700540,38220,2990280,4327560,1337280,0_0_0_0_0_1_1_0_0_0_0_0_0_0_0_0_1_1_2_2_2_2_3_3_3_3_21_21_3_3_3_3_3_3_3_3_18_18_18_18_18_18_18_18_18_18_18_18_18
7189,160,1331662440,16,20,16,1331662560,120,129600,1564260,1434660,16_16_16_16_0_16_0_16_1_16_1_16_16_16_16_16
7190,160,1331662560,16,0,16,1331683020,20460,129720,1564260,1434540,16_16_16_16_0_16_0_16_1_16_1_16_16_16_16_16_16
7191,3,1331663880,10,13,10,1331672580,8700,6660,1055580,1048920,12_12_10
7192,219,1331666580,17,10,17,1331701920,35340,2383320,3797940,1414620,26_26_26_26_26_26_26_26_26_26_8_8_38_38_17_17_17_17
7193,15,1331666880,7,10,7,1331673000,6120,486900,1822860,1335960,7_7_7_7_7
7194,3,1331672580,10,13,10,1331672640,60,15360,1055580,1040220,12_12_10_10
7195,3,1331672640,10,13,10,1331675340,2700,15420,1055580,1040160,12_12_10_10_10
7196,15,1331673000,7,10,1,1331701200,28200,493020,1822860,1329840,7_7_7_7_7_7
7197,213,1331674740,4,23,3,1331676000,1260,2638320,3206820,568500,0_0_0_0_0_1_0_1_0_0_0_0_0_0_0_0_1_1_0_0_0_0_0_0_0_1_1_0_0_0_0_0_0_0_0_0_0_0_0_0_0_1_1_1_0_1_0_0_0_0_0_0_0_0_0_0_1_0_1_0_0_0_0_0_0_0_0_0_0_0_0_0_0_0_0_0_0_0_0_1_1_0_0_0_0_0_0_0_0_0_0_0_0_0_1_1_0_0_2_2_3_3_4_3_3_4_2_2_4_4_4_4_4_4_4_4_5_2_3_4_5_2_3_4_6_6_5_5_0_1_0_1_2_2_2_2_3_3_4_4_4_3_3_3_3_4_3_3_4_4_4_4_4_4
7198,3,1331675340,10,13,10,1331675400,60,18120,1055580,1037460,12_12_10_10_10_10
7199,3,1331675400,10,13,10,1331679960,4560,18180,1055580,1037400,12_12_10_10_10_10_10
7200,61,1331676000,3,25,2,1331676000,0,6220800,6225300,4500,4_4_18_18_34_34_34_3_3_34_3_3_34_35_34_35_35_35_36_36_35_35_35_35_34_34_34_34_34_34_34_34_34_34_34_34_34_34_34_34_34_34_34_34_34_34_34_34_34_34_34_34_34_34_34_34_34_34_1_1_3
7201,61,1331676000,2,25,4,1331676000,0,6220800,6225300,4500,4_4_18_18_34_34_34_3_3_34_3_3_34_35_34_35_35_35_36_36_35_35_35_35_34_34_34_34_34_34_34_34_34_34_34_34_34_34_34_34_34_34_34_34_34_34_34_34_34_34_34_34_34_34_34_34_34_34_1_1_3_2
7202,213,1331676000,3,4,4,1331676900,900,2639580,3206820,567240,0_0_0_0_0_1_0_1_0_0_0_0_0_0_0_0_1_1_0_0_0_0_0_0_0_1_1_0_0_0_0_0_0_0_0_0_0_0_0_0_0_1_1_1_0_1_0_0_0_0_0_0_0_0_0_0_1_0_1_0_0_0_0_0_0_0_0_0_0_0_0_0_0_0_0_0_0_0_0_1_1_0_0_0_0_0_0_0_0_0_0_0_0_0_1_1_0_0_2_2_3_3_4_3_3_4_2_2_4_4_4_4_4_4_4_4_5_2_3_4_5_2_3_4_6_6_5_5_0_1_0_1_2_2_2_2_3_3_4_4_4_3_3_3_3_4_3_3_4_4_4_4_4_4_3
7203,61,1331676000,15,25,3,1331680500,4500,6220800,6225300,4500,4_4_18_18_34_34_34_3_3_34_3_3_34_35_34_35_35_35_36_36_35_35_35_35_34_34_34_34_34_34_34_34_34_34_34_34_34_34_34_34_34_34_34_34_34_34_34_34_34_34_34_34_34_34_34_34_34_34_1_1_3_2_4_15
7204,61,1331676000,4,25,15,1331676000,0,6220800,6225300,4500,4_4_18_18_34_34_34_3_3_34_3_3_34_35_34_35_35_35_36_36_35_35_35_35_34_34_34_34_34_34_34_34_34_34_34_34_34_34_34_34_34_34_34_34_34_34_34_34_34_34_34_34_34_34_34_34_34_34_1_1_3_2_4
7205,27,1331676000,0,20,0,1331680500,4500,0,402780,402780,0
7206,4,1331676000,6,7,6,1331679600,3600,1322400,1326000,3600,10_10_10_10_10_10_10_1_1_10_10_10_10_10_10_10_10_10_10_1_10_1_10_1_1_10_10_10_10_10_1_1_1_1_2_2_3_3_3_3_14_14_14_14_4_15_4_4_4_15_4_15_15_4_5_5_5_5_6
7207,135,1331676000,6,7,6,1331679600,3600,5601600,5649480,47880,19_19_19_19_19_19_19_19_19_19_19_19_1_19_1_19_19_19_1_1_1_1_19_19_19_19_19_19_1_1_1_1_19_19_19_19_19_19_19_19_19_19_19_19_1_19_1_19_19_19_19_19_19_1_19_1_1_1_2_2_1_1_2_2_9_3_3_9_3_3_2_9_9_9_2_4_4_3_4_3_3_9_3_4_4_4_4_9_3_9_3_4_4_4_4_4_5_5_5_5_5_5_6_6_49_49_49_49_6
7208,205,1331676000,3,4,3,1331680500,4500,111600,460800,349200,1_1_2_2_3
7209,162,1331676000,6,7,6,1331679600,3600,3587460,4836120,1248660,0_0_16_16_0_0_0_0_0_0_0_0_16_0_0_16_0_0_16_16_0_0_1_1_2_2_3_3_3_4_3_4_4_4_4_4_5_5_5_5_6
7210,151,1331676000,6,7,6,1331679600,3600,3553800,3643800,90000,19_19_19_19_19_1_1_19_1_1_19_19_19_19_1_19_1_19_19_19_19_19_19_19_19_19_1_19_19_1_1_1_1_1_19_19_19_19_19_19_1_1_19_19_1_1_19_1_1_19_19_19_19_19_19_19_19_19_19_19_19_19_19_19_1_1_47_47_3_3_3_3_2_3_3_2_3_3_3_3_3_3_4_4_4_4_4_4_4_4_4_4_4_4_4_4_4_4_4_5_4_4_5_4_4_4_4_6_6_6_6_4_5_5_6_6_5_5_6
7211,213,1331676900,4,22,3,1331680500,3600,2640480,3206820,566340,0_0_0_0_0_1_0_1_0_0_0_0_0_0_0_0_1_1_0_0_0_0_0_0_0_1_1_0_0_0_0_0_0_0_0_0_0_0_0_0_0_1_1_1_0_1_0_0_0_0_0_0_0_0_0_0_1_0_1_0_0_0_0_0_0_0_0_0_0_0_0_0_0_0_0_0_0_0_0_1_1_0_0_0_0_0_0_0_0_0_0_0_0_0_1_1_0_0_2_2_3_3_4_3_3_4_2_2_4_4_4_4_4_4_4_4_5_2_3_4_5_2_3_4_6_6_5_5_0_1_0_1_2_2_2_2_3_3_4_4_4_3_3_3_3_4_3_3_4_4_4_4_4_4_3_4
7212,4,1331679600,6,7,99,1331679600,0,1326000,1326000,0,10_10_10_10_10_10_10_1_1_10_10_10_10_10_10_10_10_10_10_1_10_1_10_1_1_10_10_10_10_10_1_1_1_1_2_2_3_3_3_3_14_14_14_14_4_15_4_4_4_15_4_15_15_4_5_5_5_5_6_6
7213,135,1331679600,6,7,1,1331714160,34560,5605200,5649480,44280,19_19_19_19_19_19_19_19_19_19_19_19_1_19_1_19_19_19_1_1_1_1_19_19_19_19_19_19_1_1_1_1_19_19_19_19_19_19_19_19_19_19_19_19_1_19_1_19_19_19_19_19_19_1_19_1_1_1_2_2_1_1_2_2_9_3_3_9_3_3_2_9_9_9_2_4_4_3_4_3_3_9_3_4_4_4_4_9_3_9_3_4_4_4_4_4_5_5_5_5_5_5_6_6_49_49_49_49_6_6
7214,162,1331679600,6,7,5,1331700780,21180,3591060,4836120,1245060,0_0_16_16_0_0_0_0_0_0_0_0_16_0_0_16_0_0_16_16_0_0_1_1_2_2_3_3_3_4_3_4_4_4_4_4_5_5_5_5_6_6
7215,151,1331679600,6,7,6,1331762400,82800,3557400,3643800,86400,19_19_19_19_19_1_1_19_1_1_19_19_19_19_1_19_1_19_19_19_19_19_19_19_19_19_1_19_19_1_1_1_1_1_19_19_19_19_19_19_1_1_19_19_1_1_19_1_1_19_19_19_19_19_19_19_19_19_19_19_19_19_19_19_1_1_47_47_3_3_3_3_2_3_3_2_3_3_3_3_3_3_4_4_4_4_4_4_4_4_4_4_4_4_4_4_4_4_4_5_4_4_5_4_4_4_4_6_6_6_6_4_5_5_6_6_5_5_6_6
7216,3,1331679960,10,11,10,1331699280,19320,22740,1055580,1032840,12_12_10_10_10_10_10_10_10
7217,3,1331679960,10,13,10,1331679960,0,22740,1055580,1032840,12_12_10_10_10_10_10_10
7218,61,1331680500,4,25,2,1331680500,0,6225300,6225300,0,4_4_18_18_34_34_34_3_3_34_3_3_34_35_34_35_35_35_36_36_35_35_35_35_34_34_34_34_34_34_34_34_34_34_34_34_34_34_34_34_34_34_34_34_34_34_34_34_34_34_34_34_34_34_34_34_34_34_1_1_3_2_4_15_3_15_4
7219,61,1331680500,2,25,99,1331680500,0,6225300,6225300,0,4_4_18_18_34_34_34_3_3_34_3_3_34_35_34_35_35_35_36_36_35_35_35_35_34_34_34_34_34_34_34_34_34_34_34_34_34_34_34_34_34_34_34_34_34_34_34_34_34_34_34_34_34_34_34_34_34_34_1_1_3_2_4_15_3_15_4_2
7220,61,1331680500,3,25,15,1331680500,0,6225300,6225300,0,4_4_18_18_34_34_34_3_3_34_3_3_34_35_34_35_35_35_36_36_35_35_35_35_34_34_34_34_34_34_34_34_34_34_34_34_34_34_34_34_34_34_34_34_34_34_34_34_34_34_34_34_34_34_34_34_34_34_1_1_3_2_4_15_3
7221,27,1331680500,0,20,0,1331760600,80100,4500,402780,398280,0_0
7222,205,1331680500,3,4,3,1331716620,36120,116100,460800,344700,1_1_2_2_3_3
7223,213,1331680500,3,4,4,1331700480,19980,2644080,3206820,562740,0_0_0_0_0_1_0_1_0_0_0_0_0_0_0_0_1_1_0_0_0_0_0_0_0_1_1_0_0_0_0_0_0_0_0_0_0_0_0_0_0_1_1_1_0_1_0_0_0_0_0_0_0_0_0_0_1_0_1_0_0_0_0_0_0_0_0_0_0_0_0_0_0_0_0_0_0_0_0_1_1_0_0_0_0_0_0_0_0_0_0_0_0_0_1_1_0_0_2_2_3_3_4_3_3_4_2_2_4_4_4_4_4_4_4_4_5_2_3_4_5_2_3_4_6_6_5_5_0_1_0_1_2_2_2_2_3_3_4_4_4_3_3_3_3_4_3_3_4_4_4_4_4_4_3_4_3
7224,61,1331680500,15,25,4,1331680500,0,6225300,6225300,0,4_4_18_18_34_34_34_3_3_34_3_3_34_35_34_35_35_35_36_36_35_35_35_35_34_34_34_34_34_34_34_34_34_34_34_34_34_34_34_34_34_34_34_34_34_34_34_34_34_34_34_34_34_34_34_34_34_34_1_1_3_2_4_15_3_15
7225,160,1331683020,16,0,1,1331705520,22500,150180,1564260,1414080,16_16_16_16_0_16_0_16_1_16_1_16_16_16_16_16_16_16
7226,164,1331683080,22,0,22,1331697540,14460,0,123600,123600,22
7227,164,1331697540,22,0,16,1331709900,12360,14460,123600,109140,22_22
7228,3,1331699280,10,11,10,1331701320,2040,42060,1055580,1013520,12_12_10_10_10_10_10_10_10_10
7229,14,1331700300,20,0,20,1331701080,780,120900,1327560,1206660,20_20_20_20_20_20_20_20_20_20
7230,213,1331700480,4,22,4,1331700540,60,2664060,3206820,542760,0_0_0_0_0_1_0_1_0_0_0_0_0_0_0_0_1_1_0_0_0_0_0_0_0_1_1_0_0_0_0_0_0_0_0_0_0_0_0_0_0_1_1_1_0_1_0_0_0_0_0_0_0_0_0_0_1_0_1_0_0_0_0_0_0_0_0_0_0_0_0_0_0_0_0_0_0_0_0_1_1_0_0_0_0_0_0_0_0_0_0_0_0_0_1_1_0_0_2_2_3_3_4_3_3_4_2_2_4_4_4_4_4_4_4_4_5_2_3_4_5_2_3_4_6_6_5_5_0_1_0_1_2_2_2_2_3_3_4_4_4_3_3_3_3_4_3_3_4_4_4_4_4_4_3_4_3_4
7231,213,1331700540,4,5,3,1331701320,780,2664120,3206820,542700,0_0_0_0_0_1_0_1_0_0_0_0_0_0_0_0_1_1_0_0_0_0_0_0_0_1_1_0_0_0_0_0_0_0_0_0_0_0_0_0_0_1_1_1_0_1_0_0_0_0_0_0_0_0_0_0_1_0_1_0_0_0_0_0_0_0_0_0_0_0_0_0_0_0_0_0_0_0_0_1_1_0_0_0_0_0_0_0_0_0_0_0_0_0_1_1_0_0_2_2_3_3_4_3_3_4_2_2_4_4_4_4_4_4_4_4_5_2_3_4_5_2_3_4_6_6_5_5_0_1_0_1_2_2_2_2_3_3_4_4_4_3_3_3_3_4_3_3_4_4_4_4_4_4_3_4_3_4_4
7232,188,1331700540,18,22,18,1331700600,60,3028500,4327560,1299060,0_0_0_0_0_1_1_0_0_0_0_0_0_0_0_0_1_1_2_2_2_2_3_3_3_3_21_21_3_3_3_3_3_3_3_3_18_18_18_18_18_18_18_18_18_18_18_18_18_18
7233,188,1331700600,18,19,18,1331733720,33120,3028560,4327560,1299000,0_0_0_0_0_1_1_0_0_0_0_0_0_0_0_0_1_1_2_2_2_2_3_3_3_3_21_21_3_3_3_3_3_3_3_3_18_18_18_18_18_18_18_18_18_18_18_18_18_18_18
7234,162,1331700780,5,6,5,1331700840,60,3612240,4836120,1223880,0_0_16_16_0_0_0_0_0_0_0_0_16_0_0_16_0_0_16_16_0_0_1_1_2_2_3_3_3_4_3_4_4_4_4_4_5_5_5_5_6_6_5
7235,162,1331700840,5,6,6,1332882000,1181160,3612300,4836120,1223820,0_0_16_16_0_0_0_0_0_0_0_0_16_0_0_16_0_0_16_16_0_0_1_1_2_2_3_3_3_4_3_4_4_4_4_4_5_5_5_5_6_6_5_5
7236,5,1331701080,5,9,5,1331714100,13020,683280,748200,64920,10_10_10_10_10_10_10_10_10_10_1_10_10_1_1_1_10_10_10_10_10_10_10_10_1_1_2_2_9_9_5_5_5
7237,14,1331701080,20,1,20,1331715540,14460,121680,1327560,1205880,20_20_20_20_20_20_20_20_20_20_20
7238,24,1331701200,13,15,13,1331713560,12360,1453260,1547520,94260,16_16_16_16_16_16_1_1_2_2_3_3_13
7239,15,1331701200,1,18,7,1331705700,4500,521220,1822860,1301640,7_7_7_7_7_7_1
7240,220,1331701200,27,26,27,1331737200,36000,1356840,2714040,1357200,0_0_0_0_1_0_1_0_0_0_0_0_1_0_0_1_0_0_0_0_0_0_0_0_0_0_0_0_0_0_0_1_1_0_1_1_1_1_0_0_1_1_2_2_2_2_2_2_2_2_27_27_27_27_27_27_27
7241,3,1331701320,10,16,10,1331704080,2760,44100,1055580,1011480,12_12_10_10_10_10_10_10_10_10_10
7242,213,1331701320,3,4,3,1331701380,60,2664900,3206820,541920,0_0_0_0_0_1_0_1_0_0_0_0_0_0_0_0_1_1_0_0_0_0_0_0_0_1_1_0_0_0_0_0_0_0_0_0_0_0_0_0_0_1_1_1_0_1_0_0_0_0_0_0_0_0_0_0_1_0_1_0_0_0_0_0_0_0_0_0_0_0_0_0_0_0_0_0_0_0_0_1_1_0_0_0_0_0_0_0_0_0_0_0_0_0_1_1_0_0_2_2_3_3_4_3_3_4_2_2_4_4_4_4_4_4_4_4_5_2_3_4_5_2_3_4_6_6_5_5_0_1_0_1_2_2_2_2_3_3_4_4_4_3_3_3_3_4_3_3_4_4_4_4_4_4_3_4_3_4_4_3
7243,213,1331701380,3,4,3,1331705100,3720,2664960,3206820,541860,0_0_0_0_0_1_0_1_0_0_0_0_0_0_0_0_1_1_0_0_0_0_0_0_0_1_1_0_0_0_0_0_0_0_0_0_0_0_0_0_0_1_1_1_0_1_0_0_0_0_0_0_0_0_0_0_1_0_1_0_0_0_0_0_0_0_0_0_0_0_0_0_0_0_0_0_0_0_0_1_1_0_0_0_0_0_0_0_0_0_0_0_0_0_1_1_0_0_2_2_3_3_4_3_3_4_2_2_4_4_4_4_4_4_4_4_5_2_3_4_5_2_3_4_6_6_5_5_0_1_0_1_2_2_2_2_3_3_4_4_4_3_3_3_3_4_3_3_4_4_4_4_4_4_3_4_3_4_4_3_3
7244,219,1331701920,17,12,17,1331705040,3120,2418660,3797940,1379280,26_26_26_26_26_26_26_26_26_26_8_8_38_38_17_17_17_17_17
7245,3,1331704080,10,16,10,1331704140,60,46860,1055580,1008720,12_12_10_10_10_10_10_10_10_10_10_10
7246,3,1331704140,10,16,10,1331716200,12060,46920,1055580,1008660,12_12_10_10_10_10_10_10_10_10_10_10_10
7247,219,1331705040,17,12,17,1331715600,10560,2421780,3797940,1376160,26_26_26_26_26_26_26_26_26_26_8_8_38_38_17_17_17_17_17_17
7248,213,1331705100,3,3,4,1331714640,9540,2668680,3206820,538140,0_0_0_0_0_1_0_1_0_0_0_0_0_0_0_0_1_1_0_0_0_0_0_0_0_1_1_0_0_0_0_0_0_0_0_0_0_0_0_0_0_1_1_1_0_1_0_0_0_0_0_0_0_0_0_0_1_0_1_0_0_0_0_0_0_0_0_0_0_0_0_0_0_0_0_0_0_0_0_1_1_0_0_0_0_0_0_0_0_0_0_0_0_0_1_1_0_0_2_2_3_3_4_3_3_4_2_2_4_4_4_4_4_4_4_4_5_2_3_4_5_2_3_4_6_6_5_5_0_1_0_1_2_2_2_2_3_3_4_4_4_3_3_3_3_4_3_3_4_4_4_4_4_4_3_4_3_4_4_3_3_3
7249,160,1331705520,1,6,1,1331710020,4500,172680,1564260,1391580,16_16_16_16_0_16_0_16_1_16_1_16_16_16_16_16_16_16_1
7250,15,1331705700,7,8,1,1331707200,1500,525720,1822860,1297140,7_7_7_7_7_7_1_7
7251,15,1331707200,1,18,7,1331708520,1320,527220,1822860,1295640,7_7_7_7_7_7_1_7_1
7252,155,1331708400,5,18,5,1331728200,19800,3118200,3225180,106980,0_0_0_0_0_0_0_0_1_1_1_1_2_2_9_9_9_9_9_9_9_9_9_9_9_9_4_4_4_4_4_4_4_4_4_3_3_4_4_3_4_3_4_4_4_4_4_4_5_2_2_5_5
7253,15,1331708520,7,8,7,1331708520,0,528540,1822860,1294320,7_7_7_7_7_7_1_7_1_7
7254,15,1331708520,7,8,7,1331724060,15540,528540,1822860,1294320,7_7_7_7_7_7_1_7_1_7_7
7255,164,1331709900,16,14,1,1331724120,14220,26820,123600,96780,22_22_16
7256,160,1331710020,1,6,2,1331710980,960,177180,1564260,1387080,16_16_16_16_0_16_0_16_1_16_1_16_16_16_16_16_16_16_1_1
7257,160,1331710980,2,3,2,1331715480,4500,178140,1564260,1386120,16_16_16_16_0_16_0_16_1_16_1_16_16_16_16_16_16_16_1_1_2
7258,24,1331713560,13,15,13,1331713560,0,1465620,1547520,81900,16_16_16_16_16_16_1_1_2_2_3_3_13_13
7259,24,1331713560,13,15,13,1331719560,6000,1465620,1547520,81900,16_16_16_16_16_16_1_1_2_2_3_3_13_13_13
7260,5,1331714100,5,9,5,1331719380,5280,696300,748200,51900,10_10_10_10_10_10_10_10_10_10_1_10_10_1_1_1_10_10_10_10_10_10_10_10_1_1_2_2_9_9_5_5_5_5
7261,135,1331714160,1,9,1,1331716080,1920,5639760,5649480,9720,19_19_19_19_19_19_19_19_19_19_19_19_1_19_1_19_19_19_1_1_1_1_19_19_19_19_19_19_1_1_1_1_19_19_19_19_19_19_19_19_19_19_19_19_1_19_1_19_19_19_19_19_19_1_19_1_1_1_2_2_1_1_2_2_9_3_3_9_3_3_2_9_9_9_2_4_4_3_4_3_3_9_3_4_4_4_4_9_3_9_3_4_4_4_4_4_5_5_5_5_5_5_6_6_49_49_49_49_6_6_1
7262,213,1331714640,4,5,4,1331714760,120,2678220,3206820,528600,0_0_0_0_0_1_0_1_0_0_0_0_0_0_0_0_1_1_0_0_0_0_0_0_0_1_1_0_0_0_0_0_0_0_0_0_0_0_0_0_0_1_1_1_0_1_0_0_0_0_0_0_0_0_0_0_1_0_1_0_0_0_0_0_0_0_0_0_0_0_0_0_0_0_0_0_0_0_0_1_1_0_0_0_0_0_0_0_0_0_0_0_0_0_1_1_0_0_2_2_3_3_4_3_3_4_2_2_4_4_4_4_4_4_4_4_5_2_3_4_5_2_3_4_6_6_5_5_0_1_0_1_2_2_2_2_3_3_4_4_4_3_3_3_3_4_3_3_4_4_4_4_4_4_3_4_3_4_4_3_3_3_4
7263,213,1331714760,4,19,3,1331716560,1800,2678340,3206820,528480,0_0_0_0_0_1_0_1_0_0_0_0_0_0_0_0_1_1_0_0_0_0_0_0_0_1_1_0_0_0_0_0_0_0_0_0_0_0_0_0_0_1_1_1_0_1_0_0_0_0_0_0_0_0_0_0_1_0_1_0_0_0_0_0_0_0_0_0_0_0_0_0_0_0_0_0_0_0_0_1_1_0_0_0_0_0_0_0_0_0_0_0_0_0_1_1_0_0_2_2_3_3_4_3_3_4_2_2_4_4_4_4_4_4_4_4_5_2_3_4_5_2_3_4_6_6_5_5_0_1_0_1_2_2_2_2_3_3_4_4_4_3_3_3_3_4_3_3_4_4_4_4_4_4_3_4_3_4_4_3_3_3_4_4
7264,160,1331715480,2,3,3,1332795600,1080120,182640,1564260,1381620,16_16_16_16_0_16_0_16_1_16_1_16_16_16_16_16_16_16_1_1_2_2
7265,14,1331715540,20,1,8,1331725800,10260,136140,1327560,1191420,20_20_20_20_20_20_20_20_20_20_20_20
7266,219,1331715600,17,12,1,1331728200,12600,2432340,3797940,1365600,26_26_26_26_26_26_26_26_26_26_8_8_38_38_17_17_17_17_17_17_17
7267,135,1331716080,1,9,5,1331719380,3300,5641680,5649480,7800,19_19_19_19_19_19_19_19_19_19_19_19_1_19_1_19_19_19_1_1_1_1_19_19_19_19_19_19_1_1_1_1_19_19_19_19_19_19_19_19_19_19_19_19_1_19_1_19_19_19_19_19_19_1_19_1_1_1_2_2_1_1_2_2_9_3_3_9_3_3_2_9_9_9_2_4_4_3_4_3_3_9_3_4_4_4_4_9_3_9_3_4_4_4_4_4_5_5_5_5_5_5_6_6_49_49_49_49_6_6_1_1
7268,3,1331716200,10,16,10,1331716260,60,58980,1055580,996600,12_12_10_10_10_10_10_10_10_10_10_10_10_10
7269,204,1331716260,1,6,1,1331720760,4500,1183200,2567700,1384500,16_16_16_16_16_16_16_16_16_16_16_16_16_16_16_16_16_16_16_16_16_16_1_1_1_1_1_16_1_2_2_16_16_16_16_16_16_16_16_16_16_1_16_1_16_16_16_16_16_16_1_1_16_16_16_16_16_16_2_16_2_16_1_1_1_1_1_2_2_2_2_1_1_1_1
7270,3,1331716260,10,16,10,1331724600,8340,59040,1055580,996540,12_12_10_10_10_10_10_10_10_10_10_10_10_10_10
7271,167,1331716380,5,9,13,1331720580,4200,226080,534900,308820,19_19_19_19_1_1_19_19_19_19_19_1_19_19_1_1_1_2_2_9_3_13_9_2_2_9_3_9_13_19_13_3_3_13_5
7272,213,1331716560,3,3,4,1331719680,3120,2680140,3206820,526680,0_0_0_0_0_1_0_1_0_0_0_0_0_0_0_0_1_1_0_0_0_0_0_0_0_1_1_0_0_0_0_0_0_0_0_0_0_0_0_0_0_1_1_1_0_1_0_0_0_0_0_0_0_0_0_0_1_0_1_0_0_0_0_0_0_0_0_0_0_0_0_0_0_0_0_0_0_0_0_1_1_0_0_0_0_0_0_0_0_0_0_0_0_0_1_1_0_0_2_2_3_3_4_3_3_4_2_2_4_4_4_4_4_4_4_4_5_2_3_4_5_2_3_4_6_6_5_5_0_1_0_1_2_2_2_2_3_3_4_4_4_3_3_3_3_4_3_3_4_4_4_4_4_4_3_4_3_4_4_3_3_3_4_4_3
7273,25,1331716620,0,14,0,1331716740,120,739020,1951380,1212360,16_16_16_8_8_16_16_8_8_16_0
7274,205,1331716620,3,3,3,1331721840,5220,152220,460800,308580,1_1_2_2_3_3_3
7275,25,1331716740,0,16,0,1331721240,4500,739140,1951380,1212240,16_16_16_8_8_16_16_8_8_16_0_0
7276,5,1331719380,5,9,5,1331719440,60,701580,748200,46620,10_10_10_10_10_10_10_10_10_10_1_10_10_1_1_1_10_10_10_10_10_10_10_10_1_1_2_2_9_9_5_5_5_5_5
7277,135,1331719380,5,9,5,1331723880,4500,5644980,5649480,4500,19_19_19_19_19_19_19_19_19_19_19_19_1_19_1_19_19_19_1_1_1_1_19_19_19_19_19_19_1_1_1_1_19_19_19_19_19_19_19_19_19_19_19_19_1_19_1_19_19_19_19_19_19_1_19_1_1_1_2_2_1_1_2_2_9_3_3_9_3_3_2_9_9_9_2_4_4_3_4_3_3_9_3_4_4_4_4_9_3_9_3_4_4_4_4_4_5_5_5_5_5_5_6_6_49_49_49_49_6_6_1_1_5
7278,5,1331719440,5,9,6,1331762400,42960,701640,748200,46560,10_10_10_10_10_10_10_10_10_10_1_10_10_1_1_1_10_10_10_10_10_10_10_10_1_1_2_2_9_9_5_5_5_5_5_5
7279,24,1331719560,13,15,4,1331720520,960,1471620,1547520,75900,16_16_16_16_16_16_1_1_2_2_3_3_13_13_13_13
7280,213,1331719680,4,19,4,1331745360,25680,2683260,3206820,523560,0_0_0_0_0_1_0_1_0_0_0_0_0_0_0_0_1_1_0_0_0_0_0_0_0_1_1_0_0_0_0_0_0_0_0_0_0_0_0_0_0_1_1_1_0_1_0_0_0_0_0_0_0_0_0_0_1_0_1_0_0_0_0_0_0_0_0_0_0_0_0_0_0_0_0_0_0_0_0_1_1_0_0_0_0_0_0_0_0_0_0_0_0_0_1_1_0_0_2_2_3_3_4_3_3_4_2_2_4_4_4_4_4_4_4_4_5_2_3_4_5_2_3_4_6_6_5_5_0_1_0_1_2_2_2_2_3_3_4_4_4_3_3_3_3_4_3_3_4_4_4_4_4_4_3_4_3_4_4_3_3_3_4_4_3_4
7281,24,1331720520,4,19,4,1331733180,12660,1472580,1547520,74940,16_16_16_16_16_16_1_1_2_2_3_3_13_13_13_13_4
7282,167,1331720580,13,15,2,1331721720,1140,230280,534900,304620,19_19_19_19_1_1_19_19_19_19_19_1_19_19_1_1_1_2_2_9_3_13_9_2_2_9_3_9_13_19_13_3_3_13_5_13
7283,204,1331720760,1,6,3,1332882000,1161240,1187700,2567700,1380000,16_16_16_16_16_16_16_16_16_16_16_16_16_16_16_16_16_16_16_16_16_16_1_1_1_1_1_16_1_2_2_16_16_16_16_16_16_16_16_16_16_1_16_1_16_16_16_16_16_16_1_1_16_16_16_16_16_16_2_16_2_16_1_1_1_1_1_2_2_2_2_1_1_1_1_1
7284,25,1331721240,0,16,0,1331730660,9420,743640,1951380,1207740,16_16_16_8_8_16_16_8_8_16_0_0_0
7285,167,1331721720,2,15,1,1331721900,180,231420,534900,303480,19_19_19_19_1_1_19_19_19_19_19_1_19_19_1_1_1_2_2_9_3_13_9_2_2_9_3_9_13_19_13_3_3_13_5_13_2
7286,205,1331721840,3,3,5,1331814600,92760,157440,460800,303360,1_1_2_2_3_3_3_3
7287,167,1331721900,1,9,2,1331725200,3300,231600,534900,303300,19_19_19_19_1_1_19_19_19_19_19_1_19_19_1_1_1_2_2_9_3_13_9_2_2_9_3_9_13_19_13_3_3_13_5_13_2_1
7288,135,1331723880,5,9,99,1331723880,0,5649480,5649480,0,19_19_19_19_19_19_19_19_19_19_19_19_1_19_1_19_19_19_1_1_1_1_19_19_19_19_19_19_1_1_1_1_19_19_19_19_19_19_19_19_19_19_19_19_1_19_1_19_19_19_19_19_19_1_19_1_1_1_2_2_1_1_2_2_9_3_3_9_3_3_2_9_9_9_2_4_4_3_4_3_3_9_3_4_4_4_4_9_3_9_3_4_4_4_4_4_5_5_5_5_5_5_6_6_49_49_49_49_6_6_1_1_5_5
7289,15,1331724060,7,8,7,1331734200,10140,544080,1822860,1278780,7_7_7_7_7_7_1_7_1_7_7_7
7290,164,1331724120,1,6,16,1331731020,6900,41040,123600,82560,22_22_16_1
7291,3,1331724600,10,16,1,1331724780,180,67380,1055580,988200,12_12_10_10_10_10_10_10_10_10_10_10_10_10_10_10
7292,3,1331724780,1,9,1,1331729280,4500,67560,1055580,988020,12_12_10_10_10_10_10_10_10_10_10_10_10_10_10_10_1
7293,186,1331724960,24,8,24,1331788620,63660,2339340,3636240,1296900,7_7_7_7_7_7_7_7_7_1_7_1_7_7_7_1_7_7_1_7_7_7_7_7_7_1_7_1_1_1_38_38_1_1_24
7294,167,1331725200,2,15,1,1331726400,1200,234900,534900,300000,19_19_19_19_1_1_19_19_19_19_19_1_19_19_1_1_1_2_2_9_3_13_9_2_2_9_3_9_13_19_13_3_3_13_5_13_2_1_2
7295,14,1331725800,8,6,8,1331730300,4500,146400,1327560,1181160,20_20_20_20_20_20_20_20_20_20_20_20_8
7296,178,1331725800,10,16,10,1331733360,7560,0,904200,904200,10
7297,167,1331726400,1,9,13,1331732940,6540,236100,534900,298800,19_19_19_19_1_1_19_19_19_19_19_1_19_19_1_1_1_2_2_9_3_13_9_2_2_9_3_9_13_19_13_3_3_13_5_13_2_1_2_1
7298,155,1331728200,5,18,5,1331812800,84600,3138000,3225180,87180,0_0_0_0_0_0_0_0_1_1_1_1_2_2_9_9_9_9_9_9_9_9_9_9_9_9_4_4_4_4_4_4_4_4_4_3_3_4_4_3_4_3_4_4_4_4_4_4_5_2_2_5_5_5
7299,219,1331728200,1,18,17,1331732340,4140,2444940,3797940,1353000,26_26_26_26_26_26_26_26_26_26_8_8_38_38_17_17_17_17_17_17_17_1
7300,3,1331729280,1,9,9,1331798100,68820,72060,1055580,983520,12_12_10_10_10_10_10_10_10_10_10_10_10_10_10_10_1_1
7301,14,1331730300,8,6,0,1332407640,677340,150900,1327560,1176660,20_20_20_20_20_20_20_20_20_20_20_20_8_8
7302,25,1331730660,0,14,0,1331747760,17100,753060,1951380,1198320,16_16_16_8_8_16_16_8_8_16_0_0_0_0
7303,164,1331731020,16,14,16,1331731140,120,47940,123600,75660,22_22_16_1_16
7304,164,1331731140,16,14,1,1331731320,180,48060,123600,75540,22_22_16_1_16_16
7305,164,1331731320,1,6,16,1331732580,1260,48240,123600,75360,22_22_16_1_16_16_1
7306,219,1331732340,17,12,1,1331740620,8280,2449080,3797940,1348860,26_26_26_26_26_26_26_26_26_26_8_8_38_38_17_17_17_17_17_17_17_1_17
7307,164,1331732580,16,14,16,1331733240,660,49500,123600,74100,22_22_16_1_16_16_1_16
7308,167,1331732940,13,15,5,1331736960,4020,242640,534900,292260,19_19_19_19_1_1_19_19_19_19_19_1_19_19_1_1_1_2_2_9_3_13_9_2_2_9_3_9_13_19_13_3_3_13_5_13_2_1_2_1_13
7309,24,1331733180,4,19,4,1331733240,60,1485240,1547520,62280,16_16_16_16_16_16_1_1_2_2_3_3_13_13_13_13_4_4
7310,164,1331733240,16,20,16,1331761020,27780,50160,123600,73440,22_22_16_1_16_16_1_16_16
7311,24,1331733240,4,19,4,1331733720,480,1485300,1547520,62220,16_16_16_16_16_16_1_1_2_2_3_3_13_13_13_13_4_4_4
7312,178,1331733360,10,16,10,1331735040,1680,7560,904200,896640,10_10
7313,195,1331733480,9,3,3,1331733480,0,274200,393120,118920,0_0_54_54_0_0_0_0_0_0_0_0_1_1_9
7314,195,1331733480,3,3,2,1331733540,60,274200,393120,118920,0_0_54_54_0_0_0_0_0_0_0_0_1_1_9_3
7315,195,1331733540,2,3,5,1331737320,3780,274260,393120,118860,0_0_54_54_0_0_0_0_0_0_0_0_1_1_9_3_2
7316,188,1331733720,18,19,18,1331736300,2580,3061680,4327560,1265880,0_0_0_0_0_1_1_0_0_0_0_0_0_0_0_0_1_1_2_2_2_2_3_3_3_3_21_21_3_3_3_3_3_3_3_3_18_18_18_18_18_18_18_18_18_18_18_18_18_18_18_18
7317,24,1331733720,4,19,4,1331735460,1740,1485780,1547520,61740,16_16_16_16_16_16_1_1_2_2_3_3_13_13_13_13_4_4_4_4
7318,15,1331734200,7,10,7,1331740260,6060,554220,1822860,1268640,7_7_7_7_7_7_1_7_1_7_7_7_7
7319,178,1331735040,10,13,10,1331739120,4080,9240,904200,894960,10_10_10
7320,24,1331735460,4,23,4,1331745360,9900,1487520,1547520,60000,16_16_16_16_16_16_1_1_2_2_3_3_13_13_13_13_4_4_4_4_4
7321,188,1331736300,18,23,18,1331748420,12120,3064260,4327560,1263300,0_0_0_0_0_1_1_0_0_0_0_0_0_0_0_0_1_1_2_2_2_2_3_3_3_3_21_21_3_3_3_3_3_3_3_3_18_18_18_18_18_18_18_18_18_18_18_18_18_18_18_18_18
7322,167,1331736960,5,9,6,1331762400,25440,246660,534900,288240,19_19_19_19_1_1_19_19_19_19_19_1_19_19_1_1_1_2_2_9_3_13_9_2_2_9_3_9_13_19_13_3_3_13_5_13_2_1_2_1_13_5
7323,220,1331737200,27,26,27,1331787600,50400,1392840,2714040,1321200,0_0_0_0_1_0_1_0_0_0_0_0_1_0_0_1_0_0_0_0_0_0_0_0_0_0_0_0_0_0_0_1_1_0_1_1_1_1_0_0_1_1_2_2_2_2_2_2_2_2_27_27_27_27_27_27_27_27
7324,195,1331737320,5,9,9,1331737980,660,278040,393120,115080,0_0_54_54_0_0_0_0_0_0_0_0_1_1_9_3_2_5
7325,195,1331737980,9,3,3,1331737980,0,278700,393120,114420,0_0_54_54_0_0_0_0_0_0_0_0_1_1_9_3_2_5_9
7326,195,1331737980,3,3,2,1331738040,60,278700,393120,114420,0_0_54_54_0_0_0_0_0_0_0_0_1_1_9_3_2_5_9_3
7327,195,1331738040,2,3,5,1331740680,2640,278760,393120,114360,0_0_54_54_0_0_0_0_0_0_0_0_1_1_9_3_2_5_9_3_2
7328,178,1331739120,10,13,10,1331739180,60,13320,904200,890880,10_10_10_10
7329,178,1331739180,10,13,10,1331743920,4740,13380,904200,890820,10_10_10_10_10
7330,15,1331740260,7,10,7,1331750580,10320,560280,1822860,1262580,7_7_7_7_7_7_1_7_1_7_7_7_7_7
7331,133,1331740320,17,10,17,1331759820,19500,4949520,6181200,1231680,17_17_17_17_17_17_17_17_17_17_17_17_17_17_17_17_17_17_17_17_17_17_17_17_17_17_17_17_17_17_1_1_17_17_17_17_1_1_1_1_17_17_17_17_17_17_17_17_17_17_17_17_17_17_17_17_17_17_17_17_17_17_19_19_17_17_2_2_3_3_3_3_3_3_5_5_6_6_17
7332,219,1331740620,1,18,1,1331791440,50820,2457360,3797940,1340580,26_26_26_26_26_26_26_26_26_26_8_8_38_38_17_17_17_17_17_17_17_1_17_1
7333,195,1331740680,5,9,5,1331787480,46800,281400,393120,111720,0_0_54_54_0_0_0_0_0_0_0_0_1_1_9_3_2_5_9_3_2_5
7334,178,1331743920,10,13,10,1331743980,60,18120,904200,886080,10_10_10_10_10_10
7335,178,1331743980,10,13,10,1331751180,7200,18180,904200,886020,10_10_10_10_10_10_10
7336,24,1331745360,4,23,5,1331790960,45600,1497420,1547520,50100,16_16_16_16_16_16_1_1_2_2_3_3_13_13_13_13_4_4_4_4_4_4
7337,213,1331745360,4,23,4,1331750220,4860,2708940,3206820,497880,0_0_0_0_0_1_0_1_0_0_0_0_0_0_0_0_1_1_0_0_0_0_0_0_0_1_1_0_0_0_0_0_0_0_0_0_0_0_0_0_0_1_1_1_0_1_0_0_0_0_0_0_0_0_0_0_1_0_1_0_0_0_0_0_0_0_0_0_0_0_0_0_0_0_0_0_0_0_0_1_1_0_0_0_0_0_0_0_0_0_0_0_0_0_1_1_0_0_2_2_3_3_4_3_3_4_2_2_4_4_4_4_4_4_4_4_5_2_3_4_5_2_3_4_6_6_5_5_0_1_0_1_2_2_2_2_3_3_4_4_4_3_3_3_3_4_3_3_4_4_4_4_4_4_3_4_3_4_4_3_3_3_4_4_3_4_4
7338,25,1331747760,0,0,0,1331754900,7140,770160,1951380,1181220,16_16_16_8_8_16_16_8_8_16_0_0_0_0_0
7339,188,1331748420,18,23,1,1331748480,60,3076380,4327560,1251180,0_0_0_0_0_1_1_0_0_0_0_0_0_0_0_0_1_1_2_2_2_2_3_3_3_3_21_21_3_3_3_3_3_3_3_3_18_18_18_18_18_18_18_18_18_18_18_18_18_18_18_18_18_18
7340,188,1331748480,1,22,1,1331786700,38220,3076440,4327560,1251120,0_0_0_0_0_1_1_0_0_0_0_0_0_0_0_0_1_1_2_2_2_2_3_3_3_3_21_21_3_3_3_3_3_3_3_3_18_18_18_18_18_18_18_18_18_18_18_18_18_18_18_18_18_18_1
7341,213,1331750220,4,23,4,1331754420,4200,2713800,3206820,493020,0_0_0_0_0_1_0_1_0_0_0_0_0_0_0_0_1_1_0_0_0_0_0_0_0_1_1_0_0_0_0_0_0_0_0_0_0_0_0_0_0_1_1_1_0_1_0_0_0_0_0_0_0_0_0_0_1_0_1_0_0_0_0_0_0_0_0_0_0_0_0_0_0_0_0_0_0_0_0_1_1_0_0_0_0_0_0_0_0_0_0_0_0_0_1_1_0_0_2_2_3_3_4_3_3_4_2_2_4_4_4_4_4_4_4_4_5_2_3_4_5_2_3_4_6_6_5_5_0_1_0_1_2_2_2_2_3_3_4_4_4_3_3_3_3_4_3_3_4_4_4_4_4_4_3_4_3_4_4_3_3_3_4_4_3_4_4_4
7342,15,1331750580,7,11,7,1331786880,36300,570600,1822860,1252260,7_7_7_7_7_7_1_7_1_7_7_7_7_7_7
7343,178,1331751180,10,13,10,1331751240,60,25380,904200,878820,10_10_10_10_10_10_10_10
7344,178,1331751240,10,13,10,1331757540,6300,25440,904200,878760,10_10_10_10_10_10_10_10_10
7345,213,1331754420,4,22,4,1331786700,32280,2718000,3206820,488820,0_0_0_0_0_1_0_1_0_0_0_0_0_0_0_0_1_1_0_0_0_0_0_0_0_1_1_0_0_0_0_0_0_0_0_0_0_0_0_0_0_1_1_1_0_1_0_0_0_0_0_0_0_0_0_0_1_0_1_0_0_0_0_0_0_0_0_0_0_0_0_0_0_0_0_0_0_0_0_1_1_0_0_0_0_0_0_0_0_0_0_0_0_0_1_1_0_0_2_2_3_3_4_3_3_4_2_2_4_4_4_4_4_4_4_4_5_2_3_4_5_2_3_4_6_6_5_5_0_1_0_1_2_2_2_2_3_3_4_4_4_3_3_3_3_4_3_3_4_4_4_4_4_4_3_4_3_4_4_3_3_3_4_4_3_4_4_4_4
7346,25,1331754900,0,0,0,1331754960,60,777300,1951380,1174080,16_16_16_8_8_16_16_8_8_16_0_0_0_0_0_0
7347,25,1331754960,0,0,0,1331760720,5760,777360,1951380,1174020,16_16_16_8_8_16_16_8_8_16_0_0_0_0_0_0_0
7348,178,1331757540,10,13,10,1331771160,13620,31740,904200,872460,10_10_10_10_10_10_10_10_10_10_10
7349,178,1331757540,10,13,10,1331757540,0,31740,904200,872460,10_10_10_10_10_10_10_10_10_10
7350,133,1331759820,17,10,17,1331760540,720,4969020,6181200,1212180,17_17_17_17_17_17_17_17_17_17_17_17_17_17_17_17_17_17_17_17_17_17_17_17_17_17_17_17_17_17_1_1_17_17_17_17_1_1_1_1_17_17_17_17_17_17_17_17_17_17_17_17_17_17_17_17_17_17_17_17_17_17_19_19_17_17_2_2_3_3_3_3_3_3_5_5_6_6_17_17
7351,133,1331760540,17,11,17,1331775240,14700,4969740,6181200,1211460,17_17_17_17_17_17_17_17_17_17_17_17_17_17_17_17_17_17_17_17_17_17_17_17_17_17_17_17_17_17_1_1_17_17_17_17_1_1_1_1_17_17_17_17_17_17_17_17_17_17_17_17_17_17_17_17_17_17_17_17_17_17_19_19_17_17_2_2_3_3_3_3_3_3_5_5_6_6_17_17_17
7352,27,1331760600,0,0,0,1331769600,9000,84600,402780,318180,0_0_0
7353,25,1331760720,0,0,1,1331794800,34080,783120,1951380,1168260,16_16_16_8_8_16_16_8_8_16_0_0_0_0_0_0_0_0
7354,164,1331761020,16,20,16,1331761080,60,77940,123600,45660,22_22_16_1_16_16_1_16_16_16
7355,164,1331761080,16,0,16,1331773680,12600,78000,123600,45600,22_22_16_1_16_16_1_16_16_16_16
7356,169,1331762400,6,7,6,1331766000,3600,2100660,2190660,90000,50_50_50_50_50_50_50_50_50_50_50_50_50_50_50_50_50_1_1_50_50_50_50_1_1_50_50_50_50_50_50_50_50_1_1_50_3_3_50_2_50_2_50_50_50_6_6_3_3_50_5_2_2_2_2_5_50_50_1_1_2_2_3_3_3_3_3_3_3_3_5_3_5_3_5_5_6
7357,5,1331762400,6,7,6,1331766000,3600,744600,748200,3600,10_10_10_10_10_10_10_10_10_10_1_10_10_1_1_1_10_10_10_10_10_10_10_10_1_1_2_2_9_9_5_5_5_5_5_5_6
7358,31,1331762400,3,4,3,1331766900,4500,916380,1374660,458280,19_19_19_19_19_19_19_19_1_1_19_19_19_19_19_3_19_19_3_19_1_19_1_19_19_1_3_1_3_19_19_2_6_6_2_19_19_1_1_5_5_19_5_1_1_5_3_3_2_2_1_1_1_1_5_5_5_5_3_3_2_5_2_5_6_6_2_2_3
7359,167,1331762400,3,4,6,1331766000,3600,272100,534900,262800,19_19_19_19_1_1_19_19_19_19_19_1_19_19_1_1_1_2_2_9_3_13_9_2_2_9_3_9_13_19_13_3_3_13_5_13_2_1_2_1_13_5_6_3
7360,167,1331762400,6,7,3,1331762400,0,272100,534900,262800,19_19_19_19_1_1_19_19_19_19_19_1_19_19_1_1_1_2_2_9_3_13_9_2_2_9_3_9_13_19_13_3_3_13_5_13_2_1_2_1_13_5_6
7361,151,1331762400,6,7,6,1331766000,3600,3640200,3643800,3600,19_19_19_19_19_1_1_19_1_1_19_19_19_19_1_19_1_19_19_19_19_19_19_19_19_19_1_19_19_1_1_1_1_1_19_19_19_19_19_19_1_1_19_19_1_1_19_1_1_19_19_19_19_19_19_19_19_19_19_19_19_19_19_19_1_1_47_47_3_3_3_3_2_3_3_2_3_3_3_3_3_3_4_4_4_4_4_4_4_4_4_4_4_4_4_4_4_4_4_5_4_4_5_4_4_4_4_6_6_6_6_4_5_5_6_6_5_5_6_6_6
7362,169,1331766000,6,7,6,1331848800,82800,2104260,2190660,86400,50_50_50_50_50_50_50_50_50_50_50_50_50_50_50_50_50_1_1_50_50_50_50_1_1_50_50_50_50_50_50_50_50_1_1_50_3_3_50_2_50_2_50_50_50_6_6_3_3_50_5_2_2_2_2_5_50_50_1_1_2_2_3_3_3_3_3_3_3_3_5_3_5_3_5_5_6_6
7363,5,1331766000,6,7,99,1331766000,0,748200,748200,0,10_10_10_10_10_10_10_10_10_10_1_10_10_1_1_1_10_10_10_10_10_10_10_10_1_1_2_2_9_9_5_5_5_5_5_5_6_6
7364,167,1331766000,6,7,3,1331766900,900,275700,534900,259200,19_19_19_19_1_1_19_19_19_19_19_1_19_19_1_1_1_2_2_9_3_13_9_2_2_9_3_9_13_19_13_3_3_13_5_13_2_1_2_1_13_5_6_3_6
7365,151,1331766000,6,7,99,1331766000,0,3643800,3643800,0,19_19_19_19_19_1_1_19_1_1_19_19_19_19_1_19_1_19_19_19_19_19_19_19_19_19_1_19_19_1_1_1_1_1_19_19_19_19_19_19_1_1_19_19_1_1_19_1_1_19_19_19_19_19_19_19_19_19_19_19_19_19_19_19_1_1_47_47_3_3_3_3_2_3_3_2_3_3_3_3_3_3_4_4_4_4_4_4_4_4_4_4_4_4_4_4_4_4_4_5_4_4_5_4_4_4_4_6_6_6_6_4_5_5_6_6_5_5_6_6_6_6
7366,31,1331766900,3,4,3,1331810820,43920,920880,1374660,453780,19_19_19_19_19_19_19_19_1_1_19_19_19_19_19_3_19_19_3_19_1_19_1_19_19_1_3_1_3_19_19_2_6_6_2_19_19_1_1_5_5_19_5_1_1_5_3_3_2_2_1_1_1_1_5_5_5_5_3_3_2_5_2_5_6_6_2_2_3_3
7367,167,1331766900,3,4,13,1331787960,21060,276600,534900,258300,19_19_19_19_1_1_19_19_19_19_19_1_19_19_1_1_1_2_2_9_3_13_9_2_2_9_3_9_13_19_13_3_3_13_5_13_2_1_2_1_13_5_6_3_6_3
7368,27,1331769600,0,0,0,1331785800,16200,93600,402780,309180,0_0_0_0_0
7369,27,1331769600,0,0,0,1331769600,0,93600,402780,309180,0_0_0_0
7370,178,1331771160,10,13,10,1331787600,16440,45360,904200,858840,10_10_10_10_10_10_10_10_10_10_10_10
7371,164,1331773680,16,0,1,1331792100,18420,90600,123600,33000,22_22_16_1_16_16_1_16_16_16_16_16
7372,16,1331773740,22,0,22,1331786940,13200,0,117000,117000,22
7373,133,1331775240,17,11,3,1332709200,933960,4984440,6181200,1196760,17_17_17_17_17_17_17_17_17_17_17_17_17_17_17_17_17_17_17_17_17_17_17_17_17_17_17_17_17_17_1_1_17_17_17_17_1_1_1_1_17_17_17_17_17_17_17_17_17_17_17_17_17_17_17_17_17_17_17_17_17_17_19_19_17_17_2_2_3_3_3_3_3_3_5_5_6_6_17_17_17_17
7374,27,1331785800,0,0,0,1331789460,3660,109800,402780,292980,0_0_0_0_0_0
7375,41,1331786580,15,6,15,1331790300,3720,0,3720,3720,15
7376,213,1331786700,4,22,4,1331787120,420,2750280,3206820,456540,0_0_0_0_0_1_0_1_0_0_0_0_0_0_0_0_1_1_0_0_0_0_0_0_0_1_1_0_0_0_0_0_0_0_0_0_0_0_0_0_0_1_1_1_0_1_0_0_0_0_0_0_0_0_0_0_1_0_1_0_0_0_0_0_0_0_0_0_0_0_0_0_0_0_0_0_0_0_0_1_1_0_0_0_0_0_0_0_0_0_0_0_0_0_1_1_0_0_2_2_3_3_4_3_3_4_2_2_4_4_4_4_4_4_4_4_5_2_3_4_5_2_3_4_6_6_5_5_0_1_0_1_2_2_2_2_3_3_4_4_4_3_3_3_3_4_3_3_4_4_4_4_4_4_3_4_3_4_4_3_3_3_4_4_3_4_4_4_4_4
7377,188,1331786700,1,22,18,1331787180,480,3114660,4327560,1212900,0_0_0_0_0_1_1_0_0_0_0_0_0_0_0_0_1_1_2_2_2_2_3_3_3_3_21_21_3_3_3_3_3_3_3_3_18_18_18_18_18_18_18_18_18_18_18_18_18_18_18_18_18_18_1_1
7378,15,1331786880,7,11,7,1331792520,5640,606900,1822860,1215960,7_7_7_7_7_7_1_7_1_7_7_7_7_7_7_7
7379,16,1331786940,22,0,16,1331787960,1020,13200,117000,103800,22_22
7380,213,1331787120,4,5,4,1331795640,8520,2750700,3206820,456120,0_0_0_0_0_1_0_1_0_0_0_0_0_0_0_0_1_1_0_0_0_0_0_0_0_1_1_0_0_0_0_0_0_0_0_0_0_0_0_0_0_1_1_1_0_1_0_0_0_0_0_0_0_0_0_0_1_0_1_0_0_0_0_0_0_0_0_0_0_0_0_0_0_0_0_0_0_0_0_1_1_0_0_0_0_0_0_0_0_0_0_0_0_0_1_1_0_0_2_2_3_3_4_3_3_4_2_2_4_4_4_4_4_4_4_4_5_2_3_4_5_2_3_4_6_6_5_5_0_1_0_1_2_2_2_2_3_3_4_4_4_3_3_3_3_4_3_3_4_4_4_4_4_4_3_4_3_4_4_3_3_3_4_4_3_4_4_4_4_4_4
7381,188,1331787180,18,19,18,1331821020,33840,3115140,4327560,1212420,0_0_0_0_0_1_1_0_0_0_0_0_0_0_0_0_1_1_2_2_2_2_3_3_3_3_21_21_3_3_3_3_3_3_3_3_18_18_18_18_18_18_18_18_18_18_18_18_18_18_18_18_18_18_1_1_18
7382,195,1331787480,5,9,5,1331797560,10080,328200,393120,64920,0_0_54_54_0_0_0_0_0_0_0_0_1_1_9_3_2_5_9_3_2_5_5
7383,178,1331787600,1,18,10,1331791200,3600,61800,904200,842400,10_10_10_10_10_10_10_10_10_10_10_10_10_1
7384,178,1331787600,10,16,1,1331787600,0,61800,904200,842400,10_10_10_10_10_10_10_10_10_10_10_10_10
7385,220,1331787600,27,26,27,1331823600,36000,1443240,2714040,1270800,0_0_0_0_1_0_1_0_0_0_0_0_1_0_0_1_0_0_0_0_0_0_0_0_0_0_0_0_0_0_0_1_1_0_1_1_1_1_0_0_1_1_2_2_2_2_2_2_2_2_27_27_27_27_27_27_27_27_27
7386,16,1331787960,16,14,16,1331819760,31800,14220,117000,102780,22_22_16
7387,167,1331787960,13,15,9,1331792760,4800,297660,534900,237240,19_19_19_19_1_1_19_19_19_19_19_1_19_19_1_1_1_2_2_9_3_13_9_2_2_9_3_9_13_19_13_3_3_13_5_13_2_1_2_1_13_5_6_3_6_3_13
7388,186,1331788620,24,8,24,1331788680,60,2403000,3636240,1233240,7_7_7_7_7_7_7_7_7_1_7_1_7_7_7_1_7_7_1_7_7_7_7_7_7_1_7_1_1_1_38_38_1_1_24_24
7389,186,1331788680,24,8,24,1331792460,3780,2403060,3636240,1233180,7_7_7_7_7_7_7_7_7_1_7_1_7_7_7_1_7_7_1_7_7_7_7_7_7_1_7_1_1_1_38_38_1_1_24_24_24
7390,27,1331789460,0,1,0,1331794260,4800,113460,402780,289320,0_0_0_0_0_0_0
7391,41,1331790300,15,6,99,1331790300,0,3720,3720,0,15_15
7392,24,1331790960,5,6,5,1331795460,4500,1543020,1547520,4500,16_16_16_16_16_16_1_1_2_2_3_3_13_13_13_13_4_4_4_4_4_4_5
7393,178,1331791200,10,16,1,1331791200,0,65400,904200,838800,10_10_10_10_10_10_10_10_10_10_10_10_10_1_10
7394,178,1331791200,1,18,10,1331791200,0,65400,904200,838800,10_10_10_10_10_10_10_10_10_10_10_10_10_1_10_1
7395,178,1331791200,10,16,10,1331803800,12600,65400,904200,838800,10_10_10_10_10_10_10_10_10_10_10_10_10_1_10_1_10
7396,219,1331791440,1,18,1,1331812800,21360,2508180,3797940,1289760,26_26_26_26_26_26_26_26_26_26_8_8_38_38_17_17_17_17_17_17_17_1_17_1_1
7397,164,1331792100,1,6,1,1331795760,3660,109020,123600,14580,22_22_16_1_16_16_1_16_16_16_16_16_1
7398,186,1331792460,24,8,24,1332054900,262440,2406840,3636240,1229400,7_7_7_7_7_7_7_7_7_1_7_1_7_7_7_1_7_7_1_7_7_7_7_7_7_1_7_1_1_1_38_38_1_1_24_24_24_24
7399,15,1331792520,7,8,7,1331797380,4860,612540,1822860,1210320,7_7_7_7_7_7_1_7_1_7_7_7_7_7_7_7_7
7400,167,1331792760,9,3,9,1331798040,5280,302460,534900,232440,19_19_19_19_1_1_19_19_19_19_19_1_19_19_1_1_1_2_2_9_3_13_9_2_2_9_3_9_13_19_13_3_3_13_5_13_2_1_2_1_13_5_6_3_6_3_13_9
7401,27,1331794260,0,1,0,1331800740,6480,118260,402780,284520,0_0_0_0_0_0_0_0
7402,25,1331794800,1,6,1,1331797080,2280,817200,1951380,1134180,16_16_16_8_8_16_16_8_8_16_0_0_0_0_0_0_0_0_1
7403,24,1331795460,5,6,99,1331795460,0,1547520,1547520,0,16_16_16_16_16_16_1_1_2_2_3_3_13_13_13_13_4_4_4_4_4_4_5_5
7404,213,1331795640,4,5,6,1332194400,398760,2759220,3206820,447600,0_0_0_0_0_1_0_1_0_0_0_0_0_0_0_0_1_1_0_0_0_0_0_0_0_1_1_0_0_0_0_0_0_0_0_0_0_0_0_0_0_1_1_1_0_1_0_0_0_0_0_0_0_0_0_0_1_0_1_0_0_0_0_0_0_0_0_0_0_0_0_0_0_0_0_0_0_0_0_1_1_0_0_0_0_0_0_0_0_0_0_0_0_0_1_1_0_0_2_2_3_3_4_3_3_4_2_2_4_4_4_4_4_4_4_4_5_2_3_4_5_2_3_4_6_6_5_5_0_1_0_1_2_2_2_2_3_3_4_4_4_3_3_3_3_4_3_3_4_4_4_4_4_4_3_4_3_4_4_3_3_3_4_4_3_4_4_4_4_4_4_4
7405,164,1331795760,1,6,2,1331801700,5940,112680,123600,10920,22_22_16_1_16_16_1_16_16_16_16_16_1_1
7406,25,1331797080,1,6,2,1331889300,92220,819480,1951380,1131900,16_16_16_8_8_16_16_8_8_16_0_0_0_0_0_0_0_0_1_1
7407,15,1331797380,7,8,7,1331797440,60,617400,1822860,1205460,7_7_7_7_7_7_1_7_1_7_7_7_7_7_7_7_7_7
7408,15,1331797440,7,8,7,1331824920,27480,617460,1822860,1205400,7_7_7_7_7_7_1_7_1_7_7_7_7_7_7_7_7_7_7
7409,195,1331797560,5,9,6,1331848800,51240,338280,393120,54840,0_0_54_54_0_0_0_0_0_0_0_0_1_1_9_3_2_5_9_3_2_5_5_5
7410,167,1331798040,9,3,3,1331798040,0,307740,534900,227160,19_19_19_19_1_1_19_19_19_19_19_1_19_19_1_1_1_2_2_9_3_13_9_2_2_9_3_9_13_19_13_3_3_13_5_13_2_1_2_1_13_5_6_3_6_3_13_9_9
7411,167,1331798040,3,3,3,1331798100,60,307740,534900,227160,19_19_19_19_1_1_19_19_19_19_19_1_19_19_1_1_1_2_2_9_3_13_9_2_2_9_3_9_13_19_13_3_3_13_5_13_2_1_2_1_13_5_6_3_6_3_13_9_9_3
7412,3,1331798100,9,3,9,1331801700,3600,140880,1055580,914700,12_12_10_10_10_10_10_10_10_10_10_10_10_10_10_10_1_1_9
7413,167,1331798100,3,3,13,1331818920,20820,307800,534900,227100,19_19_19_19_1_1_19_19_19_19_19_1_19_19_1_1_1_2_2_9_3_13_9_2_2_9_3_9_13_19_13_3_3_13_5_13_2_1_2_1_13_5_6_3_6_3_13_9_9_3_3
7414,197,1331798580,17,12,17,1331807160,8580,0,626580,626580,17
7415,8,1331799240,10,16,10,1331819040,19800,0,615060,615060,10
7416,27,1331800740,0,1,0,1331826960,26220,124740,402780,278040,0_0_0_0_0_0_0_0_0
7417,3,1331801700,9,3,3,1332493200,691500,144480,1055580,911100,12_12_10_10_10_10_10_10_10_10_10_10_10_10_10_10_1_1_9_9
7418,164,1331801700,2,3,2,1331801760,60,118620,123600,4980,22_22_16_1_16_16_1_16_16_16_16_16_1_1_2
7419,164,1331801760,2,3,1,1331802120,360,118680,123600,4920,22_22_16_1_16_16_1_16_16_16_16_16_1_1_2_2
7420,164,1331802120,1,6,2,1331802180,60,119040,123600,4560,22_22_16_1_16_16_1_16_16_16_16_16_1_1_2_2_1
7421,164,1331802180,2,3,1,1331806620,4440,119100,123600,4500,22_22_16_1_16_16_1_16_16_16_16_16_1_1_2_2_1_2
7422,11,1331802300,2,3,2,1331803560,1260,949860,1777560,827700,0_0_0_0_1_0_0_0_1_0_0_1_1_0_1_1_2
7423,75,1331803140,5,6,5,1331812860,9720,5694600,6135000,440400,16_16_16_16_16_16_1_16_16_1_16_16_16_16_16_16_16_16_1_1_2_2_39_39_1_1_3_3_3_3_3_3_3_3_3_3_2_3_3_2_18_18_18_18_18_18_18_18_18_18_18_18_18_18_18_18_18_18_5
7424,11,1331803560,2,3,18,1332298980,495420,951120,1777560,826440,0_0_0_0_1_0_0_0_1_0_0_1_1_0_1_1_2_2
7425,178,1331803800,10,16,1,1331810400,6600,78000,904200,826200,10_10_10_10_10_10_10_10_10_10_10_10_10_1_10_1_10_10
7426,174,1331805480,2,3,2,1331806980,1500,1226340,1300440,74100,10_1_10_1_10_10_19_19_1_1_9_9_1_1_2
7427,164,1331806620,1,6,2,1331806680,60,123540,123600,60,22_22_16_1_16_16_1_16_16_16_16_16_1_1_2_2_1_2_1
7428,164,1331806680,2,3,99,1331806680,0,123600,123600,0,22_22_16_1_16_16_1_16_16_16_16_16_1_1_2_2_1_2_1_2
7429,174,1331806980,2,3,3,1331814660,7680,1227840,1300440,72600,10_1_10_1_10_10_19_19_1_1_9_9_1_1_2_2
7430,197,1331807160,17,12,17,1331818980,11820,8580,626580,618000,17_17_17
7431,197,1331807160,17,12,17,1331807160,0,8580,626580,618000,17_17
7432,178,1331810400,1,18,1,1331811060,660,84600,904200,819600,10_10_10_10_10_10_10_10_10_10_10_10_10_1_10_1_10_10_1
7433,31,1331810820,3,4,3,1331812740,1920,964800,1374660,409860,19_19_19_19_19_19_19_19_1_1_19_19_19_19_19_3_19_19_3_19_1_19_1_19_19_1_3_1_3_19_19_2_6_6_2_19_19_1_1_5_5_19_5_1_1_5_3_3_2_2_1_1_1_1_5_5_5_5_3_3_2_5_2_5_6_6_2_2_3_3_3
7434,178,1331811060,1,18,1,1331877600,66540,85260,904200,818940,10_10_10_10_10_10_10_10_10_10_10_10_10_1_10_1_10_10_1_1
7435,31,1331812740,3,4,5,1332158760,346020,966720,1374660,407940,19_19_19_19_19_19_19_19_1_1_19_19_19_19_19_3_19_19_3_19_1_19_1_19_19_1_3_1_3_19_19_2_6_6_2_19_19_1_1_5_5_19_5_1_1_5_3_3_2_2_1_1_1_1_5_5_5_5_3_3_2_5_2_5_6_6_2_2_3_3_3_3
7436,172,1331812800,2,4,2,1331812980,180,885960,1443960,558000,10_10_10_1_10_10_1_10_10_10_10_10_1_1_2
7437,219,1331812800,1,18,17,1331820540,7740,2529540,3797940,1268400,26_26_26_26_26_26_26_26_26_26_8_8_38_38_17_17_17_17_17_17_17_1_17_1_1_1
7438,155,1331812800,5,18,5,1331815380,2580,3222600,3225180,2580,0_0_0_0_0_0_0_0_1_1_1_1_2_2_9_9_9_9_9_9_9_9_9_9_9_9_4_4_4_4_4_4_4_4_4_3_3_4_4_3_4_3_4_4_4_4_4_4_5_2_2_5_5_5_5
7439,75,1331812860,5,6,6,1331848800,35940,5704320,6135000,430680,16_16_16_16_16_16_1_16_16_1_16_16_16_16_16_16_16_16_1_1_2_2_39_39_1_1_3_3_3_3_3_3_3_3_3_3_2_3_3_2_18_18_18_18_18_18_18_18_18_18_18_18_18_18_18_18_18_18_5_5
7440,172,1331812980,2,4,9,1331890800,77820,886140,1443960,557820,10_10_10_1_10_10_1_10_10_10_10_10_1_1_2_2
7441,205,1331814600,5,18,5,1331819820,5220,250200,460800,210600,1_1_2_2_3_3_3_3_5
7442,174,1331814660,3,3,3,1331819160,4500,1235520,1300440,64920,10_1_10_1_10_10_19_19_1_1_9_9_1_1_2_2_3
7443,155,1331815380,5,18,99,1331815380,0,3225180,3225180,0,0_0_0_0_0_0_0_0_1_1_1_1_2_2_9_9_9_9_9_9_9_9_9_9_9_9_4_4_4_4_4_4_4_4_4_3_3_4_4_3_4_3_4_4_4_4_4_4_5_2_2_5_5_5_5_5
7444,167,1331818920,13,15,13,1331873700,54780,328620,534900,206280,19_19_19_19_1_1_19_19_19_19_19_1_19_19_1_1_1_2_2_9_3_13_9_2_2_9_3_9_13_19_13_3_3_13_5_13_2_1_2_1_13_5_6_3_6_3_13_9_9_3_3_13
7445,197,1331818980,17,12,6,1332367200,548220,20400,626580,606180,17_17_17_17
7446,8,1331819040,10,16,10,1331823300,4260,19800,615060,595260,10_10
7447,174,1331819160,3,3,6,1331848800,29640,1240020,1300440,60420,10_1_10_1_10_10_19_19_1_1_9_9_1_1_2_2_3_3
7448,16,1331819760,16,14,1,1331874180,54420,46020,117000,70980,22_22_16_16
7449,205,1331819820,5,18,6,1332021600,201780,255420,460800,205380,1_1_2_2_3_3_3_3_5_5
7450,219,1331820540,17,10,17,1331846820,26280,2537280,3797940,1260660,26_26_26_26_26_26_26_26_26_26_8_8_38_38_17_17_17_17_17_17_17_1_17_1_1_1_17
7451,188,1331821020,18,23,18,1331821080,60,3148980,4327560,1178580,0_0_0_0_0_1_1_0_0_0_0_0_0_0_0_0_1_1_2_2_2_2_3_3_3_3_21_21_3_3_3_3_3_3_3_3_18_18_18_18_18_18_18_18_18_18_18_18_18_18_18_18_18_18_1_1_18_18
7452,188,1331821080,18,19,18,1331847840,26760,3149040,4327560,1178520,0_0_0_0_0_1_1_0_0_0_0_0_0_0_0_0_1_1_2_2_2_2_3_3_3_3_21_21_3_3_3_3_3_3_3_3_18_18_18_18_18_18_18_18_18_18_18_18_18_18_18_18_18_18_1_1_18_18_18
7453,189,1331821740,16,20,16,1331848740,27000,0,308460,308460,16
7454,8,1331823300,10,13,10,1331836680,13380,24060,615060,591000,10_10_10
7455,220,1331823600,27,26,27,1331874000,50400,1479240,2714040,1234800,0_0_0_0_1_0_1_0_0_0_0_0_1_0_0_1_0_0_0_0_0_0_0_0_0_0_0_0_0_0_0_1_1_0_1_1_1_1_0_0_1_1_2_2_2_2_2_2_2_2_27_27_27_27_27_27_27_27_27_27
7456,15,1331824920,7,8,7,1331838240,13320,644940,1822860,1177920,7_7_7_7_7_7_1_7_1_7_7_7_7_7_7_7_7_7_7_7
7457,27,1331826960,0,1,0,1331833740,6780,150960,402780,251820,0_0_0_0_0_0_0_0_0_0
7458,27,1331833740,0,0,0,1331854020,20280,157740,402780,245040,0_0_0_0_0_0_0_0_0_0_0
7459,8,1331836680,10,13,1,1332133200,296520,37440,615060,577620,10_10_10_10
7460,15,1331838240,7,11,7,1331873220,34980,658260,1822860,1164600,7_7_7_7_7_7_1_7_1_7_7_7_7_7_7_7_7_7_7_7_7
7461,185,1331842980,26,13,26,1331849400,6420,0,441420,441420,26
7462,13,1331845800,19,11,19,1331873220,27420,1279260,2525940,1246680,19_19_19_1_1_19_19_19_19_19_19_19_19_19_19_19_1_1_1_19_1_19_19_19_19_19_19_19_19_19_19_1_19_1_19_19_19_19_19_19_1_1_1_1_19_19_19_19_1_1_1_1_1_1_19
7463,219,1331846820,17,10,1,1331881740,34920,2563560,3797940,1234380,26_26_26_26_26_26_26_26_26_26_8_8_38_38_17_17_17_17_17_17_17_1_17_1_1_1_17_17
7464,188,1331847840,18,23,1,1331847900,60,3175800,4327560,1151760,0_0_0_0_0_1_1_0_0_0_0_0_0_0_0_0_1_1_2_2_2_2_3_3_3_3_21_21_3_3_3_3_3_3_3_3_18_18_18_18_18_18_18_18_18_18_18_18_18_18_18_18_18_18_1_1_18_18_18_18
7465,188,1331847900,1,22,1,1331859780,11880,3175860,4327560,1151700,0_0_0_0_0_1_1_0_0_0_0_0_0_0_0_0_1_1_2_2_2_2_3_3_3_3_21_21_3_3_3_3_3_3_3_3_18_18_18_18_18_18_18_18_18_18_18_18_18_18_18_18_18_18_1_1_18_18_18_18_1
7466,189,1331848740,16,20,16,1331850000,1260,27000,308460,281460,16_16
7467,174,1331848800,6,7,6,1331852400,3600,1269660,1300440,30780,10_1_10_1_10_10_19_19_1_1_9_9_1_1_2_2_3_3_6
7468,195,1331848800,6,7,6,1331852400,3600,389520,393120,3600,0_0_54_54_0_0_0_0_0_0_0_0_1_1_9_3_2_5_9_3_2_5_5_5_6
7469,169,1331848800,6,7,6,1331852400,3600,2187060,2190660,3600,50_50_50_50_50_50_50_50_50_50_50_50_50_50_50_50_50_1_1_50_50_50_50_1_1_50_50_50_50_50_50_50_50_1_1_50_3_3_50_2_50_2_50_50_50_6_6_3_3_50_5_2_2_2_2_5_50_50_1_1_2_2_3_3_3_3_3_3_3_3_5_3_5_3_5_5_6_6_6
7470,157,1331848800,6,7,6,1331852400,3600,1960620,1993260,32640,19_19_1_19_1_19_19_19_19_19_19_19_1_1_1_1_9_9_1_1_2_2_3_3_18_18_18_18_18_18_6_6
7471,157,1331848800,6,7,6,1331848800,0,1960620,1993260,32640,19_19_1_19_1_19_19_19_19_19_19_19_1_1_1_1_9_9_1_1_2_2_3_3_18_18_18_18_18_18_6
7472,75,1331848800,6,7,6,1331852400,3600,5740260,6135000,394740,16_16_16_16_16_16_1_16_16_1_16_16_16_16_16_16_16_16_1_1_2_2_39_39_1_1_3_3_3_3_3_3_3_3_3_3_2_3_3_2_18_18_18_18_18_18_18_18_18_18_18_18_18_18_18_18_18_18_5_5_6
7473,185,1331849400,26,13,3,1331874000,24600,6420,441420,435000,26_26
7474,189,1331850000,16,0,16,1331874000,24000,28260,308460,280200,16_16_16
7475,157,1331852400,6,7,5,1331876940,24540,1964220,1993260,29040,19_19_1_19_1_19_19_19_19_19_19_19_1_1_1_1_9_9_1_1_2_2_3_3_18_18_18_18_18_18_6_6_6_6
7476,174,1331852400,6,7,5,1331877600,25200,1273260,1300440,27180,10_1_10_1_10_10_19_19_1_1_9_9_1_1_2_2_3_3_6_6
7477,157,1331852400,6,7,6,1331852400,0,1964220,1993260,29040,19_19_1_19_1_19_19_19_19_19_19_19_1_1_1_1_9_9_1_1_2_2_3_3_18_18_18_18_18_18_6_6_6
7478,195,1331852400,6,7,99,1331852400,0,393120,393120,0,0_0_54_54_0_0_0_0_0_0_0_0_1_1_9_3_2_5_9_3_2_5_5_5_6_6
7479,75,1331852400,6,7,6,1332021600,169200,5743860,6135000,391140,16_16_16_16_16_16_1_16_16_1_16_16_16_16_16_16_16_16_1_1_2_2_39_39_1_1_3_3_3_3_3_3_3_3_3_3_2_3_3_2_18_18_18_18_18_18_18_18_18_18_18_18_18_18_18_18_18_18_5_5_6_6
7480,169,1331852400,6,7,99,1331852400,0,2190660,2190660,0,50_50_50_50_50_50_50_50_50_50_50_50_50_50_50_50_50_1_1_50_50_50_50_1_1_50_50_50_50_50_50_50_50_1_1_50_3_3_50_2_50_2_50_50_50_6_6_3_3_50_5_2_2_2_2_5_50_50_1_1_2_2_3_3_3_3_3_3_3_3_5_3_5_3_5_5_6_6_6_6
7481,27,1331854020,0,0,0,1331854080,60,178020,402780,224760,0_0_0_0_0_0_0_0_0_0_0_0
7482,27,1331854080,0,0,0,1331861400,7320,178080,402780,224700,0_0_0_0_0_0_0_0_0_0_0_0_0
7483,188,1331859780,1,22,18,1331874240,14460,3187740,4327560,1139820,0_0_0_0_0_1_1_0_0_0_0_0_0_0_0_0_1_1_2_2_2_2_3_3_3_3_21_21_3_3_3_3_3_3_3_3_18_18_18_18_18_18_18_18_18_18_18_18_18_18_18_18_18_18_1_1_18_18_18_18_1_1
7484,27,1331861400,0,0,0,1331861460,60,185400,402780,217380,0_0_0_0_0_0_0_0_0_0_0_0_0_0
7485,27,1331861460,0,0,0,1331866020,4560,185460,402780,217320,0_0_0_0_0_0_0_0_0_0_0_0_0_0_0
7486,27,1331866020,0,0,0,1331874600,8580,190020,402780,212760,0_0_0_0_0_0_0_0_0_0_0_0_0_0_0_0
7487,13,1331873220,19,11,1,1331873880,660,1306680,2525940,1219260,19_19_19_1_1_19_19_19_19_19_19_19_19_19_19_19_1_1_1_19_1_19_19_19_19_19_19_19_19_19_19_1_19_1_19_19_19_19_19_19_1_1_1_1_19_19_19_19_1_1_1_1_1_1_19_19
7488,15,1331873220,7,11,7,1332033480,160260,693240,1822860,1129620,7_7_7_7_7_7_1_7_1_7_7_7_7_7_7_7_7_7_7_7_7_7
7489,167,1331873700,13,15,13,1331882340,8640,383400,534900,151500,19_19_19_19_1_1_19_19_19_19_19_1_19_19_1_1_1_2_2_9_3_13_9_2_2_9_3_9_13_19_13_3_3_13_5_13_2_1_2_1_13_5_6_3_6_3_13_9_9_3_3_13_13
7490,13,1331873880,1,9,19,1331874780,900,1307340,2525940,1218600,19_19_19_1_1_19_19_19_19_19_19_19_19_19_19_19_1_1_1_19_1_19_19_19_19_19_19_19_19_19_19_1_19_1_19_19_19_19_19_19_1_1_1_1_19_19_19_19_1_1_1_1_1_1_19_19_1
7491,185,1331874000,3,3,3,1331875200,1200,31020,441420,410400,26_26_3
7492,189,1331874000,16,0,16,1331874600,600,52260,308460,256200,16_16_16_16
7493,220,1331874000,27,27,27,1331893800,19800,1529640,2714040,1184400,0_0_0_0_1_0_1_0_0_0_0_0_1_0_0_1_0_0_0_0_0_0_0_0_0_0_0_0_0_0_0_1_1_0_1_1_1_1_0_0_1_1_2_2_2_2_2_2_2_2_27_27_27_27_27_27_27_27_27_27_27
7494,16,1331874180,1,6,1,1331888640,14460,100440,117000,16560,22_22_16_16_1
7495,188,1331874240,18,19,3,1331878440,4200,3202200,4327560,1125360,0_0_0_0_0_1_1_0_0_0_0_0_0_0_0_0_1_1_2_2_2_2_3_3_3_3_21_21_3_3_3_3_3_3_3_3_18_18_18_18_18_18_18_18_18_18_18_18_18_18_18_18_18_18_1_1_18_18_18_18_1_1_18
7496,189,1331874600,16,14,16,1331894940,20340,52860,308460,255600,16_16_16_16_16
7497,27,1331874600,0,1,0,1331874720,120,198600,402780,204180,0_0_0_0_0_0_0_0_0_0_0_0_0_0_0_0_0
7498,27,1331874720,0,1,0,1331874720,0,198720,402780,204060,0_0_0_0_0_0_0_0_0_0_0_0_0_0_0_0_0_0
7499,27,1331874720,0,1,1,1331879460,4740,198720,402780,204060,0_0_0_0_0_0_0_0_0_0_0_0_0_0_0_0_0_0_0
7500,13,1331874780,19,14,1,1331879520,4740,1308240,2525940,1217700,19_19_19_1_1_19_19_19_19_19_19_19_19_19_19_19_1_1_1_19_1_19_19_19_19_19_19_19_19_19_19_1_19_1_19_19_19_19_19_19_1_1_1_1_19_19_19_19_1_1_1_1_1_1_19_19_1_19
7501,185,1331875200,3,3,26,1331884380,9180,32220,441420,409200,26_26_3_3
7502,157,1331876940,5,9,5,1331881440,4500,1988760,1993260,4500,19_19_1_19_1_19_19_19_19_19_19_19_1_1_1_1_9_9_1_1_2_2_3_3_18_18_18_18_18_18_6_6_6_6_5
7503,174,1331877600,5,9,5,1331879580,1980,1298460,1300440,1980,10_1_10_1_10_10_19_19_1_1_9_9_1_1_2_2_3_3_6_6_5
7504,178,1331877600,1,18,1,1331881680,4080,151800,904200,752400,10_10_10_10_10_10_10_10_10_10_10_10_10_1_10_1_10_10_1_1_1
7505,188,1331878440,3,3,18,1331884320,5880,3206400,4327560,1121160,0_0_0_0_0_1_1_0_0_0_0_0_0_0_0_0_1_1_2_2_2_2_3_3_3_3_21_21_3_3_3_3_3_3_3_3_18_18_18_18_18_18_18_18_18_18_18_18_18_18_18_18_18_18_1_1_18_18_18_18_1_1_18_3
7506,27,1331879460,1,6,1,1331883120,3660,203460,402780,199320,0_0_0_0_0_0_0_0_0_0_0_0_0_0_0_0_0_0_0_1
7507,13,1331879520,1,9,19,1331894940,15420,1312980,2525940,1212960,19_19_19_1_1_19_19_19_19_19_19_19_19_19_19_19_1_1_1_19_1_19_19_19_19_19_19_19_19_19_19_1_19_1_19_19_19_19_19_19_1_1_1_1_19_19_19_19_1_1_1_1_1_1_19_19_1_19_1
7508,174,1331879580,5,9,99,1331879580,0,1300440,1300440,0,10_1_10_1_10_10_19_19_1_1_9_9_1_1_2_2_3_3_6_6_5_5
7509,157,1331881440,5,9,99,1331881440,0,1993260,1993260,0,19_19_1_19_1_19_19_19_19_19_19_19_1_1_1_1_9_9_1_1_2_2_3_3_18_18_18_18_18_18_6_6_6_6_5_5
7510,178,1331881680,1,18,2,1332142740,261060,155880,904200,748320,10_10_10_10_10_10_10_10_10_10_10_10_10_1_10_1_10_10_1_1_1_1
7511,219,1331881740,1,18,1,1331894700,12960,2598480,3797940,1199460,26_26_26_26_26_26_26_26_26_26_8_8_38_38_17_17_17_17_17_17_17_1_17_1_1_1_17_17_1
7512,167,1331882340,13,15,5,1331885640,3300,392040,534900,142860,19_19_19_19_1_1_19_19_19_19_19_1_19_19_1_1_1_2_2_9_3_13_9_2_2_9_3_9_13_19_13_3_3_13_5_13_2_1_2_1_13_5_6_3_6_3_13_9_9_3_3_13_13_13
7513,187,1331882400,11,15,11,1331891100,8700,2231580,2496960,265380,10_10_10_10_10_10_10_10_10_10_10_10_1_1_1_1_2_9_2_9_3_3_4_4_4_4_11
7514,176,1331882640,3,3,2,1331887140,4500,1201740,1462860,261120,19_19_19_19_19_19_19_19_1_1_2_3_3
7515,176,1331882640,3,3,3,1331882640,0,1201740,1462860,261120,19_19_19_19_19_19_19_19_1_1_2_3
7516,176,1331882640,2,3,3,1331882640,0,1201740,1462860,261120,19_19_19_19_19_19_19_19_1_1_2
7517,27,1331883120,1,6,0,1331894880,11760,207120,402780,195660,0_0_0_0_0_0_0_0_0_0_0_0_0_0_0_0_0_0_0_1_1
7518,76,1331883240,5,6,5,1331895060,11820,6341640,7552500,1210860,3_3_3_3_3_3_3_3_3_18_3_18_18_18_18_18_3_3_3_1_1_3_17_17_17_18_17_17_18_18_18_18_18_17_17_18_3_3_18_17_18_18_17_18_18_17_17_17_5_5_5_5_1_1_17_17_17_2_2_17_17_17_5_5_5_5_5_5_17_17_5_5_5_17_5_5_5_5_5_17_17_17_1_1_1_1_1_1_1_1_2_2_34_34_5_5_5_5_6_6_3_3_4_3_3_4_4_4_4_4_3_3_3_3_3_3_4_3_3_3_3_4_4_4_3_4_4_4_3_4_4_4_3_3_4_4_4_4_5_3_3_5_5_5_5_5_4_5_4_5_4_3_3_3_3_4_3_3_4_4_5_5_5_4_5_5_5_4_6_6_34_34_5
7519,188,1331884320,18,19,18,1331884380,60,3212280,4327560,1115280,0_0_0_0_0_1_1_0_0_0_0_0_0_0_0_0_1_1_2_2_2_2_3_3_3_3_21_21_3_3_3_3_3_3_3_3_18_18_18_18_18_18_18_18_18_18_18_18_18_18_18_18_18_18_1_1_18_18_18_18_1_1_18_3_18
7520,188,1331884380,18,19,3,1331890740,6360,3212340,4327560,1115220,0_0_0_0_0_1_1_0_0_0_0_0_0_0_0_0_1_1_2_2_2_2_3_3_3_3_21_21_3_3_3_3_3_3_3_3_18_18_18_18_18_18_18_18_18_18_18_18_18_18_18_18_18_18_1_1_18_18_18_18_1_1_18_3_18_18
7521,185,1331884380,26,16,26,1331893800,9420,41400,441420,400020,26_26_3_3_26
7522,167,1331885640,5,9,5,1331891520,5880,395340,534900,139560,19_19_19_19_1_1_19_19_19_19_19_1_19_19_1_1_1_2_2_9_3_13_9_2_2_9_3_9_13_19_13_3_3_13_5_13_2_1_2_1_13_5_6_3_6_3_13_9_9_3_3_13_13_13_5
7523,176,1331887140,2,3,6,1332108000,220860,1206240,1462860,256620,19_19_19_19_19_19_19_19_1_1_2_3_3_2
7524,64,1331888460,1,9,1,1331888520,60,5788380,6845160,1056780,1_1_11_11_5_5_1_1_6_6_1
7525,64,1331888520,1,9,19,1332194400,305880,5788440,6845160,1056720,1_1_11_11_5_5_1_1_6_6_1_1
7526,16,1331888640,1,6,2,1331889300,660,114900,117000,2100,22_22_16_16_1_1
7527,16,1331889300,2,3,2,1331890740,1440,115560,117000,1440,22_22_16_16_1_1_2
7528,25,1331889300,2,3,2,1331890740,1440,911700,1951380,1039680,16_16_16_8_8_16_16_8_8_16_0_0_0_0_0_0_0_0_1_1_2
7529,2,1331890200,11,15,11,1331894400,4200,2139660,2555640,415980,10_10_10_10_10_10_10_10_1_1_2_2_9_9_3_3_4_4_4_4_11
7530,25,1331890740,2,3,25,1332051360,160620,913140,1951380,1038240,16_16_16_8_8_16_16_8_8_16_0_0_0_0_0_0_0_0_1_1_2_2
7531,16,1331890740,2,3,99,1331890740,0,117000,117000,0,22_22_16_16_1_1_2_2
7532,188,1331890740,3,3,18,1331893020,2280,3218700,4327560,1108860,0_0_0_0_0_1_1_0_0_0_0_0_0_0_0_0_1_1_2_2_2_2_3_3_3_3_21_21_3_3_3_3_3_3_3_3_18_18_18_18_18_18_18_18_18_18_18_18_18_18_18_18_18_18_1_1_18_18_18_18_1_1_18_3_18_18_3
7533,172,1331890800,9,3,9,1331893560,2760,963960,1443960,480000,10_10_10_1_10_10_1_10_10_10_10_10_1_1_2_2_9
7534,187,1331891100,11,15,6,1332108000,216900,2240280,2496960,256680,10_10_10_10_10_10_10_10_10_10_10_10_1_1_1_1_2_9_2_9_3_3_4_4_4_4_11_11
7535,167,1331891520,5,9,18,1331891580,60,401220,534900,133680,19_19_19_19_1_1_19_19_19_19_19_1_19_19_1_1_1_2_2_9_3_13_9_2_2_9_3_9_13_19_13_3_3_13_5_13_2_1_2_1_13_5_6_3_6_3_13_9_9_3_3_13_13_13_5_5
7536,167,1331891580,18,9,18,1331891700,120,401280,534900,133620,19_19_19_19_1_1_19_19_19_19_19_1_19_19_1_1_1_2_2_9_3_13_9_2_2_9_3_9_13_19_13_3_3_13_5_13_2_1_2_1_13_5_6_3_6_3_13_9_9_3_3_13_13_13_5_5_18
7537,167,1331891700,18,9,6,1332021600,129900,401400,534900,133500,19_19_19_19_1_1_19_19_19_19_19_1_19_19_1_1_1_2_2_9_3_13_9_2_2_9_3_9_13_19_13_3_3_13_5_13_2_1_2_1_13_5_6_3_6_3_13_9_9_3_3_13_13_13_5_5_18_18
7538,188,1331893020,18,19,18,1332015240,122220,3220980,4327560,1106580,0_0_0_0_0_1_1_0_0_0_0_0_0_0_0_0_1_1_2_2_2_2_3_3_3_3_21_21_3_3_3_3_3_3_3_3_18_18_18_18_18_18_18_18_18_18_18_18_18_18_18_18_18_18_1_1_18_18_18_18_1_1_18_3_18_18_3_18
7539,172,1331893560,9,3,3,1331893560,0,966720,1443960,477240,10_10_10_1_10_10_1_10_10_10_10_10_1_1_2_2_9_9
7540,172,1331893560,3,3,3,1331898060,4500,966720,1443960,477240,10_10_10_1_10_10_1_10_10_10_10_10_1_1_2_2_9_9_3
7541,220,1331893800,27,27,27,1332046800,153000,1549440,2714040,1164600,0_0_0_0_1_0_1_0_0_0_0_0_1_0_0_1_0_0_0_0_0_0_0_0_0_0_0_0_0_0_0_1_1_0_1_1_1_1_0_0_1_1_2_2_2_2_2_2_2_2_27_27_27_27_27_27_27_27_27_27_27_27
7542,185,1331893800,26,16,8,1332046800,153000,50820,441420,390600,26_26_3_3_26_26
7543,2,1331894400,11,15,5,1332148860,254460,2143860,2555640,411780,10_10_10_10_10_10_10_10_1_1_2_2_9_9_3_3_4_4_4_4_11_11
7544,219,1331894700,1,18,17,1332020580,125880,2611440,3797940,1186500,26_26_26_26_26_26_26_26_26_26_8_8_38_38_17_17_17_17_17_17_17_1_17_1_1_1_17_17_1_1
7545,27,1331894880,0,1,0,1331983320,88440,218880,402780,183900,0_0_0_0_0_0_0_0_0_0_0_0_0_0_0_0_0_0_0_1_1_0
7546,189,1331894940,16,14,16,1331965380,70440,73200,308460,235260,16_16_16_16_16_16
7547,13,1331894940,19,14,19,1331983440,88500,1328400,2525940,1197540,19_19_19_1_1_19_19_19_19_19_19_19_19_19_19_19_1_1_1_19_1_19_19_19_19_19_19_19_19_19_19_1_19_1_19_19_19_19_19_19_1_1_1_1_19_19_19_19_1_1_1_1_1_1_19_19_1_19_1_19
7548,76,1331895060,5,6,34,1332058680,163620,6353460,7552500,1199040,3_3_3_3_3_3_3_3_3_18_3_18_18_18_18_18_3_3_3_1_1_3_17_17_17_18_17_17_18_18_18_18_18_17_17_18_3_3_18_17_18_18_17_18_18_17_17_17_5_5_5_5_1_1_17_17_17_2_2_17_17_17_5_5_5_5_5_5_17_17_5_5_5_17_5_5_5_5_5_17_17_17_1_1_1_1_1_1_1_1_2_2_34_34_5_5_5_5_6_6_3_3_4_3_3_4_4_4_4_4_3_3_3_3_3_3_4_3_3_3_3_4_4_4_3_4_4_4_3_4_4_4_3_3_4_4_4_4_5_3_3_5_5_5_5_5_4_5_4_5_4_3_3_3_3_4_3_3_4_4_5_5_5_4_5_5_5_4_6_6_34_34_5_5
7549,172,1331898060,3,3,18,1332291600,393540,971220,1443960,472740,10_10_10_1_10_10_1_10_10_10_10_10_1_1_2_2_9_9_3_3
7550,189,1331965380,16,0,16,1331989200,23820,143640,308460,164820,16_16_16_16_16_16_16
7551,27,1331983320,0,0,0,1332024960,41640,307320,402780,95460,0_0_0_0_0_0_0_0_0_0_0_0_0_0_0_0_0_0_0_1_1_0_0
7552,13,1331983440,19,0,19,1332021240,37800,1416900,2525940,1109040,19_19_19_1_1_19_19_19_19_19_19_19_19_19_19_19_1_1_1_19_1_19_19_19_19_19_19_19_19_19_19_1_19_1_19_19_19_19_19_19_1_1_1_1_19_19_19_19_1_1_1_1_1_1_19_19_1_19_1_19_19
7553,189,1331989200,16,0,16,1332069720,80520,167460,308460,141000,16_16_16_16_16_16_16_16
7554,188,1332015240,18,5,18,1332046320,31080,3343200,4327560,984360,0_0_0_0_0_1_1_0_0_0_0_0_0_0_0_0_1_1_2_2_2_2_3_3_3_3_21_21_3_3_3_3_3_3_3_3_18_18_18_18_18_18_18_18_18_18_18_18_18_18_18_18_18_18_1_1_18_18_18_18_1_1_18_3_18_18_3_18_18
7555,219,1332020580,17,12,17,1332046200,25620,2737320,3797940,1060620,26_26_26_26_26_26_26_26_26_26_8_8_38_38_17_17_17_17_17_17_17_1_17_1_1_1_17_17_1_1_17
7556,13,1332021240,19,12,19,1332030360,9120,1454700,2525940,1071240,19_19_19_1_1_19_19_19_19_19_19_19_19_19_19_19_1_1_1_19_1_19_19_19_19_19_19_19_19_19_19_1_19_1_19_19_19_19_19_19_1_1_1_1_19_19_19_19_1_1_1_1_1_1_19_19_1_19_1_19_19_19
7557,131,1332021600,6,7,6,1332025200,3600,5761500,6825900,1064400,16_16_16_16_16_16_16_16_16_16_16_16_16_16_16_16_16_16_16_16_16_16_16_16_16_16_1_1_1_1_2_2_3_3_3_3_18_18_18_18_18_3_3_3_3_18_18_18_18_18_18_18_18_18_18_18_18_18_18_18_18_18_18_18_5_5_5_5_5_5_5_5_5_5_5_5_6_6_5_5_6_6_5_5_5_5_5_5_5_5_5_5_6_6_5_5_34_34_34_34_3_3_18_18_18_18_18_18_6
7558,75,1332021600,6,7,6,1332025200,3600,5913060,6135000,221940,16_16_16_16_16_16_1_16_16_1_16_16_16_16_16_16_16_16_1_1_2_2_39_39_1_1_3_3_3_3_3_3_3_3_3_3_2_3_3_2_18_18_18_18_18_18_18_18_18_18_18_18_18_18_18_18_18_18_5_5_6_6_6
7559,167,1332021600,6,7,6,1332025200,3600,531300,534900,3600,19_19_19_19_1_1_19_19_19_19_19_1_19_19_1_1_1_2_2_9_3_13_9_2_2_9_3_9_13_19_13_3_3_13_5_13_2_1_2_1_13_5_6_3_6_3_13_9_9_3_3_13_13_13_5_5_18_18_6
7560,98,1332021600,6,7,6,1332025200,3600,6282180,7319880,1037700,34_34_2_2_35_35_34_34_2_2_3_3_3_3_3_3_18_18_3_3_3_18_3_3_3_18_18_18_18_3_3_18_18_18_18_18_18_18_18_3_3_18_39_3_3_39_3_3_3_3_4_4_5_5_5_5_5_5_4_4_4_5_3_5_5_3_5_4_4_4_5_5_5_5_6_6_6_6_5_5_5_5_5_5_5_5_5_5_5_5_6_6_5_5_34_34_6_6_5_5_5_5_5_5_5_5_5_5_5_5_2_2_5_18_5_18_18_18_6_6_5_5_5_5_5_5_6_6_34_34_34_34_35_35_6
7561,205,1332021600,6,7,6,1332025200,3600,457200,460800,3600,1_1_2_2_3_3_3_3_5_5_6
7562,27,1332024960,0,12,0,1332025020,60,348960,402780,53820,0_0_0_0_0_0_0_0_0_0_0_0_0_0_0_0_0_0_0_1_1_0_0_0
7563,27,1332025020,0,12,0,1332025020,0,349020,402780,53760,0_0_0_0_0_0_0_0_0_0_0_0_0_0_0_0_0_0_0_1_1_0_0_0_0
7564,27,1332025020,0,12,0,1332030360,5340,349020,402780,53760,0_0_0_0_0_0_0_0_0_0_0_0_0_0_0_0_0_0_0_1_1_0_0_0_0_0
7565,98,1332025200,6,7,5,1332061200,36000,6285780,7319880,1034100,34_34_2_2_35_35_34_34_2_2_3_3_3_3_3_3_18_18_3_3_3_18_3_3_3_18_18_18_18_3_3_18_18_18_18_18_18_18_18_3_3_18_39_3_3_39_3_3_3_3_4_4_5_5_5_5_5_5_4_4_4_5_3_5_5_3_5_4_4_4_5_5_5_5_6_6_6_6_5_5_5_5_5_5_5_5_5_5_5_5_6_6_5_5_34_34_6_6_5_5_5_5_5_5_5_5_5_5_5_5_2_2_5_18_5_18_18_18_6_6_5_5_5_5_5_5_6_6_34_34_34_34_35_35_6_6
7566,167,1332025200,6,7,99,1332025200,0,534900,534900,0,19_19_19_19_1_1_19_19_19_19_19_1_19_19_1_1_1_2_2_9_3_13_9_2_2_9_3_9_13_19_13_3_3_13_5_13_2_1_2_1_13_5_6_3_6_3_13_9_9_3_3_13_13_13_5_5_18_18_6_6
7567,131,1332025200,6,7,5,1332046800,21600,5765100,6825900,1060800,16_16_16_16_16_16_16_16_16_16_16_16_16_16_16_16_16_16_16_16_16_16_16_16_16_16_1_1_1_1_2_2_3_3_3_3_18_18_18_18_18_3_3_3_3_18_18_18_18_18_18_18_18_18_18_18_18_18_18_18_18_18_18_18_5_5_5_5_5_5_5_5_5_5_5_5_6_6_5_5_6_6_5_5_5_5_5_5_5_5_5_5_6_6_5_5_34_34_34_34_3_3_18_18_18_18_18_18_6_6
7568,75,1332025200,6,7,5,1332058140,32940,5916660,6135000,218340,16_16_16_16_16_16_1_16_16_1_16_16_16_16_16_16_16_16_1_1_2_2_39_39_1_1_3_3_3_3_3_3_3_3_3_3_2_3_3_2_18_18_18_18_18_18_18_18_18_18_18_18_18_18_18_18_18_18_5_5_6_6_6_6
7569,205,1332025200,6,7,99,1332025200,0,460800,460800,0,1_1_2_2_3_3_3_3_5_5_6_6
7570,27,1332030360,0,12,0,1332046500,16140,354360,402780,48420,0_0_0_0_0_0_0_0_0_0_0_0_0_0_0_0_0_0_0_1_1_0_0_0_0_0_0
7571,13,1332030360,19,12,19,1332063000,32640,1463820,2525940,1062120,19_19_19_1_1_19_19_19_19_19_19_19_19_19_19_19_1_1_1_19_1_19_19_19_19_19_19_19_19_19_19_1_19_1_19_19_19_19_19_19_1_1_1_1_19_19_19_19_1_1_1_1_1_1_19_19_1_19_1_19_19_19_19
7572,15,1332033480,7,12,7,1332046200,12720,853500,1822860,969360,7_7_7_7_7_7_1_7_1_7_7_7_7_7_7_7_7_7_7_7_7_7_7
7573,15,1332046200,7,12,1,1332064800,18600,866220,1822860,956640,7_7_7_7_7_7_1_7_1_7_7_7_7_7_7_7_7_7_7_7_7_7_7_7
7574,219,1332046200,17,12,1,1332050400,4200,2762940,3797940,1035000,26_26_26_26_26_26_26_26_26_26_8_8_38_38_17_17_17_17_17_17_17_1_17_1_1_1_17_17_1_1_17_17
7575,188,1332046320,18,5,18,1332058860,12540,3374280,4327560,953280,0_0_0_0_0_1_1_0_0_0_0_0_0_0_0_0_1_1_2_2_2_2_3_3_3_3_21_21_3_3_3_3_3_3_3_3_18_18_18_18_18_18_18_18_18_18_18_18_18_18_18_18_18_18_1_1_18_18_18_18_1_1_18_3_18_18_3_18_18_18
7576,27,1332046500,0,0,1,1332046800,300,370500,402780,32280,0_0_0_0_0_0_0_0_0_0_0_0_0_0_0_0_0_0_0_1_1_0_0_0_0_0_0_0
7577,131,1332046800,5,2,5,1332050400,3600,5786700,6825900,1039200,16_16_16_16_16_16_16_16_16_16_16_16_16_16_16_16_16_16_16_16_16_16_16_16_16_16_1_1_1_1_2_2_3_3_3_3_18_18_18_18_18_3_3_3_3_18_18_18_18_18_18_18_18_18_18_18_18_18_18_18_18_18_18_18_5_5_5_5_5_5_5_5_5_5_5_5_6_6_5_5_6_6_5_5_5_5_5_5_5_5_5_5_6_6_5_5_34_34_34_34_3_3_18_18_18_18_18_18_6_6_5
7578,27,1332046800,1,6,0,1332047580,780,370800,402780,31980,0_0_0_0_0_0_0_0_0_0_0_0_0_0_0_0_0_0_0_1_1_0_0_0_0_0_0_0_1
7579,185,1332046800,8,18,26,1332046860,60,203820,441420,237600,26_26_3_3_26_26_8
7580,220,1332046800,27,26,27,1332090000,43200,1702440,2714040,1011600,0_0_0_0_1_0_1_0_0_0_0_0_1_0_0_1_0_0_0_0_0_0_0_0_0_0_0_0_0_0_0_1_1_0_1_1_1_1_0_0_1_1_2_2_2_2_2_2_2_2_27_27_27_27_27_27_27_27_27_27_27_27_27
7581,185,1332046860,26,13,8,1332050400,3540,203880,441420,237540,26_26_3_3_26_26_8_26
7582,27,1332047580,0,0,0,1332055140,7560,371580,402780,31200,0_0_0_0_0_0_0_0_0_0_0_0_0_0_0_0_0_0_0_1_1_0_0_0_0_0_0_0_1_0
7583,219,1332050400,1,18,17,1332054360,3960,2767140,3797940,1030800,26_26_26_26_26_26_26_26_26_26_8_8_38_38_17_17_17_17_17_17_17_1_17_1_1_1_17_17_1_1_17_17_1
7584,185,1332050400,8,18,26,1332052740,2340,207420,441420,234000,26_26_3_3_26_26_8_26_8
7585,131,1332050400,5,2,34,1332064560,14160,5790300,6825900,1035600,16_16_16_16_16_16_16_16_16_16_16_16_16_16_16_16_16_16_16_16_16_16_16_16_16_16_1_1_1_1_2_2_3_3_3_3_18_18_18_18_18_3_3_3_3_18_18_18_18_18_18_18_18_18_18_18_18_18_18_18_18_18_18_18_5_5_5_5_5_5_5_5_5_5_5_5_6_6_5_5_6_6_5_5_5_5_5_5_5_5_5_5_6_6_5_5_34_34_34_34_3_3_18_18_18_18_18_18_6_6_5_5
7586,141,1332050400,5,2,5,1332052800,2400,6397200,7406100,1008900,1_1_16_16_16_16_16_1_16_16_1_1_1_16_16_16_16_16_16_16_16_16_16_16_16_16_16_16_1_1_1_1_1_1_1_1_1_1_1_1_16_2_2_16_3_3_3_3_3_3_18_18_18_18_18_3_18_3_3_3_5_5_5_5_5_5_3_3_4_4_4_4_4_3_1_3_1_4_18_3_3_18_18_1_1_18_18_5_5_18_5_5_5_5_6_6_5_5_6_6_6_6_5_5_5_5_5_5_5_5_6_6_5_5_5_5_5_5_5_5_5_5_5_5_34_34_34_34_5
7587,25,1332051360,25,3,25,1332051420,60,1073760,1951380,877620,16_16_16_8_8_16_16_8_8_16_0_0_0_0_0_0_0_0_1_1_2_2_25
7588,25,1332051420,25,3,9,1332051540,120,1073820,1951380,877560,16_16_16_8_8_16_16_8_8_16_0_0_0_0_0_0_0_0_1_1_2_2_25_25
7589,25,1332051540,9,3,9,1332057120,5580,1073940,1951380,877440,16_16_16_8_8_16_16_8_8_16_0_0_0_0_0_0_0_0_1_1_2_2_25_25_9
7590,185,1332052740,26,13,26,1332082260,29520,209760,441420,231660,26_26_3_3_26_26_8_26_8_26
7591,141,1332052800,5,2,5,1332054000,1200,6399600,7406100,1006500,1_1_16_16_16_16_16_1_16_16_1_1_1_16_16_16_16_16_16_16_16_16_16_16_16_16_16_16_1_1_1_1_1_1_1_1_1_1_1_1_16_2_2_16_3_3_3_3_3_3_18_18_18_18_18_3_18_3_3_3_5_5_5_5_5_5_3_3_4_4_4_4_4_3_1_3_1_4_18_3_3_18_18_1_1_18_18_5_5_18_5_5_5_5_6_6_5_5_6_6_6_6_5_5_5_5_5_5_5_5_6_6_5_5_5_5_5_5_5_5_5_5_5_5_34_34_34_34_5_5
7592,141,1332054000,5,2,5,1332061200,7200,6400800,7406100,1005300,1_1_16_16_16_16_16_1_16_16_1_1_1_16_16_16_16_16_16_16_16_16_16_16_16_16_16_16_1_1_1_1_1_1_1_1_1_1_1_1_16_2_2_16_3_3_3_3_3_3_18_18_18_18_18_3_18_3_3_3_5_5_5_5_5_5_3_3_4_4_4_4_4_3_1_3_1_4_18_3_3_18_18_1_1_18_18_5_5_18_5_5_5_5_6_6_5_5_6_6_6_6_5_5_5_5_5_5_5_5_6_6_5_5_5_5_5_5_5_5_5_5_5_5_34_34_34_34_5_5_5
7593,219,1332054360,17,10,1,1332064800,10440,2771100,3797940,1026840,26_26_26_26_26_26_26_26_26_26_8_8_38_38_17_17_17_17_17_17_17_1_17_1_1_1_17_17_1_1_17_17_1_17
7594,186,1332054900,24,8,8,1332075600,20700,2669280,3636240,966960,7_7_7_7_7_7_7_7_7_1_7_1_7_7_7_1_7_7_1_7_7_7_7_7_7_1_7_1_1_1_38_38_1_1_24_24_24_24_24
7595,27,1332055140,0,0,0,1332055200,60,379140,402780,23640,0_0_0_0_0_0_0_0_0_0_0_0_0_0_0_0_0_0_0_1_1_0_0_0_0_0_0_0_1_0_0
7596,27,1332055200,0,0,0,1332055260,60,379200,402780,23580,0_0_0_0_0_0_0_0_0_0_0_0_0_0_0_0_0_0_0_1_1_0_0_0_0_0_0_0_1_0_0_0_0
7597,27,1332055200,0,0,0,1332055200,0,379200,402780,23580,0_0_0_0_0_0_0_0_0_0_0_0_0_0_0_0_0_0_0_1_1_0_0_0_0_0_0_0_1_0_0_0
7598,27,1332055260,0,0,1,1332056460,1200,379260,402780,23520,0_0_0_0_0_0_0_0_0_0_0_0_0_0_0_0_0_0_0_1_1_0_0_0_0_0_0_0_1_0_0_0_0_0
7599,179,1332055440,0,20,0,1332079800,24360,0,345960,345960,0
7600,27,1332056460,1,6,0,1332063000,6540,380460,402780,22320,0_0_0_0_0_0_0_0_0_0_0_0_0_0_0_0_0_0_0_1_1_0_0_0_0_0_0_0_1_0_0_0_0_0_1
7601,183,1332056820,19,11,19,1332078840,22020,0,445560,445560,19
7602,25,1332057120,9,3,3,1332057120,0,1079520,1951380,871860,16_16_16_8_8_16_16_8_8_16_0_0_0_0_0_0_0_0_1_1_2_2_25_25_9_9
7603,25,1332057120,3,3,3,1332063780,6660,1079520,1951380,871860,16_16_16_8_8_16_16_8_8_16_0_0_0_0_0_0_0_0_1_1_2_2_25_25_9_9_3
7604,75,1332058140,5,6,5,1332065460,7320,5949600,6135000,185400,16_16_16_16_16_16_1_16_16_1_16_16_16_16_16_16_16_16_1_1_2_2_39_39_1_1_3_3_3_3_3_3_3_3_3_3_2_3_3_2_18_18_18_18_18_18_18_18_18_18_18_18_18_18_18_18_18_18_5_5_6_6_6_6_5
7605,76,1332058680,34,17,34,1332062640,3960,6517080,7552500,1035420,3_3_3_3_3_3_3_3_3_18_3_18_18_18_18_18_3_3_3_1_1_3_17_17_17_18_17_17_18_18_18_18_18_17_17_18_3_3_18_17_18_18_17_18_18_17_17_17_5_5_5_5_1_1_17_17_17_2_2_17_17_17_5_5_5_5_5_5_17_17_5_5_5_17_5_5_5_5_5_17_17_17_1_1_1_1_1_1_1_1_2_2_34_34_5_5_5_5_6_6_3_3_4_3_3_4_4_4_4_4_3_3_3_3_3_3_4_3_3_3_3_4_4_4_3_4_4_4_3_4_4_4_3_3_4_4_4_4_5_3_3_5_5_5_5_5_4_5_4_5_4_3_3_3_3_4_3_3_4_4_5_5_5_4_5_5_5_4_6_6_34_34_5_5_34
7606,188,1332058860,18,23,18,1332078780,19920,3386820,4327560,940740,0_0_0_0_0_1_1_0_0_0_0_0_0_0_0_0_1_1_2_2_2_2_3_3_3_3_21_21_3_3_3_3_3_3_3_3_18_18_18_18_18_18_18_18_18_18_18_18_18_18_18_18_18_18_1_1_18_18_18_18_1_1_18_3_18_18_3_18_18_18_18
7607,98,1332061200,5,2,5,1332067800,6600,6321780,7319880,998100,34_34_2_2_35_35_34_34_2_2_3_3_3_3_3_3_18_18_3_3_3_18_3_3_3_18_18_18_18_3_3_18_18_18_18_18_18_18_18_3_3_18_39_3_3_39_3_3_3_3_4_4_5_5_5_5_5_5_4_4_4_5_3_5_5_3_5_4_4_4_5_5_5_5_6_6_6_6_5_5_5_5_5_5_5_5_5_5_5_5_6_6_5_5_34_34_6_6_5_5_5_5_5_5_5_5_5_5_5_5_2_2_5_18_5_18_18_18_6_6_5_5_5_5_5_5_6_6_34_34_34_34_35_35_6_6_5
7608,141,1332061200,5,2,34,1332062640,1440,6408000,7406100,998100,1_1_16_16_16_16_16_1_16_16_1_1_1_16_16_16_16_16_16_16_16_16_16_16_16_16_16_16_1_1_1_1_1_1_1_1_1_1_1_1_16_2_2_16_3_3_3_3_3_3_18_18_18_18_18_3_18_3_3_3_5_5_5_5_5_5_3_3_4_4_4_4_4_3_1_3_1_4_18_3_3_18_18_1_1_18_18_5_5_18_5_5_5_5_6_6_5_5_6_6_6_6_5_5_5_5_5_5_5_5_6_6_5_5_5_5_5_5_5_5_5_5_5_5_34_34_34_34_5_5_5_5
7609,76,1332062640,34,17,34,1332080160,17520,6521040,7552500,1031460,3_3_3_3_3_3_3_3_3_18_3_18_18_18_18_18_3_3_3_1_1_3_17_17_17_18_17_17_18_18_18_18_18_17_17_18_3_3_18_17_18_18_17_18_18_17_17_17_5_5_5_5_1_1_17_17_17_2_2_17_17_17_5_5_5_5_5_5_17_17_5_5_5_17_5_5_5_5_5_17_17_17_1_1_1_1_1_1_1_1_2_2_34_34_5_5_5_5_6_6_3_3_4_3_3_4_4_4_4_4_3_3_3_3_3_3_4_3_3_3_3_4_4_4_3_4_4_4_3_4_4_4_3_3_4_4_4_4_5_3_3_5_5_5_5_5_4_5_4_5_4_3_3_3_3_4_3_3_4_4_5_5_5_4_5_5_5_4_6_6_34_34_5_5_34_34
7610,141,1332062640,34,17,34,1332064560,1920,6409440,7406100,996660,1_1_16_16_16_16_16_1_16_16_1_1_1_16_16_16_16_16_16_16_16_16_16_16_16_16_16_16_1_1_1_1_1_1_1_1_1_1_1_1_16_2_2_16_3_3_3_3_3_3_18_18_18_18_18_3_18_3_3_3_5_5_5_5_5_5_3_3_4_4_4_4_4_3_1_3_1_4_18_3_3_18_18_1_1_18_18_5_5_18_5_5_5_5_6_6_5_5_6_6_6_6_5_5_5_5_5_5_5_5_6_6_5_5_5_5_5_5_5_5_5_5_5_5_34_34_34_34_5_5_5_5_34
7611,27,1332063000,0,0,2,1332075780,12780,387000,402780,15780,0_0_0_0_0_0_0_0_0_0_0_0_0_0_0_0_0_0_0_1_1_0_0_0_0_0_0_0_1_0_0_0_0_0_1_0
7612,13,1332063000,19,0,2,1332152940,89940,1496460,2525940,1029480,19_19_19_1_1_19_19_19_19_19_19_19_19_19_19_19_1_1_1_19_1_19_19_19_19_19_19_19_19_19_19_1_19_1_19_19_19_19_19_19_1_1_1_1_19_19_19_19_1_1_1_1_1_1_19_19_1_19_1_19_19_19_19_19
7613,25,1332063780,3,3,4,1332136980,73200,1086180,1951380,865200,16_16_16_8_8_16_16_8_8_16_0_0_0_0_0_0_0_0_1_1_2_2_25_25_9_9_3_3
7614,141,1332064560,34,17,6,1332108000,43440,6411360,7406100,994740,1_1_16_16_16_16_16_1_16_16_1_1_1_16_16_16_16_16_16_16_16_16_16_16_16_16_16_16_1_1_1_1_1_1_1_1_1_1_1_1_16_2_2_16_3_3_3_3_3_3_18_18_18_18_18_3_18_3_3_3_5_5_5_5_5_5_3_3_4_4_4_4_4_3_1_3_1_4_18_3_3_18_18_1_1_18_18_5_5_18_5_5_5_5_6_6_5_5_6_6_6_6_5_5_5_5_5_5_5_5_6_6_5_5_5_5_5_5_5_5_5_5_5_5_34_34_34_34_5_5_5_5_34_34
7615,131,1332064560,34,17,34,1332077460,12900,5804460,6825900,1021440,16_16_16_16_16_16_16_16_16_16_16_16_16_16_16_16_16_16_16_16_16_16_16_16_16_16_1_1_1_1_2_2_3_3_3_3_18_18_18_18_18_3_3_3_3_18_18_18_18_18_18_18_18_18_18_18_18_18_18_18_18_18_18_18_5_5_5_5_5_5_5_5_5_5_5_5_6_6_5_5_6_6_5_5_5_5_5_5_5_5_5_5_6_6_5_5_34_34_34_34_3_3_18_18_18_18_18_18_6_6_5_5_34
7616,219,1332064800,1,18,17,1332077940,13140,2781540,3797940,1016400,26_26_26_26_26_26_26_26_26_26_8_8_38_38_17_17_17_17_17_17_17_1_17_1_1_1_17_17_1_1_17_17_1_17_1
7617,15,1332064800,1,18,1,1332064800,0,884820,1822860,938040,7_7_7_7_7_7_1_7_1_7_7_7_7_7_7_7_7_7_7_7_7_7_7_7_1
7618,15,1332064800,1,18,1,1332066780,1980,884820,1822860,938040,7_7_7_7_7_7_1_7_1_7_7_7_7_7_7_7_7_7_7_7_7_7_7_7_1_1
7619,221,1332064800,1,18,1,1332071580,6780,0,934800,934800,1
7620,75,1332065460,5,6,34,1332134400,68940,5956920,6135000,178080,16_16_16_16_16_16_1_16_16_1_16_16_16_16_16_16_16_16_1_1_2_2_39_39_1_1_3_3_3_3_3_3_3_3_3_3_2_3_3_2_18_18_18_18_18_18_18_18_18_18_18_18_18_18_18_18_18_18_5_5_6_6_6_6_5_5
7621,15,1332066780,1,18,2,1332067320,540,886800,1822860,936060,7_7_7_7_7_7_1_7_1_7_7_7_7_7_7_7_7_7_7_7_7_7_7_7_1_1_1_1
7622,15,1332066780,1,18,1,1332066780,0,886800,1822860,936060,7_7_7_7_7_7_1_7_1_7_7_7_7_7_7_7_7_7_7_7_7_7_7_7_1_1_1
7623,15,1332067320,2,21,2,1332075300,7980,887340,1822860,935520,7_7_7_7_7_7_1_7_1_7_7_7_7_7_7_7_7_7_7_7_7_7_7_7_1_1_1_1_2
7624,98,1332067800,5,2,5,1332156000,88200,6328380,7319880,991500,34_34_2_2_35_35_34_34_2_2_3_3_3_3_3_3_18_18_3_3_3_18_3_3_3_18_18_18_18_3_3_18_18_18_18_18_18_18_18_3_3_18_39_3_3_39_3_3_3_3_4_4_5_5_5_5_5_5_4_4_4_5_3_5_5_3_5_4_4_4_5_5_5_5_6_6_6_6_5_5_5_5_5_5_5_5_5_5_5_5_6_6_5_5_34_34_6_6_5_5_5_5_5_5_5_5_5_5_5_5_2_2_5_18_5_18_18_18_6_6_5_5_5_5_5_5_6_6_34_34_34_34_35_35_6_6_5_5
7625,63,1332069600,5,2,34,1332079320,9720,5218140,6232860,1014720,16_16_16_16_16_16_16_16_16_0_0_16_16_0_16_16_0_16_16_0_0_16_16_16_0_0_16_0_0_16_0_16_0_0_0_16_1_1_1_16_16_16_0_1_1_1_16_0_0_16_16_0_16_0_16_0_0_2_2_1_1_0_0_0_0_2_2_2_2_2_2_0_1_0_1_1_0_0_0_1_1_0_0_1_1_1_0_0_0_0_0_2_2_2_2_0_0_0_0_0_0_1_1_1_1_0_0_16_0_16_16_16_16_16_0_0_1_1_2_2_1_1_16_0_2_16_2_2_2_0_1_1_1_1_1_16_16_1_1_1_3_3_18_3_18_3_3_3_3_3_18_18_18_18_3_3_3_3_18_18_18_18_18_18_18_5_5_5_18_5_18_18_18_18_18_5_5_5_18_18_18_5_6_6_5_5_5_5_3_5_18_3_3_3_18_16_18_16_5_18_18_6_3_6_18_3_18_18_5_5_18_5_5_5_5_5_5_5_5_5_18_3_5_3_18_3_3_3_3_18_18_18_18_3_5_5_18_3_18_6_3_6_3_18_3_3_18_18_5_5_3_18_3_5_34_34_3_3_18_5_18_3_2_3_2_18_5_34_18_3_5_5_3_5_3_3_5_18_3_34_3_5_18_18_18_18_18_18_18_18_18_18_18_18_18_18_18_18_18_18_34_34_5
7626,189,1332069720,16,0,16,1332079440,9720,247980,308460,60480,16_16_16_16_16_16_16_16_16
7627,221,1332071580,1,18,1,1332850320,778740,6780,934800,928020,1_1
7628,222,1332071640,5,18,5,1332075600,3960,786240,1113000,326760,1_1_2_2_2_2_3_3_3_3_9_9_3_3_5
7629,15,1332075300,2,21,3,1332078180,2880,895320,1822860,927540,7_7_7_7_7_7_1_7_1_7_7_7_7_7_7_7_7_7_7_7_7_7_7_7_1_1_1_1_2_2
7630,186,1332075600,8,18,24,1332075900,300,2689980,3636240,946260,7_7_7_7_7_7_7_7_7_1_7_1_7_7_7_1_7_7_1_7_7_7_7_7_7_1_7_1_1_1_38_38_1_1_24_24_24_24_24_8
7631,222,1332075600,5,18,5,1332157140,81540,790200,1113000,322800,1_1_2_2_2_2_3_3_3_3_9_9_3_3_5_5
7632,27,1332075780,2,21,2,1332078780,3000,399780,402780,3000,0_0_0_0_0_0_0_0_0_0_0_0_0_0_0_0_0_0_0_1_1_0_0_0_0_0_0_0_1_0_0_0_0_0_1_0_2
7633,186,1332075900,24,8,24,1332075960,60,2690280,3636240,945960,7_7_7_7_7_7_7_7_7_1_7_1_7_7_7_1_7_7_1_7_7_7_7_7_7_1_7_1_1_1_38_38_1_1_24_24_24_24_24_8_24
7634,186,1332075960,24,8,8,1332079620,3660,2690340,3636240,945900,7_7_7_7_7_7_7_7_7_1_7_1_7_7_7_1_7_7_1_7_7_7_7_7_7_1_7_1_1_1_38_38_1_1_24_24_24_24_24_8_24_24
7635,131,1332077460,34,17,5,1332140400,62940,5817360,6825900,1008540,16_16_16_16_16_16_16_16_16_16_16_16_16_16_16_16_16_16_16_16_16_16_16_16_16_16_1_1_1_1_2_2_3_3_3_3_18_18_18_18_18_3_3_3_3_18_18_18_18_18_18_18_18_18_18_18_18_18_18_18_18_18_18_18_5_5_5_5_5_5_5_5_5_5_5_5_6_6_5_5_6_6_5_5_5_5_5_5_5_5_5_5_6_6_5_5_34_34_34_34_3_3_18_18_18_18_18_18_6_6_5_5_34_34
7636,219,1332077940,17,10,1,1332136800,58860,2794680,3797940,1003260,26_26_26_26_26_26_26_26_26_26_8_8_38_38_17_17_17_17_17_17_17_1_17_1_1_1_17_17_1_1_17_17_1_17_1_17
7637,15,1332078180,3,3,3,1332087000,8820,898200,1822860,924660,7_7_7_7_7_7_1_7_1_7_7_7_7_7_7_7_7_7_7_7_7_7_7_7_1_1_1_1_2_2_3
7638,188,1332078780,18,23,18,1332078960,180,3406740,4327560,920820,0_0_0_0_0_1_1_0_0_0_0_0_0_0_0_0_1_1_2_2_2_2_3_3_3_3_21_21_3_3_3_3_3_3_3_3_18_18_18_18_18_18_18_18_18_18_18_18_18_18_18_18_18_18_1_1_18_18_18_18_1_1_18_3_18_18_3_18_18_18_18_18
7639,27,1332078780,2,21,99,1332078780,0,402780,402780,0,0_0_0_0_0_0_0_0_0_0_0_0_0_0_0_0_0_0_0_1_1_0_0_0_0_0_0_0_1_0_0_0_0_0_1_0_2_2
7640,183,1332078840,19,11,19,1332079860,1020,22020,445560,423540,19_19
7641,188,1332078960,18,22,18,1332085920,6960,3406920,4327560,920640,0_0_0_0_0_1_1_0_0_0_0_0_0_0_0_0_1_1_2_2_2_2_3_3_3_3_21_21_3_3_3_3_3_3_3_3_18_18_18_18_18_18_18_18_18_18_18_18_18_18_18_18_18_18_1_1_18_18_18_18_1_1_18_3_18_18_3_18_18_18_18_18_18
7642,63,1332079320,34,17,5,1332079800,480,5227860,6232860,1005000,16_16_16_16_16_16_16_16_16_0_0_16_16_0_16_16_0_16_16_0_0_16_16_16_0_0_16_0_0_16_0_16_0_0_0_16_1_1_1_16_16_16_0_1_1_1_16_0_0_16_16_0_16_0_16_0_0_2_2_1_1_0_0_0_0_2_2_2_2_2_2_0_1_0_1_1_0_0_0_1_1_0_0_1_1_1_0_0_0_0_0_2_2_2_2_0_0_0_0_0_0_1_1_1_1_0_0_16_0_16_16_16_16_16_0_0_1_1_2_2_1_1_16_0_2_16_2_2_2_0_1_1_1_1_1_16_16_1_1_1_3_3_18_3_18_3_3_3_3_3_18_18_18_18_3_3_3_3_18_18_18_18_18_18_18_5_5_5_18_5_18_18_18_18_18_5_5_5_18_18_18_5_6_6_5_5_5_5_3_5_18_3_3_3_18_16_18_16_5_18_18_6_3_6_18_3_18_18_5_5_18_5_5_5_5_5_5_5_5_5_18_3_5_3_18_3_3_3_3_18_18_18_18_3_5_5_18_3_18_6_3_6_3_18_3_3_18_18_5_5_3_18_3_5_34_34_3_3_18_5_18_3_2_3_2_18_5_34_18_3_5_5_3_5_3_3_5_18_3_34_3_5_18_18_18_18_18_18_18_18_18_18_18_18_18_18_18_18_18_18_34_34_5_34
7643,189,1332079440,16,0,16,1332081600,2160,257700,308460,50760,16_16_16_16_16_16_16_16_16_16
7644,186,1332079620,8,18,24,1332086400,6780,2694000,3636240,942240,7_7_7_7_7_7_7_7_7_1_7_1_7_7_7_1_7_7_1_7_7_7_7_7_7_1_7_1_1_1_38_38_1_1_24_24_24_24_24_8_24_24_8
7645,179,1332079800,0,20,0,1332094080,14280,24360,345960,321600,0_0
7646,63,1332079800,5,2,34,1332080160,360,5228340,6232860,1004520,16_16_16_16_16_16_16_16_16_0_0_16_16_0_16_16_0_16_16_0_0_16_16_16_0_0_16_0_0_16_0_16_0_0_0_16_1_1_1_16_16_16_0_1_1_1_16_0_0_16_16_0_16_0_16_0_0_2_2_1_1_0_0_0_0_2_2_2_2_2_2_0_1_0_1_1_0_0_0_1_1_0_0_1_1_1_0_0_0_0_0_2_2_2_2_0_0_0_0_0_0_1_1_1_1_0_0_16_0_16_16_16_16_16_0_0_1_1_2_2_1_1_16_0_2_16_2_2_2_0_1_1_1_1_1_16_16_1_1_1_3_3_18_3_18_3_3_3_3_3_18_18_18_18_3_3_3_3_18_18_18_18_18_18_18_5_5_5_18_5_18_18_18_18_18_5_5_5_18_18_18_5_6_6_5_5_5_5_3_5_18_3_3_3_18_16_18_16_5_18_18_6_3_6_18_3_18_18_5_5_18_5_5_5_5_5_5_5_5_5_18_3_5_3_18_3_3_3_3_18_18_18_18_3_5_5_18_3_18_6_3_6_3_18_3_3_18_18_5_5_3_18_3_5_34_34_3_3_18_5_18_3_2_3_2_18_5_34_18_3_5_5_3_5_3_3_5_18_3_34_3_5_18_18_18_18_18_18_18_18_18_18_18_18_18_18_18_18_18_18_34_34_5_34_5
7647,183,1332079860,19,20,19,1332086340,6480,23040,445560,422520,19_19_19
7648,76,1332080160,34,17,34,1332085620,5460,6538560,7552500,1013940,3_3_3_3_3_3_3_3_3_18_3_18_18_18_18_18_3_3_3_1_1_3_17_17_17_18_17_17_18_18_18_18_18_17_17_18_3_3_18_17_18_18_17_18_18_17_17_17_5_5_5_5_1_1_17_17_17_2_2_17_17_17_5_5_5_5_5_5_17_17_5_5_5_17_5_5_5_5_5_17_17_17_1_1_1_1_1_1_1_1_2_2_34_34_5_5_5_5_6_6_3_3_4_3_3_4_4_4_4_4_3_3_3_3_3_3_4_3_3_3_3_4_4_4_3_4_4_4_3_4_4_4_3_3_4_4_4_4_5_3_3_5_5_5_5_5_4_5_4_5_4_3_3_3_3_4_3_3_4_4_5_5_5_4_5_5_5_4_6_6_34_34_5_5_34_34_34
7649,63,1332080160,34,17,5,1332133200,53040,5228700,6232860,1004160,16_16_16_16_16_16_16_16_16_0_0_16_16_0_16_16_0_16_16_0_0_16_16_16_0_0_16_0_0_16_0_16_0_0_0_16_1_1_1_16_16_16_0_1_1_1_16_0_0_16_16_0_16_0_16_0_0_2_2_1_1_0_0_0_0_2_2_2_2_2_2_0_1_0_1_1_0_0_0_1_1_0_0_1_1_1_0_0_0_0_0_2_2_2_2_0_0_0_0_0_0_1_1_1_1_0_0_16_0_16_16_16_16_16_0_0_1_1_2_2_1_1_16_0_2_16_2_2_2_0_1_1_1_1_1_16_16_1_1_1_3_3_18_3_18_3_3_3_3_3_18_18_18_18_3_3_3_3_18_18_18_18_18_18_18_5_5_5_18_5_18_18_18_18_18_5_5_5_18_18_18_5_6_6_5_5_5_5_3_5_18_3_3_3_18_16_18_16_5_18_18_6_3_6_18_3_18_18_5_5_18_5_5_5_5_5_5_5_5_5_18_3_5_3_18_3_3_3_3_18_18_18_18_3_5_5_18_3_18_6_3_6_3_18_3_3_18_18_5_5_3_18_3_5_34_34_3_3_18_5_18_3_2_3_2_18_5_34_18_3_5_5_3_5_3_3_5_18_3_34_3_5_18_18_18_18_18_18_18_18_18_18_18_18_18_18_18_18_18_18_34_34_5_34_5_34
7650,189,1332081600,16,20,16,1332086340,4740,259860,308460,48600,16_16_16_16_16_16_16_16_16_16_16
7651,185,1332082260,26,16,26,1332106200,23940,239280,441420,202140,26_26_3_3_26_26_8_26_8_26_26
7652,76,1332085620,34,17,5,1332133140,47520,6544020,7552500,1008480,3_3_3_3_3_3_3_3_3_18_3_18_18_18_18_18_3_3_3_1_1_3_17_17_17_18_17_17_18_18_18_18_18_17_17_18_3_3_18_17_18_18_17_18_18_17_17_17_5_5_5_5_1_1_17_17_17_2_2_17_17_17_5_5_5_5_5_5_17_17_5_5_5_17_5_5_5_5_5_17_17_17_1_1_1_1_1_1_1_1_2_2_34_34_5_5_5_5_6_6_3_3_4_3_3_4_4_4_4_4_3_3_3_3_3_3_4_3_3_3_3_4_4_4_3_4_4_4_3_4_4_4_3_3_4_4_4_4_5_3_3_5_5_5_5_5_4_5_4_5_4_3_3_3_3_4_3_3_4_4_5_5_5_4_5_5_5_4_6_6_34_34_5_5_34_34_34_34
7653,188,1332085920,18,22,18,1332097200,11280,3413880,4327560,913680,0_0_0_0_0_1_1_0_0_0_0_0_0_0_0_0_1_1_2_2_2_2_3_3_3_3_21_21_3_3_3_3_3_3_3_3_18_18_18_18_18_18_18_18_18_18_18_18_18_18_18_18_18_18_1_1_18_18_18_18_1_1_18_3_18_18_3_18_18_18_18_18_18_18
7654,189,1332086340,16,20,16,1332094020,7680,264600,308460,43860,16_16_16_16_16_16_16_16_16_16_16_16
7655,183,1332086340,19,20,19,1332094860,8520,29520,445560,416040,19_19_19_19
7656,186,1332086400,24,8,24,1332109140,22740,2700780,3636240,935460,7_7_7_7_7_7_7_7_7_1_7_1_7_7_7_1_7_7_1_7_7_7_7_7_7_1_7_1_1_1_38_38_1_1_24_24_24_24_24_8_24_24_8_24
7657,15,1332087000,3,3,17,1332099480,12480,907020,1822860,915840,7_7_7_7_7_7_1_7_1_7_7_7_7_7_7_7_7_7_7_7_7_7_7_7_1_1_1_1_2_2_3_3
7658,220,1332090000,27,26,27,1332133200,43200,1745640,2714040,968400,0_0_0_0_1_0_1_0_0_0_0_0_1_0_0_1_0_0_0_0_0_0_0_0_0_0_0_0_0_0_0_1_1_0_1_1_1_1_0_0_1_1_2_2_2_2_2_2_2_2_27_27_27_27_27_27_27_27_27_27_27_27_27_27
7659,189,1332094020,16,14,16,1332094080,60,272280,308460,36180,16_16_16_16_16_16_16_16_16_16_16_16_16
7660,189,1332094080,16,14,16,1332094080,0,272340,308460,36120,16_16_16_16_16_16_16_16_16_16_16_16_16_16
7661,189,1332094080,16,14,16,1332130200,36120,272340,308460,36120,16_16_16_16_16_16_16_16_16_16_16_16_16_16_16
7662,179,1332094080,0,1,0,1332107160,13080,38640,345960,307320,0_0_0
7663,183,1332094860,19,14,19,1332098280,3420,38040,445560,407520,19_19_19_19_19
7664,188,1332097200,18,5,18,1332132540,35340,3425160,4327560,902400,0_0_0_0_0_1_1_0_0_0_0_0_0_0_0_0_1_1_2_2_2_2_3_3_3_3_21_21_3_3_3_3_3_3_3_3_18_18_18_18_18_18_18_18_18_18_18_18_18_18_18_18_18_18_1_1_18_18_18_18_1_1_18_3_18_18_3_18_18_18_18_18_18_18_18
7665,183,1332098280,19,14,1,1332314400,216120,41460,445560,404100,19_19_19_19_19_19
7666,15,1332099480,17,12,17,1332109140,9660,919500,1822860,903360,7_7_7_7_7_7_1_7_1_7_7_7_7_7_7_7_7_7_7_7_7_7_7_7_1_1_1_1_2_2_3_3_17
7667,58,1332099720,19,14,19,1332116040,16320,0,992100,992100,19
7668,185,1332106200,26,16,8,1332169200,63000,263220,441420,178200,26_26_3_3_26_26_8_26_8_26_26_26
7669,179,1332107160,0,1,0,1332135120,27960,51720,345960,294240,0_0_0_0
7670,187,1332108000,6,7,6,1332111600,3600,2457180,2496960,39780,10_10_10_10_10_10_10_10_10_10_10_10_1_1_1_1_2_9_2_9_3_3_4_4_4_4_11_11_6
7671,32,1332108000,6,7,6,1332111600,3600,1086120,1205580,119460,10_1_1_10_10_10_10_10_1_1_3_3_3_3_6
7672,180,1332108000,50,25,50,1332112500,4500,3317580,3322080,4500,50_50_50_50_50_50_1_50_1_50_50_50_50_50_50_50_50_50_1_1_2_2_9_9_9_9_3_3_3_3_5_5_6_6_50
7673,141,1332108000,6,7,6,1332111600,3600,6454800,7406100,951300,1_1_16_16_16_16_16_1_16_16_1_1_1_16_16_16_16_16_16_16_16_16_16_16_16_16_16_16_1_1_1_1_1_1_1_1_1_1_1_1_16_2_2_16_3_3_3_3_3_3_18_18_18_18_18_3_18_3_3_3_5_5_5_5_5_5_3_3_4_4_4_4_4_3_1_3_1_4_18_3_3_18_18_1_1_18_18_5_5_18_5_5_5_5_6_6_5_5_6_6_6_6_5_5_5_5_5_5_5_5_6_6_5_5_5_5_5_5_5_5_5_5_5_5_34_34_34_34_5_5_5_5_34_34_6
7674,176,1332108000,6,7,6,1332111600,3600,1427100,1462860,35760,19_19_19_19_19_19_19_19_1_1_2_3_3_2_6
7675,15,1332109140,17,12,17,1332119400,10260,929160,1822860,893700,7_7_7_7_7_7_1_7_1_7_7_7_7_7_7_7_7_7_7_7_7_7_7_7_1_1_1_1_2_2_3_3_17_17_17
7676,186,1332109140,24,12,24,1332133020,23880,2723520,3636240,912720,7_7_7_7_7_7_7_7_7_1_7_1_7_7_7_1_7_7_1_7_7_7_7_7_7_1_7_1_1_1_38_38_1_1_24_24_24_24_24_8_24_24_8_24_24
7677,15,1332109140,17,12,17,1332109140,0,929160,1822860,893700,7_7_7_7_7_7_1_7_1_7_7_7_7_7_7_7_7_7_7_7_7_7_7_7_1_1_1_1_2_2_3_3_17_17
7678,176,1332111600,6,7,5,1332135240,23640,1430700,1462860,32160,19_19_19_19_19_19_19_19_1_1_2_3_3_2_6_6
7679,141,1332111600,6,7,5,1332136800,25200,6458400,7406100,947700,1_1_16_16_16_16_16_1_16_16_1_1_1_16_16_16_16_16_16_16_16_16_16_16_16_16_16_16_1_1_1_1_1_1_1_1_1_1_1_1_16_2_2_16_3_3_3_3_3_3_18_18_18_18_18_3_18_3_3_3_5_5_5_5_5_5_3_3_4_4_4_4_4_3_1_3_1_4_18_3_3_18_18_1_1_18_18_5_5_18_5_5_5_5_6_6_5_5_6_6_6_6_5_5_5_5_5_5_5_5_6_6_5_5_5_5_5_5_5_5_5_5_5_5_34_34_34_34_5_5_5_5_34_34_6_6
7680,32,1332111600,6,7,5,1332165600,54000,1089720,1205580,115860,10_1_1_10_10_10_10_10_1_1_3_3_3_3_6_6
7681,187,1332111600,6,7,5,1332143820,32220,2460780,2496960,36180,10_10_10_10_10_10_10_10_10_10_10_10_1_1_1_1_2_9_2_9_3_3_4_4_4_4_11_11_6_6
7682,180,1332112500,50,25,99,1332112500,0,3322080,3322080,0,50_50_50_50_50_50_1_50_1_50_50_50_50_50_50_50_50_50_1_1_2_2_9_9_9_9_3_3_3_3_5_5_6_6_50_50
7683,58,1332116040,19,14,19,1332134400,18360,16320,992100,975780,19_19
7684,15,1332119400,17,12,17,1332119520,120,939420,1822860,883440,7_7_7_7_7_7_1_7_1_7_7_7_7_7_7_7_7_7_7_7_7_7_7_7_1_1_1_1_2_2_3_3_17_17_17_17
7685,15,1332119520,17,14,17,1332132360,12840,939540,1822860,883320,7_7_7_7_7_7_1_7_1_7_7_7_7_7_7_7_7_7_7_7_7_7_7_7_1_1_1_1_2_2_3_3_17_17_17_17_17
7686,189,1332130200,16,14,99,1332130200,0,308460,308460,0,16_16_16_16_16_16_16_16_16_16_16_16_16_16_16_16
7687,15,1332132360,17,14,17,1332134760,2400,952380,1822860,870480,7_7_7_7_7_7_1_7_1_7_7_7_7_7_7_7_7_7_7_7_7_7_7_7_1_1_1_1_2_2_3_3_17_17_17_17_17_17
7688,188,1332132540,18,5,18,1332133560,1020,3460500,4327560,867060,0_0_0_0_0_1_1_0_0_0_0_0_0_0_0_0_1_1_2_2_2_2_3_3_3_3_21_21_3_3_3_3_3_3_3_3_18_18_18_18_18_18_18_18_18_18_18_18_18_18_18_18_18_18_1_1_18_18_18_18_1_1_18_3_18_18_3_18_18_18_18_18_18_18_18_18
7689,186,1332133020,24,12,24,1332133920,900,2747400,3636240,888840,7_7_7_7_7_7_7_7_7_1_7_1_7_7_7_1_7_7_1_7_7_7_7_7_7_1_7_1_1_1_38_38_1_1_24_24_24_24_24_8_24_24_8_24_24_24
7690,76,1332133140,5,6,5,1332147480,14340,6591540,7552500,960960,3_3_3_3_3_3_3_3_3_18_3_18_18_18_18_18_3_3_3_1_1_3_17_17_17_18_17_17_18_18_18_18_18_17_17_18_3_3_18_17_18_18_17_18_18_17_17_17_5_5_5_5_1_1_17_17_17_2_2_17_17_17_5_5_5_5_5_5_17_17_5_5_5_17_5_5_5_5_5_17_17_17_1_1_1_1_1_1_1_1_2_2_34_34_5_5_5_5_6_6_3_3_4_3_3_4_4_4_4_4_3_3_3_3_3_3_4_3_3_3_3_4_4_4_3_4_4_4_3_4_4_4_3_3_4_4_4_4_5_3_3_5_5_5_5_5_4_5_4_5_4_3_3_3_3_4_3_3_4_4_5_5_5_4_5_5_5_4_6_6_34_34_5_5_34_34_34_34_5
7691,8,1332133200,1,9,1,1332134880,1680,333960,615060,281100,10_10_10_10_1
7692,220,1332133200,27,26,27,1332165600,32400,1788840,2714040,925200,0_0_0_0_1_0_1_0_0_0_0_0_1_0_0_1_0_0_0_0_0_0_0_0_0_0_0_0_0_0_0_1_1_0_1_1_1_1_0_0_1_1_2_2_2_2_2_2_2_2_27_27_27_27_27_27_27_27_27_27_27_27_27_27_27
7693,63,1332133200,5,2,5,1332136800,3600,5281740,6232860,951120,16_16_16_16_16_16_16_16_16_0_0_16_16_0_16_16_0_16_16_0_0_16_16_16_0_0_16_0_0_16_0_16_0_0_0_16_1_1_1_16_16_16_0_1_1_1_16_0_0_16_16_0_16_0_16_0_0_2_2_1_1_0_0_0_0_2_2_2_2_2_2_0_1_0_1_1_0_0_0_1_1_0_0_1_1_1_0_0_0_0_0_2_2_2_2_0_0_0_0_0_0_1_1_1_1_0_0_16_0_16_16_16_16_16_0_0_1_1_2_2_1_1_16_0_2_16_2_2_2_0_1_1_1_1_1_16_16_1_1_1_3_3_18_3_18_3_3_3_3_3_18_18_18_18_3_3_3_3_18_18_18_18_18_18_18_5_5_5_18_5_18_18_18_18_18_5_5_5_18_18_18_5_6_6_5_5_5_5_3_5_18_3_3_3_18_16_18_16_5_18_18_6_3_6_18_3_18_18_5_5_18_5_5_5_5_5_5_5_5_5_18_3_5_3_18_3_3_3_3_18_18_18_18_3_5_5_18_3_18_6_3_6_3_18_3_3_18_18_5_5_3_18_3_5_34_34_3_3_18_5_18_3_2_3_2_18_5_34_18_3_5_5_3_5_3_3_5_18_3_34_3_5_18_18_18_18_18_18_18_18_18_18_18_18_18_18_18_18_18_18_34_34_5_34_5_34_5
7694,188,1332133560,18,23,18,1332136860,3300,3461520,4327560,866040,0_0_0_0_0_1_1_0_0_0_0_0_0_0_0_0_1_1_2_2_2_2_3_3_3_3_21_21_3_3_3_3_3_3_3_3_18_18_18_18_18_18_18_18_18_18_18_18_18_18_18_18_18_18_1_1_18_18_18_18_1_1_18_3_18_18_3_18_18_18_18_18_18_18_18_18_18
7695,186,1332133920,24,8,24,1332161820,27900,2748300,3636240,887940,7_7_7_7_7_7_7_7_7_1_7_1_7_7_7_1_7_7_1_7_7_7_7_7_7_1_7_1_1_1_38_38_1_1_24_24_24_24_24_8_24_24_8_24_24_24_24
7696,42,1332134040,16,20,16,1332172740,38700,0,953340,953340,16
7697,75,1332134400,34,17,34,1332143760,9360,6025860,6135000,109140,16_16_16_16_16_16_1_16_16_1_16_16_16_16_16_16_16_16_1_1_2_2_39_39_1_1_3_3_3_3_3_3_3_3_3_3_2_3_3_2_18_18_18_18_18_18_18_18_18_18_18_18_18_18_18_18_18_18_5_5_6_6_6_6_5_5_34
7698,58,1332134400,19,11,1,1332149400,15000,34680,992100,957420,19_19_19
7699,15,1332134760,17,21,17,1332167940,33180,954780,1822860,868080,7_7_7_7_7_7_1_7_1_7_7_7_7_7_7_7_7_7_7_7_7_7_7_7_1_1_1_1_2_2_3_3_17_17_17_17_17_17_17
7700,8,1332134880,1,9,2,1332142680,7800,335640,615060,279420,10_10_10_10_1_1
7701,179,1332135120,0,0,0,1332137820,2700,79680,345960,266280,0_0_0_0_0
7702,176,1332135240,5,9,5,1332143760,8520,1454340,1462860,8520,19_19_19_19_19_19_19_19_1_1_2_3_3_2_6_6_5
7703,196,1332136140,10,13,10,1332180000,43860,2335440,3281700,946260,7_7_7_7_7_7_7_7_7_7_7_7_7_7_7_7_7_7_7_7_1_1_1_1_7_7_1_1_7_7_1_1_7_7_7_1_1_7_7_7_7_7_7_7_7_7_1_1_7_7_7_30_30_7_1_7_7_1_7_1_1_7_7_7_1_7_7_1_1_1_7_7_30_30_1_1_10
7704,141,1332136800,5,2,5,1332139200,2400,6483600,7406100,922500,1_1_16_16_16_16_16_1_16_16_1_1_1_16_16_16_16_16_16_16_16_16_16_16_16_16_16_16_1_1_1_1_1_1_1_1_1_1_1_1_16_2_2_16_3_3_3_3_3_3_18_18_18_18_18_3_18_3_3_3_5_5_5_5_5_5_3_3_4_4_4_4_4_3_1_3_1_4_18_3_3_18_18_1_1_18_18_5_5_18_5_5_5_5_6_6_5_5_6_6_6_6_5_5_5_5_5_5_5_5_6_6_5_5_5_5_5_5_5_5_5_5_5_5_34_34_34_34_5_5_5_5_34_34_6_6_5
7705,219,1332136800,1,18,1,1332149400,12600,2853540,3797940,944400,26_26_26_26_26_26_26_26_26_26_8_8_38_38_17_17_17_17_17_17_17_1_17_1_1_1_17_17_1_1_17_17_1_17_1_17_1
7706,63,1332136800,5,2,6,1332194400,57600,5285340,6232860,947520,16_16_16_16_16_16_16_16_16_0_0_16_16_0_16_16_0_16_16_0_0_16_16_16_0_0_16_0_0_16_0_16_0_0_0_16_1_1_1_16_16_16_0_1_1_1_16_0_0_16_16_0_16_0_16_0_0_2_2_1_1_0_0_0_0_2_2_2_2_2_2_0_1_0_1_1_0_0_0_1_1_0_0_1_1_1_0_0_0_0_0_2_2_2_2_0_0_0_0_0_0_1_1_1_1_0_0_16_0_16_16_16_16_16_0_0_1_1_2_2_1_1_16_0_2_16_2_2_2_0_1_1_1_1_1_16_16_1_1_1_3_3_18_3_18_3_3_3_3_3_18_18_18_18_3_3_3_3_18_18_18_18_18_18_18_5_5_5_18_5_18_18_18_18_18_5_5_5_18_18_18_5_6_6_5_5_5_5_3_5_18_3_3_3_18_16_18_16_5_18_18_6_3_6_18_3_18_18_5_5_18_5_5_5_5_5_5_5_5_5_18_3_5_3_18_3_3_3_3_18_18_18_18_3_5_5_18_3_18_6_3_6_3_18_3_3_18_18_5_5_3_18_3_5_34_34_3_3_18_5_18_3_2_3_2_18_5_34_18_3_5_5_3_5_3_3_5_18_3_34_3_5_18_18_18_18_18_18_18_18_18_18_18_18_18_18_18_18_18_18_34_34_5_34_5_34_5_5
7707,188,1332136860,18,22,18,1332136920,60,3464820,4327560,862740,0_0_0_0_0_1_1_0_0_0_0_0_0_0_0_0_1_1_2_2_2_2_3_3_3_3_21_21_3_3_3_3_3_3_3_3_18_18_18_18_18_18_18_18_18_18_18_18_18_18_18_18_18_18_1_1_18_18_18_18_1_1_18_3_18_18_3_18_18_18_18_18_18_18_18_18_18_18
7708,188,1332136920,18,23,18,1332172380,35460,3464880,4327560,862680,0_0_0_0_0_1_1_0_0_0_0_0_0_0_0_0_1_1_2_2_2_2_3_3_3_3_21_21_3_3_3_3_3_3_3_3_18_18_18_18_18_18_18_18_18_18_18_18_18_18_18_18_18_18_1_1_18_18_18_18_1_1_18_3_18_18_3_18_18_18_18_18_18_18_18_18_18_18_18
7709,25,1332136980,4,23,4,1332144000,7020,1159380,1951380,792000,16_16_16_8_8_16_16_8_8_16_0_0_0_0_0_0_0_0_1_1_2_2_25_25_9_9_3_3_4
7710,179,1332137820,0,0,0,1332142620,4800,82380,345960,263580,0_0_0_0_0_0
7711,141,1332139200,5,2,6,1332280800,141600,6486000,7406100,920100,1_1_16_16_16_16_16_1_16_16_1_1_1_16_16_16_16_16_16_16_16_16_16_16_16_16_16_16_1_1_1_1_1_1_1_1_1_1_1_1_16_2_2_16_3_3_3_3_3_3_18_18_18_18_18_3_18_3_3_3_5_5_5_5_5_5_3_3_4_4_4_4_4_3_1_3_1_4_18_3_3_18_18_1_1_18_18_5_5_18_5_5_5_5_6_6_5_5_6_6_6_6_5_5_5_5_5_5_5_5_6_6_5_5_5_5_5_5_5_5_5_5_5_5_34_34_34_34_5_5_5_5_34_34_6_6_5_5
7712,131,1332140400,5,2,5,1332154200,13800,5880300,6825900,945600,16_16_16_16_16_16_16_16_16_16_16_16_16_16_16_16_16_16_16_16_16_16_16_16_16_16_1_1_1_1_2_2_3_3_3_3_18_18_18_18_18_3_3_3_3_18_18_18_18_18_18_18_18_18_18_18_18_18_18_18_18_18_18_18_5_5_5_5_5_5_5_5_5_5_5_5_6_6_5_5_6_6_5_5_5_5_5_5_5_5_5_5_6_6_5_5_34_34_34_34_3_3_18_18_18_18_18_18_6_6_5_5_34_34_5
7713,179,1332142620,0,0,1,1332153540,10920,87180,345960,258780,0_0_0_0_0_0_0
7714,8,1332142680,2,3,2,1332147060,4380,343440,615060,271620,10_10_10_10_1_1_2
7715,178,1332142740,2,3,2,1332148860,6120,416940,904200,487260,10_10_10_10_10_10_10_10_10_10_10_10_10_1_10_1_10_10_1_1_1_1_2
7716,176,1332143760,5,9,99,1332143760,0,1462860,1462860,0,19_19_19_19_19_19_19_19_1_1_2_3_3_2_6_6_5_5
7717,75,1332143760,34,17,6,1332194400,50640,6035220,6135000,99780,16_16_16_16_16_16_1_16_16_1_16_16_16_16_16_16_16_16_1_1_2_2_39_39_1_1_3_3_3_3_3_3_3_3_3_3_2_3_3_2_18_18_18_18_18_18_18_18_18_18_18_18_18_18_18_18_18_18_5_5_6_6_6_6_5_5_34_34
7718,187,1332143820,5,9,5,1332147780,3960,2493000,2496960,3960,10_10_10_10_10_10_10_10_10_10_10_10_1_1_1_1_2_9_2_9_3_3_4_4_4_4_11_11_6_6_5
7719,25,1332144000,4,23,4,1332144120,120,1166400,1951380,784980,16_16_16_8_8_16_16_8_8_16_0_0_0_0_0_0_0_0_1_1_2_2_25_25_9_9_3_3_4_4
7720,25,1332144120,4,23,4,1332155940,11820,1166520,1951380,784860,16_16_16_8_8_16_16_8_8_16_0_0_0_0_0_0_0_0_1_1_2_2_25_25_9_9_3_3_4_4_4
7721,8,1332147060,2,3,9,1332160920,13860,347820,615060,267240,10_10_10_10_1_1_2_2
7722,76,1332147480,5,6,5,1332147600,120,6605880,7552500,946620,3_3_3_3_3_3_3_3_3_18_3_18_18_18_18_18_3_3_3_1_1_3_17_17_17_18_17_17_18_18_18_18_18_17_17_18_3_3_18_17_18_18_17_18_18_17_17_17_5_5_5_5_1_1_17_17_17_2_2_17_17_17_5_5_5_5_5_5_17_17_5_5_5_17_5_5_5_5_5_17_17_17_1_1_1_1_1_1_1_1_2_2_34_34_5_5_5_5_6_6_3_3_4_3_3_4_4_4_4_4_3_3_3_3_3_3_4_3_3_3_3_4_4_4_3_4_4_4_3_4_4_4_3_3_4_4_4_4_5_3_3_5_5_5_5_5_4_5_4_5_4_3_3_3_3_4_3_3_4_4_5_5_5_4_5_5_5_4_6_6_34_34_5_5_34_34_34_34_5_5
7723,76,1332147600,5,6,5,1332165540,17940,6606000,7552500,946500,3_3_3_3_3_3_3_3_3_18_3_18_18_18_18_18_3_3_3_1_1_3_17_17_17_18_17_17_18_18_18_18_18_17_17_18_3_3_18_17_18_18_17_18_18_17_17_17_5_5_5_5_1_1_17_17_17_2_2_17_17_17_5_5_5_5_5_5_17_17_5_5_5_17_5_5_5_5_5_17_17_17_1_1_1_1_1_1_1_1_2_2_34_34_5_5_5_5_6_6_3_3_4_3_3_4_4_4_4_4_3_3_3_3_3_3_4_3_3_3_3_4_4_4_3_4_4_4_3_4_4_4_3_3_4_4_4_4_5_3_3_5_5_5_5_5_4_5_4_5_4_3_3_3_3_4_3_3_4_4_5_5_5_4_5_5_5_4_6_6_34_34_5_5_34_34_34_34_5_5_5
7724,187,1332147780,5,9,99,1332147780,0,2496960,2496960,0,10_10_10_10_10_10_10_10_10_10_10_10_1_1_1_1_2_9_2_9_3_3_4_4_4_4_11_11_6_6_5_5
7725,178,1332148860,2,3,9,1332256800,107940,423060,904200,481140,10_10_10_10_10_10_10_10_10_10_10_10_10_1_10_1_10_10_1_1_1_1_2_2
7726,2,1332148860,5,9,5,1332158760,9900,2398320,2555640,157320,10_10_10_10_10_10_10_10_1_1_2_2_9_9_3_3_4_4_4_4_11_11_5
7727,219,1332149400,1,18,3,1332158400,9000,2866140,3797940,931800,26_26_26_26_26_26_26_26_26_26_8_8_38_38_17_17_17_17_17_17_17_1_17_1_1_1_17_17_1_1_17_17_1_17_1_17_1_1
7728,58,1332149400,1,18,19,1332151920,2520,49680,992100,942420,19_19_19_1
7729,58,1332151920,19,11,1,1332153420,1500,52200,992100,939900,19_19_19_1_19_19
7730,58,1332151920,19,11,19,1332151920,0,52200,992100,939900,19_19_19_1_19
7731,13,1332152940,2,3,2,1332165960,13020,1586400,2525940,939540,19_19_19_1_1_19_19_19_19_19_19_19_19_19_19_19_1_1_1_19_1_19_19_19_19_19_19_19_19_19_19_1_19_1_19_19_19_19_19_19_1_1_1_1_19_19_19_19_1_1_1_1_1_1_19_19_1_19_1_19_19_19_19_19_2
7732,58,1332153420,1,18,19,1332165660,12240,53700,992100,938400,19_19_19_1_19_19_1
7733,179,1332153540,1,18,1,1332157080,3540,98100,345960,247860,0_0_0_0_0_0_0_1
7734,131,1332154200,5,2,5,1332226800,72600,5894100,6825900,931800,16_16_16_16_16_16_16_16_16_16_16_16_16_16_16_16_16_16_16_16_16_16_16_16_16_16_1_1_1_1_2_2_3_3_3_3_18_18_18_18_18_3_3_3_3_18_18_18_18_18_18_18_18_18_18_18_18_18_18_18_18_18_18_18_5_5_5_5_5_5_5_5_5_5_5_5_6_6_5_5_6_6_5_5_5_5_5_5_5_5_5_5_6_6_5_5_34_34_34_34_3_3_18_18_18_18_18_18_6_6_5_5_34_34_5_5
7735,25,1332155940,4,23,15,1332311460,155520,1178340,1951380,773040,16_16_16_8_8_16_16_8_8_16_0_0_0_0_0_0_0_0_1_1_2_2_25_25_9_9_3_3_4_4_4_4
7736,98,1332156000,5,2,5,1332160500,4500,6416580,7319880,903300,34_34_2_2_35_35_34_34_2_2_3_3_3_3_3_3_18_18_3_3_3_18_3_3_3_18_18_18_18_3_3_18_18_18_18_18_18_18_18_3_3_18_39_3_3_39_3_3_3_3_4_4_5_5_5_5_5_5_4_4_4_5_3_5_5_3_5_4_4_4_5_5_5_5_6_6_6_6_5_5_5_5_5_5_5_5_5_5_5_5_6_6_5_5_34_34_6_6_5_5_5_5_5_5_5_5_5_5_5_5_2_2_5_18_5_18_18_18_6_6_5_5_5_5_5_5_6_6_34_34_34_34_35_35_6_6_5_5_5
7737,179,1332157080,1,18,0,1332165840,8760,101640,345960,244320,0_0_0_0_0_0_0_1_1
7738,222,1332157140,5,18,5,1332165600,8460,871740,1113000,241260,1_1_2_2_2_2_3_3_3_3_9_9_3_3_5_5_5
7739,219,1332158400,25,28,3,1332165600,7200,2875140,3797940,922800,26_26_26_26_26_26_26_26_26_26_8_8_38_38_17_17_17_17_17_17_17_1_17_1_1_1_17_17_1_1_17_17_1_17_1_17_1_1_3_25
7740,219,1332158400,3,3,25,1332158400,0,2875140,3797940,922800,26_26_26_26_26_26_26_26_26_26_8_8_38_38_17_17_17_17_17_17_17_1_17_1_1_1_17_17_1_1_17_17_1_17_1_17_1_1_3
7741,2,1332158760,5,9,6,1332280800,122040,2408220,2555640,147420,10_10_10_10_10_10_10_10_1_1_2_2_9_9_3_3_4_4_4_4_11_11_5_5
7742,31,1332158760,5,9,5,1332165240,6480,1312740,1374660,61920,19_19_19_19_19_19_19_19_1_1_19_19_19_19_19_3_19_19_3_19_1_19_1_19_19_1_3_1_3_19_19_2_6_6_2_19_19_1_1_5_5_19_5_1_1_5_3_3_2_2_1_1_1_1_5_5_5_5_3_3_2_5_2_5_6_6_2_2_3_3_3_3_5
7743,98,1332160500,5,2,34,1332339180,178680,6421080,7319880,898800,34_34_2_2_35_35_34_34_2_2_3_3_3_3_3_3_18_18_3_3_3_18_3_3_3_18_18_18_18_3_3_18_18_18_18_18_18_18_18_3_3_18_39_3_3_39_3_3_3_3_4_4_5_5_5_5_5_5_4_4_4_5_3_5_5_3_5_4_4_4_5_5_5_5_6_6_6_6_5_5_5_5_5_5_5_5_5_5_5_5_6_6_5_5_34_34_6_6_5_5_5_5_5_5_5_5_5_5_5_5_2_2_5_18_5_18_18_18_6_6_5_5_5_5_5_5_6_6_34_34_34_34_35_35_6_6_5_5_5_5
7744,8,1332160920,9,4,9,1332163200,2280,361680,615060,253380,10_10_10_10_1_1_2_2_9
7745,186,1332161820,24,8,8,1332223200,61380,2776200,3636240,860040,7_7_7_7_7_7_7_7_7_1_7_1_7_7_7_1_7_7_1_7_7_7_7_7_7_1_7_1_1_1_38_38_1_1_24_24_24_24_24_8_24_24_8_24_24_24_24_24
7746,8,1332163200,9,4,5,1332336420,173220,363960,615060,251100,10_10_10_10_1_1_2_2_9_9
7747,31,1332165240,5,9,5,1332165600,360,1319220,1374660,55440,19_19_19_19_19_19_19_19_1_1_19_19_19_19_19_3_19_19_3_19_1_19_1_19_19_1_3_1_3_19_19_2_6_6_2_19_19_1_1_5_5_19_5_1_1_5_3_3_2_2_1_1_1_1_5_5_5_5_3_3_2_5_2_5_6_6_2_2_3_3_3_3_5_5
7748,76,1332165540,5,6,6,1332194400,28860,6623940,7552500,928560,3_3_3_3_3_3_3_3_3_18_3_18_18_18_18_18_3_3_3_1_1_3_17_17_17_18_17_17_18_18_18_18_18_17_17_18_3_3_18_17_18_18_17_18_18_17_17_17_5_5_5_5_1_1_17_17_17_2_2_17_17_17_5_5_5_5_5_5_17_17_5_5_5_17_5_5_5_5_5_17_17_17_1_1_1_1_1_1_1_1_2_2_34_34_5_5_5_5_6_6_3_3_4_3_3_4_4_4_4_4_3_3_3_3_3_3_4_3_3_3_3_4_4_4_3_4_4_4_3_4_4_4_3_3_4_4_4_4_5_3_3_5_5_5_5_5_4_5_4_5_4_3_3_3_3_4_3_3_4_4_5_5_5_4_5_5_5_4_6_6_34_34_5_5_34_34_34_34_5_5_5_5
7749,222,1332165600,5,18,6,1332367200,201600,880200,1113000,232800,1_1_2_2_2_2_3_3_3_3_9_9_3_3_5_5_5_5
7750,32,1332165600,5,18,5,1332167400,1800,1143720,1205580,61860,10_1_1_10_10_10_10_10_1_1_3_3_3_3_6_6_5
7751,219,1332165600,25,28,18,1332220680,55080,2882340,3797940,915600,26_26_26_26_26_26_26_26_26_26_8_8_38_38_17_17_17_17_17_17_17_1_17_1_1_1_17_17_1_1_17_17_1_17_1_17_1_1_3_25_3_25
7752,219,1332165600,3,3,25,1332165600,0,2882340,3797940,915600,26_26_26_26_26_26_26_26_26_26_8_8_38_38_17_17_17_17_17_17_17_1_17_1_1_1_17_17_1_1_17_17_1_17_1_17_1_1_3_25_3
7753,220,1332165600,27,26,3,1332244260,78660,1821240,2714040,892800,0_0_0_0_1_0_1_0_0_0_0_0_1_0_0_1_0_0_0_0_0_0_0_0_0_0_0_0_0_0_0_1_1_0_1_1_1_1_0_0_1_1_2_2_2_2_2_2_2_2_27_27_27_27_27_27_27_27_27_27_27_27_27_27_27_27
7754,31,1332165600,5,9,5,1332172680,7080,1319580,1374660,55080,19_19_19_19_19_19_19_19_1_1_19_19_19_19_19_3_19_19_3_19_1_19_1_19_19_1_3_1_3_19_19_2_6_6_2_19_19_1_1_5_5_19_5_1_1_5_3_3_2_2_1_1_1_1_5_5_5_5_3_3_2_5_2_5_6_6_2_2_3_3_3_3_5_5_5
7755,58,1332165660,19,11,19,1332168000,2340,65940,992100,926160,19_19_19_1_19_19_1_19
7756,179,1332165840,0,0,0,1332165900,60,110400,345960,235560,0_0_0_0_0_0_0_1_1_0
7757,179,1332165900,0,1,0,1332190740,24840,110460,345960,235500,0_0_0_0_0_0_0_1_1_0_0
7758,13,1332165960,2,3,9,1332167040,1080,1599420,2525940,926520,19_19_19_1_1_19_19_19_19_19_19_19_19_19_19_19_1_1_1_19_1_19_19_19_19_19_19_19_19_19_19_1_19_1_19_19_19_19_19_19_1_1_1_1_19_19_19_19_1_1_1_1_1_1_19_19_1_19_1_19_19_19_19_19_2_2
7759,13,1332167040,9,17,9,1332171780,4740,1600500,2525940,925440,19_19_19_1_1_19_19_19_19_19_19_19_19_19_19_19_1_1_1_19_1_19_19_19_19_19_19_19_19_19_19_1_19_1_19_19_19_19_19_19_1_1_1_1_19_19_19_19_1_1_1_1_1_1_19_19_1_19_1_19_19_19_19_19_2_2_9
7760,32,1332167400,5,18,2,1332224820,57420,1145520,1205580,60060,10_1_1_10_10_10_10_10_1_1_3_3_3_3_6_6_5_5
7761,15,1332167940,17,21,17,1332184680,16740,987960,1822860,834900,7_7_7_7_7_7_1_7_1_7_7_7_7_7_7_7_7_7_7_7_7_7_7_7_1_1_1_1_2_2_3_3_17_17_17_17_17_17_17_17
7762,58,1332168000,19,21,19,1332172140,4140,68280,992100,923820,19_19_19_1_19_19_1_19_19
7763,185,1332169200,8,18,8,1332172680,3480,326220,441420,115200,26_26_3_3_26_26_8_26_8_26_26_26_8
7764,13,1332171780,9,17,2,1332185340,13560,1605240,2525940,920700,19_19_19_1_1_19_19_19_19_19_19_19_19_19_19_19_1_1_1_19_1_19_19_19_19_19_19_19_19_19_19_1_19_1_19_19_19_19_19_19_1_1_1_1_19_19_19_19_1_1_1_1_1_1_19_19_1_19_1_19_19_19_19_19_2_2_9_9
7765,58,1332172140,19,21,19,1332179820,7680,72420,992100,919680,19_19_19_1_19_19_1_19_19_19
7766,188,1332172380,18,22,18,1332180960,8580,3500340,4327560,827220,0_0_0_0_0_1_1_0_0_0_0_0_0_0_0_0_1_1_2_2_2_2_3_3_3_3_21_21_3_3_3_3_3_3_3_3_18_18_18_18_18_18_18_18_18_18_18_18_18_18_18_18_18_18_1_1_18_18_18_18_1_1_18_3_18_18_3_18_18_18_18_18_18_18_18_18_18_18_18_18
7767,31,1332172680,5,9,6,1332194400,21720,1326660,1374660,48000,19_19_19_19_19_19_19_19_1_1_19_19_19_19_19_3_19_19_3_19_1_19_1_19_19_1_3_1_3_19_19_2_6_6_2_19_19_1_1_5_5_19_5_1_1_5_3_3_2_2_1_1_1_1_5_5_5_5_3_3_2_5_2_5_6_6_2_2_3_3_3_3_5_5_5_5
7768,185,1332172680,8,18,8,1332220440,47760,329700,441420,111720,26_26_3_3_26_26_8_26_8_26_26_26_8_8
7769,42,1332172740,16,20,16,1332181200,8460,38700,953340,914640,16_16
7770,58,1332179820,19,16,19,1332192480,12660,80100,992100,912000,19_19_19_1_19_19_1_19_19_19_19
7771,196,1332180000,10,13,10,1332219600,39600,2379300,3281700,902400,7_7_7_7_7_7_7_7_7_7_7_7_7_7_7_7_7_7_7_7_1_1_1_1_7_7_1_1_7_7_1_1_7_7_7_1_1_7_7_7_7_7_7_7_7_7_1_1_7_7_7_30_30_7_1_7_7_1_7_1_1_7_7_7_1_7_7_1_1_1_7_7_30_30_1_1_10_10
7772,188,1332180960,18,5,18,1332197040,16080,3508920,4327560,818640,0_0_0_0_0_1_1_0_0_0_0_0_0_0_0_0_1_1_2_2_2_2_3_3_3_3_21_21_3_3_3_3_3_3_3_3_18_18_18_18_18_18_18_18_18_18_18_18_18_18_18_18_18_18_1_1_18_18_18_18_1_1_18_3_18_18_3_18_18_18_18_18_18_18_18_18_18_18_18_18_18
7773,42,1332181200,16,1,16,1332185700,4500,47160,953340,906180,16_16_16
7774,6,1332182580,16,14,16,1332203160,20580,0,133560,133560,16
7775,15,1332184680,17,12,17,1332218880,34200,1004700,1822860,818160,7_7_7_7_7_7_1_7_1_7_7_7_7_7_7_7_7_7_7_7_7_7_7_7_1_1_1_1_2_2_3_3_17_17_17_17_17_17_17_17_17
7776,13,1332185340,2,16,2,1332189120,3780,1618800,2525940,907140,19_19_19_1_1_19_19_19_19_19_19_19_19_19_19_19_1_1_1_19_1_19_19_19_19_19_19_19_19_19_19_1_19_1_19_19_19_19_19_19_1_1_1_1_19_19_19_19_1_1_1_1_1_1_19_19_1_19_1_19_19_19_19_19_2_2_9_9_2
7777,42,1332185700,16,1,1,1332234120,48420,51660,953340,901680,16_16_16_16
7778,13,1332189120,2,16,1,1332219120,30000,1622580,2525940,903360,19_19_19_1_1_19_19_19_19_19_19_19_19_19_19_19_1_1_1_19_1_19_19_19_19_19_19_19_19_19_19_1_19_1_19_19_19_19_19_19_1_1_1_1_19_19_19_19_1_1_1_1_1_1_19_19_1_19_1_19_19_19_19_19_2_2_9_9_2_2
7779,179,1332190740,0,1,1,1332219600,28860,135300,345960,210660,0_0_0_0_0_0_0_1_1_0_0_0
7780,58,1332192480,19,16,19,1332205380,12900,92760,992100,899340,19_19_19_1_19_19_1_19_19_19_19_19
7781,75,1332194400,6,7,6,1332198000,3600,6085860,6135000,49140,16_16_16_16_16_16_1_16_16_1_16_16_16_16_16_16_16_16_1_1_2_2_39_39_1_1_3_3_3_3_3_3_3_3_3_3_2_3_3_2_18_18_18_18_18_18_18_18_18_18_18_18_18_18_18_18_18_18_5_5_6_6_6_6_5_5_34_34_6
7782,146,1332194400,6,7,6,1332198000,3600,6667200,6670800,3600,16_16_16_16_16_16_16_1_16_1_16_1_1_16_1_16_16_2_1_1_16_1_2_16_2_2_3_3_3_3_21_21_3_3_3_3_3_21_3_21_3_3_3_3_21_3_21_3_18_18_18_18_18_18_3_3_3_3_4_4_4_4_4_4_4_4_4_4_4_4_4_4_4_4_4_4_18_18_4_4_4_4_4_3_3_4_4_4_5_5_6_6_5_5_6_6_5_5_34_34_34_34_34_34_5_5_5_5_6_6_5_6_6_5_6_6_6
7783,64,1332194400,19,25,19,1332198900,4500,6094320,6845160,750840,1_1_11_11_5_5_1_1_6_6_1_1_19
7784,31,1332194400,6,7,6,1332198000,3600,1348380,1374660,26280,19_19_19_19_19_19_19_19_1_1_19_19_19_19_19_3_19_19_3_19_1_19_1_19_19_1_3_1_3_19_19_2_6_6_2_19_19_1_1_5_5_19_5_1_1_5_3_3_2_2_1_1_1_1_5_5_5_5_3_3_2_5_2_5_6_6_2_2_3_3_3_3_5_5_5_5_6
7785,194,1332194400,6,7,6,1332198000,3600,576120,615600,39480,53_53_6
7786,76,1332194400,6,7,6,1332198000,3600,6652800,7552500,899700,3_3_3_3_3_3_3_3_3_18_3_18_18_18_18_18_3_3_3_1_1_3_17_17_17_18_17_17_18_18_18_18_18_17_17_18_3_3_18_17_18_18_17_18_18_17_17_17_5_5_5_5_1_1_17_17_17_2_2_17_17_17_5_5_5_5_5_5_17_17_5_5_5_17_5_5_5_5_5_17_17_17_1_1_1_1_1_1_1_1_2_2_34_34_5_5_5_5_6_6_3_3_4_3_3_4_4_4_4_4_3_3_3_3_3_3_4_3_3_3_3_4_4_4_3_4_4_4_3_4_4_4_3_3_4_4_4_4_5_3_3_5_5_5_5_5_4_5_4_5_4_3_3_3_3_4_3_3_4_4_5_5_5_4_5_5_5_4_6_6_34_34_5_5_34_34_34_34_5_5_5_5_6
7787,213,1332194400,6,7,6,1332198000,3600,3157980,3206820,48840,0_0_0_0_0_1_0_1_0_0_0_0_0_0_0_0_1_1_0_0_0_0_0_0_0_1_1_0_0_0_0_0_0_0_0_0_0_0_0_0_0_1_1_1_0_1_0_0_0_0_0_0_0_0_0_0_1_0_1_0_0_0_0_0_0_0_0_0_0_0_0_0_0_0_0_0_0_0_0_1_1_0_0_0_0_0_0_0_0_0_0_0_0_0_1_1_0_0_2_2_3_3_4_3_3_4_2_2_4_4_4_4_4_4_4_4_5_2_3_4_5_2_3_4_6_6_5_5_0_1_0_1_2_2_2_2_3_3_4_4_4_3_3_3_3_4_3_3_4_4_4_4_4_4_3_4_3_4_4_3_3_3_4_4_3_4_4_4_4_4_4_4_6
7788,63,1332194400,6,7,6,1332198000,3600,5342940,6232860,889920,16_16_16_16_16_16_16_16_16_0_0_16_16_0_16_16_0_16_16_0_0_16_16_16_0_0_16_0_0_16_0_16_0_0_0_16_1_1_1_16_16_16_0_1_1_1_16_0_0_16_16_0_16_0_16_0_0_2_2_1_1_0_0_0_0_2_2_2_2_2_2_0_1_0_1_1_0_0_0_1_1_0_0_1_1_1_0_0_0_0_0_2_2_2_2_0_0_0_0_0_0_1_1_1_1_0_0_16_0_16_16_16_16_16_0_0_1_1_2_2_1_1_16_0_2_16_2_2_2_0_1_1_1_1_1_16_16_1_1_1_3_3_18_3_18_3_3_3_3_3_18_18_18_18_3_3_3_3_18_18_18_18_18_18_18_5_5_5_18_5_18_18_18_18_18_5_5_5_18_18_18_5_6_6_5_5_5_5_3_5_18_3_3_3_18_16_18_16_5_18_18_6_3_6_18_3_18_18_5_5_18_5_5_5_5_5_5_5_5_5_18_3_5_3_18_3_3_3_3_18_18_18_18_3_5_5_18_3_18_6_3_6_3_18_3_3_18_18_5_5_3_18_3_5_34_34_3_3_18_5_18_3_2_3_2_18_5_34_18_3_5_5_3_5_3_3_5_18_3_34_3_5_18_18_18_18_18_18_18_18_18_18_18_18_18_18_18_18_18_18_34_34_5_34_5_34_5_5_6
7789,188,1332197040,18,5,5,1332750000,552960,3525000,4327560,802560,0_0_0_0_0_1_1_0_0_0_0_0_0_0_0_0_1_1_2_2_2_2_3_3_3_3_21_21_3_3_3_3_3_3_3_3_18_18_18_18_18_18_18_18_18_18_18_18_18_18_18_18_18_18_1_1_18_18_18_18_1_1_18_3_18_18_3_18_18_18_18_18_18_18_18_18_18_18_18_18_18_18
7790,213,1332198000,6,7,5,1332226800,28800,3161580,3206820,45240,0_0_0_0_0_1_0_1_0_0_0_0_0_0_0_0_1_1_0_0_0_0_0_0_0_1_1_0_0_0_0_0_0_0_0_0_0_0_0_0_0_1_1_1_0_1_0_0_0_0_0_0_0_0_0_0_1_0_1_0_0_0_0_0_0_0_0_0_0_0_0_0_0_0_0_0_0_0_0_1_1_0_0_0_0_0_0_0_0_0_0_0_0_0_1_1_0_0_2_2_3_3_4_3_3_4_2_2_4_4_4_4_4_4_4_4_5_2_3_4_5_2_3_4_6_6_5_5_0_1_0_1_2_2_2_2_3_3_4_4_4_3_3_3_3_4_3_3_4_4_4_4_4_4_3_4_3_4_4_3_3_3_4_4_3_4_4_4_4_4_4_4_6_6
7791,31,1332198000,6,7,5,1332219780,21780,1351980,1374660,22680,19_19_19_19_19_19_19_19_1_1_19_19_19_19_19_3_19_19_3_19_1_19_1_19_19_1_3_1_3_19_19_2_6_6_2_19_19_1_1_5_5_19_5_1_1_5_3_3_2_2_1_1_1_1_5_5_5_5_3_3_2_5_2_5_6_6_2_2_3_3_3_3_5_5_5_5_6_6
7792,75,1332198000,6,7,5,1332228840,30840,6089460,6135000,45540,16_16_16_16_16_16_1_16_16_1_16_16_16_16_16_16_16_16_1_1_2_2_39_39_1_1_3_3_3_3_3_3_3_3_3_3_2_3_3_2_18_18_18_18_18_18_18_18_18_18_18_18_18_18_18_18_18_18_5_5_6_6_6_6_5_5_34_34_6_6
7793,146,1332198000,6,7,99,1332198000,0,6670800,6670800,0,16_16_16_16_16_16_16_1_16_1_16_1_1_16_1_16_16_2_1_1_16_1_2_16_2_2_3_3_3_3_21_21_3_3_3_3_3_21_3_21_3_3_3_3_21_3_21_3_18_18_18_18_18_18_3_3_3_3_4_4_4_4_4_4_4_4_4_4_4_4_4_4_4_4_4_4_18_18_4_4_4_4_4_3_3_4_4_4_5_5_6_6_5_5_6_6_5_5_34_34_34_34_34_34_5_5_5_5_6_6_5_6_6_5_6_6_6_6
7794,63,1332198000,6,7,5,1332231300,33300,5346540,6232860,886320,16_16_16_16_16_16_16_16_16_0_0_16_16_0_16_16_0_16_16_0_0_16_16_16_0_0_16_0_0_16_0_16_0_0_0_16_1_1_1_16_16_16_0_1_1_1_16_0_0_16_16_0_16_0_16_0_0_2_2_1_1_0_0_0_0_2_2_2_2_2_2_0_1_0_1_1_0_0_0_1_1_0_0_1_1_1_0_0_0_0_0_2_2_2_2_0_0_0_0_0_0_1_1_1_1_0_0_16_0_16_16_16_16_16_0_0_1_1_2_2_1_1_16_0_2_16_2_2_2_0_1_1_1_1_1_16_16_1_1_1_3_3_18_3_18_3_3_3_3_3_18_18_18_18_3_3_3_3_18_18_18_18_18_18_18_5_5_5_18_5_18_18_18_18_18_5_5_5_18_18_18_5_6_6_5_5_5_5_3_5_18_3_3_3_18_16_18_16_5_18_18_6_3_6_18_3_18_18_5_5_18_5_5_5_5_5_5_5_5_5_18_3_5_3_18_3_3_3_3_18_18_18_18_3_5_5_18_3_18_6_3_6_3_18_3_3_18_18_5_5_3_18_3_5_34_34_3_3_18_5_18_3_2_3_2_18_5_34_18_3_5_5_3_5_3_3_5_18_3_34_3_5_18_18_18_18_18_18_18_18_18_18_18_18_18_18_18_18_18_18_34_34_5_34_5_34_5_5_6_6
7795,194,1332198000,6,7,5,1332229380,31380,579720,615600,35880,53_53_6_6
7796,76,1332198000,6,7,5,1332229860,31860,6656400,7552500,896100,3_3_3_3_3_3_3_3_3_18_3_18_18_18_18_18_3_3_3_1_1_3_17_17_17_18_17_17_18_18_18_18_18_17_17_18_3_3_18_17_18_18_17_18_18_17_17_17_5_5_5_5_1_1_17_17_17_2_2_17_17_17_5_5_5_5_5_5_17_17_5_5_5_17_5_5_5_5_5_17_17_17_1_1_1_1_1_1_1_1_2_2_34_34_5_5_5_5_6_6_3_3_4_3_3_4_4_4_4_4_3_3_3_3_3_3_4_3_3_3_3_4_4_4_3_4_4_4_3_4_4_4_3_3_4_4_4_4_5_3_3_5_5_5_5_5_4_5_4_5_4_3_3_3_3_4_3_3_4_4_5_5_5_4_5_5_5_4_6_6_34_34_5_5_34_34_34_34_5_5_5_5_6_6
7797,64,1332198900,19,25,2,1332679500,480600,6098820,6845160,746340,1_1_11_11_5_5_1_1_6_6_1_1_19_19
7798,6,1332203160,16,14,16,1332203220,60,20580,133560,112980,16_16
7799,6,1332203220,16,14,16,1332218460,15240,20640,133560,112920,16_16_16
7800,58,1332205380,19,14,19,1332218400,13020,105660,992100,886440,19_19_19_1_19_19_1_19_19_19_19_19_19
7801,58,1332218400,19,14,19,1332221100,2700,118680,992100,873420,19_19_19_1_19_19_1_19_19_19_19_19_19_19
7802,6,1332218460,16,14,16,1332219600,1140,35880,133560,97680,16_16_16_16
7803,15,1332218880,17,12,17,1332220800,1920,1038900,1822860,783960,7_7_7_7_7_7_1_7_1_7_7_7_7_7_7_7_7_7_7_7_7_7_7_7_1_1_1_1_2_2_3_3_17_17_17_17_17_17_17_17_17_17
7804,13,1332219120,1,9,9,1332220560,1440,1652580,2525940,873360,19_19_19_1_1_19_19_19_19_19_19_19_19_19_19_19_1_1_1_19_1_19_19_19_19_19_19_19_19_19_19_1_19_1_19_19_19_19_19_19_1_1_1_1_19_19_19_19_1_1_1_1_1_1_19_19_1_19_1_19_19_19_19_19_2_2_9_9_2_2_1
7805,28,1332219540,0,0,0,1332246840,27300,0,493260,493260,0
7806,6,1332219600,16,20,1,1332230040,10440,37020,133560,96540,16_16_16_16_16
7807,179,1332219600,1,18,1,1332220500,900,164160,345960,181800,0_0_0_0_0_0_0_1_1_0_0_0_1
7808,196,1332219600,10,13,1,1332230520,10920,2418900,3281700,862800,7_7_7_7_7_7_7_7_7_7_7_7_7_7_7_7_7_7_7_7_1_1_1_1_7_7_1_1_7_7_1_1_7_7_7_1_1_7_7_7_7_7_7_7_7_7_1_1_7_7_7_30_30_7_1_7_7_1_7_1_1_7_7_7_1_7_7_1_1_1_7_7_30_30_1_1_10_10_10
7809,31,1332219780,5,9,5,1332220680,900,1373760,1374660,900,19_19_19_19_19_19_19_19_1_1_19_19_19_19_19_3_19_19_3_19_1_19_1_19_19_1_3_1_3_19_19_2_6_6_2_19_19_1_1_5_5_19_5_1_1_5_3_3_2_2_1_1_1_1_5_5_5_5_3_3_2_5_2_5_6_6_2_2_3_3_3_3_5_5_5_5_6_6_5
7810,22,1332220320,17,10,17,1332251820,31500,0,810360,810360,17
7811,185,1332220440,8,18,8,1332223200,2760,377460,441420,63960,26_26_3_3_26_26_8_26_8_26_26_26_8_8_8
7812,179,1332220500,1,18,9,1332244200,23700,165060,345960,180900,0_0_0_0_0_0_0_1_1_0_0_0_1_1
7813,13,1332220560,9,17,1,1332229440,8880,1654020,2525940,871920,19_19_19_1_1_19_19_19_19_19_19_19_19_19_19_19_1_1_1_19_1_19_19_19_19_19_19_19_19_19_19_1_19_1_19_19_19_19_19_19_1_1_1_1_19_19_19_19_1_1_1_1_1_1_19_19_1_19_1_19_19_19_19_19_2_2_9_9_2_2_1_9
7814,219,1332220680,18,23,18,1332223140,2460,2937420,3797940,860520,26_26_26_26_26_26_26_26_26_26_8_8_38_38_17_17_17_17_17_17_17_1_17_1_1_1_17_17_1_1_17_17_1_17_1_17_1_1_3_25_3_25_18
7815,31,1332220680,5,9,99,1332220680,0,1374660,1374660,0,19_19_19_19_19_19_19_19_1_1_19_19_19_19_19_3_19_19_3_19_1_19_1_19_19_1_3_1_3_19_19_2_6_6_2_19_19_1_1_5_5_19_5_1_1_5_3_3_2_2_1_1_1_1_5_5_5_5_3_3_2_5_2_5_6_6_2_2_3_3_3_3_5_5_5_5_6_6_5_5
7816,15,1332220800,17,8,5,1332235800,15000,1040820,1822860,782040,7_7_7_7_7_7_1_7_1_7_7_7_7_7_7_7_7_7_7_7_7_7_7_7_1_1_1_1_2_2_3_3_17_17_17_17_17_17_17_17_17_17_17
7817,58,1332221100,19,11,19,1332242940,21840,121380,992100,870720,19_19_19_1_19_19_1_19_19_19_19_19_19_19_19
7818,219,1332223140,18,23,18,1332230640,7500,2939880,3797940,858060,26_26_26_26_26_26_26_26_26_26_8_8_38_38_17_17_17_17_17_17_17_1_17_1_1_1_17_17_1_1_17_17_1_17_1_17_1_1_3_25_3_25_18_18
7819,186,1332223200,8,18,8,1332230400,7200,2837580,3636240,798660,7_7_7_7_7_7_7_7_7_1_7_1_7_7_7_1_7_7_1_7_7_7_7_7_7_1_7_1_1_1_38_38_1_1_24_24_24_24_24_8_24_24_8_24_24_24_24_24_8
7820,185,1332223200,8,18,3,1332237540,14340,380220,441420,61200,26_26_3_3_26_26_8_26_8_26_26_26_8_8_8_8
7821,32,1332224820,2,3,2,1332227460,2640,1202940,1205580,2640,10_1_1_10_10_10_10_10_1_1_3_3_3_3_6_6_5_5_2
7822,213,1332226800,5,9,5,1332238680,11880,3190380,3206820,16440,0_0_0_0_0_1_0_1_0_0_0_0_0_0_0_0_1_1_0_0_0_0_0_0_0_1_1_0_0_0_0_0_0_0_0_0_0_0_0_0_0_1_1_1_0_1_0_0_0_0_0_0_0_0_0_0_1_0_1_0_0_0_0_0_0_0_0_0_0_0_0_0_0_0_0_0_0_0_0_1_1_0_0_0_0_0_0_0_0_0_0_0_0_0_1_1_0_0_2_2_3_3_4_3_3_4_2_2_4_4_4_4_4_4_4_4_5_2_3_4_5_2_3_4_6_6_5_5_0_1_0_1_2_2_2_2_3_3_4_4_4_3_3_3_3_4_3_3_4_4_4_4_4_4_3_4_3_4_4_3_3_3_4_4_3_4_4_4_4_4_4_4_6_6_5
7823,131,1332226800,5,2,5,1332228600,1800,5966700,6825900,859200,16_16_16_16_16_16_16_16_16_16_16_16_16_16_16_16_16_16_16_16_16_16_16_16_16_16_1_1_1_1_2_2_3_3_3_3_18_18_18_18_18_3_3_3_3_18_18_18_18_18_18_18_18_18_18_18_18_18_18_18_18_18_18_18_5_5_5_5_5_5_5_5_5_5_5_5_6_6_5_5_6_6_5_5_5_5_5_5_5_5_5_5_6_6_5_5_34_34_34_34_3_3_18_18_18_18_18_18_6_6_5_5_34_34_5_5_5
7824,32,1332227460,2,3,99,1332227460,0,1205580,1205580,0,10_1_1_10_10_10_10_10_1_1_3_3_3_3_6_6_5_5_2_2
7825,131,1332228600,5,2,5,1332228600,0,5968500,6825900,857400,16_16_16_16_16_16_16_16_16_16_16_16_16_16_16_16_16_16_16_16_16_16_16_16_16_16_1_1_1_1_2_2_3_3_3_3_18_18_18_18_18_3_3_3_3_18_18_18_18_18_18_18_18_18_18_18_18_18_18_18_18_18_18_18_5_5_5_5_5_5_5_5_5_5_5_5_6_6_5_5_6_6_5_5_5_5_5_5_5_5_5_5_6_6_5_5_34_34_34_34_3_3_18_18_18_18_18_18_6_6_5_5_34_34_5_5_5_5
7826,131,1332228600,5,2,5,1332229500,900,5968500,6825900,857400,16_16_16_16_16_16_16_16_16_16_16_16_16_16_16_16_16_16_16_16_16_16_16_16_16_16_1_1_1_1_2_2_3_3_3_3_18_18_18_18_18_3_3_3_3_18_18_18_18_18_18_18_18_18_18_18_18_18_18_18_18_18_18_18_5_5_5_5_5_5_5_5_5_5_5_5_6_6_5_5_6_6_5_5_5_5_5_5_5_5_5_5_6_6_5_5_34_34_34_34_3_3_18_18_18_18_18_18_6_6_5_5_34_34_5_5_5_5_5
7827,75,1332228840,5,6,5,1332233340,4500,6120300,6135000,14700,16_16_16_16_16_16_1_16_16_1_16_16_16_16_16_16_16_16_1_1_2_2_39_39_1_1_3_3_3_3_3_3_3_3_3_3_2_3_3_2_18_18_18_18_18_18_18_18_18_18_18_18_18_18_18_18_18_18_5_5_6_6_6_6_5_5_34_34_6_6_5
7828,194,1332229380,5,9,5,1332233880,4500,611100,615600,4500,53_53_6_6_5
7829,13,1332229440,1,9,3,1332229560,120,1662900,2525940,863040,19_19_19_1_1_19_19_19_19_19_19_19_19_19_19_19_1_1_1_19_1_19_19_19_19_19_19_19_19_19_19_1_19_1_19_19_19_19_19_19_1_1_1_1_19_19_19_19_1_1_1_1_1_1_19_19_1_19_1_19_19_19_19_19_2_2_9_9_2_2_1_9_1
7830,131,1332229500,5,2,5,1332230400,900,5969400,6825900,856500,16_16_16_16_16_16_16_16_16_16_16_16_16_16_16_16_16_16_16_16_16_16_16_16_16_16_1_1_1_1_2_2_3_3_3_3_18_18_18_18_18_3_3_3_3_18_18_18_18_18_18_18_18_18_18_18_18_18_18_18_18_18_18_18_5_5_5_5_5_5_5_5_5_5_5_5_6_6_5_5_6_6_5_5_5_5_5_5_5_5_5_5_6_6_5_5_34_34_34_34_3_3_18_18_18_18_18_18_6_6_5_5_34_34_5_5_5_5_5_5_5
7831,131,1332229500,5,2,5,1332229500,0,5969400,6825900,856500,16_16_16_16_16_16_16_16_16_16_16_16_16_16_16_16_16_16_16_16_16_16_16_16_16_16_1_1_1_1_2_2_3_3_3_3_18_18_18_18_18_3_3_3_3_18_18_18_18_18_18_18_18_18_18_18_18_18_18_18_18_18_18_18_5_5_5_5_5_5_5_5_5_5_5_5_6_6_5_5_6_6_5_5_5_5_5_5_5_5_5_5_6_6_5_5_34_34_34_34_3_3_18_18_18_18_18_18_6_6_5_5_34_34_5_5_5_5_5_5
7832,13,1332229560,3,3,1,1332236160,6600,1663020,2525940,862920,19_19_19_1_1_19_19_19_19_19_19_19_19_19_19_19_1_1_1_19_1_19_19_19_19_19_19_19_19_19_19_1_19_1_19_19_19_19_19_19_1_1_1_1_19_19_19_19_1_1_1_1_1_1_19_19_1_19_1_19_19_19_19_19_2_2_9_9_2_2_1_9_1_3
7833,76,1332229860,5,6,5,1332234360,4500,6688260,7552500,864240,3_3_3_3_3_3_3_3_3_18_3_18_18_18_18_18_3_3_3_1_1_3_17_17_17_18_17_17_18_18_18_18_18_17_17_18_3_3_18_17_18_18_17_18_18_17_17_17_5_5_5_5_1_1_17_17_17_2_2_17_17_17_5_5_5_5_5_5_17_17_5_5_5_17_5_5_5_5_5_17_17_17_1_1_1_1_1_1_1_1_2_2_34_34_5_5_5_5_6_6_3_3_4_3_3_4_4_4_4_4_3_3_3_3_3_3_4_3_3_3_3_4_4_4_3_4_4_4_3_4_4_4_3_3_4_4_4_4_5_3_3_5_5_5_5_5_4_5_4_5_4_3_3_3_3_4_3_3_4_4_5_5_5_4_5_5_5_4_6_6_34_34_5_5_34_34_34_34_5_5_5_5_6_6_5
7834,6,1332230040,1,6,16,1332234420,4380,47460,133560,86100,16_16_16_16_16_1
7835,131,1332230400,5,2,5,1332231300,900,5970300,6825900,855600,16_16_16_16_16_16_16_16_16_16_16_16_16_16_16_16_16_16_16_16_16_16_16_16_16_16_1_1_1_1_2_2_3_3_3_3_18_18_18_18_18_3_3_3_3_18_18_18_18_18_18_18_18_18_18_18_18_18_18_18_18_18_18_18_5_5_5_5_5_5_5_5_5_5_5_5_6_6_5_5_6_6_5_5_5_5_5_5_5_5_5_5_6_6_5_5_34_34_34_34_3_3_18_18_18_18_18_18_6_6_5_5_34_34_5_5_5_5_5_5_5_5_5
7836,131,1332230400,5,2,5,1332230400,0,5970300,6825900,855600,16_16_16_16_16_16_16_16_16_16_16_16_16_16_16_16_16_16_16_16_16_16_16_16_16_16_1_1_1_1_2_2_3_3_3_3_18_18_18_18_18_3_3_3_3_18_18_18_18_18_18_18_18_18_18_18_18_18_18_18_18_18_18_18_5_5_5_5_5_5_5_5_5_5_5_5_6_6_5_5_6_6_5_5_5_5_5_5_5_5_5_5_6_6_5_5_34_34_34_34_3_3_18_18_18_18_18_18_6_6_5_5_34_34_5_5_5_5_5_5_5_5
7837,186,1332230400,8,18,2,1332968400,738000,2844780,3636240,791460,7_7_7_7_7_7_7_7_7_1_7_1_7_7_7_1_7_7_1_7_7_7_7_7_7_1_7_1_1_1_38_38_1_1_24_24_24_24_24_8_24_24_8_24_24_24_24_24_8_8
7838,196,1332230520,1,18,1,1332236100,5580,2429820,3281700,851880,7_7_7_7_7_7_7_7_7_7_7_7_7_7_7_7_7_7_7_7_1_1_1_1_7_7_1_1_7_7_1_1_7_7_7_1_1_7_7_7_7_7_7_7_7_7_1_1_7_7_7_30_30_7_1_7_7_1_7_1_1_7_7_7_1_7_7_1_1_1_7_7_30_30_1_1_10_10_10_1
7839,219,1332230640,18,23,18,1332240600,9960,2947380,3797940,850560,26_26_26_26_26_26_26_26_26_26_8_8_38_38_17_17_17_17_17_17_17_1_17_1_1_1_17_17_1_1_17_17_1_17_1_17_1_1_3_25_3_25_18_18_18
7840,131,1332231300,5,2,6,1332280800,49500,5971200,6825900,854700,16_16_16_16_16_16_16_16_16_16_16_16_16_16_16_16_16_16_16_16_16_16_16_16_16_16_1_1_1_1_2_2_3_3_3_3_18_18_18_18_18_3_3_3_3_18_18_18_18_18_18_18_18_18_18_18_18_18_18_18_18_18_18_18_5_5_5_5_5_5_5_5_5_5_5_5_6_6_5_5_6_6_5_5_5_5_5_5_5_5_5_5_6_6_5_5_34_34_34_34_3_3_18_18_18_18_18_18_6_6_5_5_34_34_5_5_5_5_5_5_5_5_5_5
7841,63,1332231300,5,2,5,1332240600,9300,5379840,6232860,853020,16_16_16_16_16_16_16_16_16_0_0_16_16_0_16_16_0_16_16_0_0_16_16_16_0_0_16_0_0_16_0_16_0_0_0_16_1_1_1_16_16_16_0_1_1_1_16_0_0_16_16_0_16_0_16_0_0_2_2_1_1_0_0_0_0_2_2_2_2_2_2_0_1_0_1_1_0_0_0_1_1_0_0_1_1_1_0_0_0_0_0_2_2_2_2_0_0_0_0_0_0_1_1_1_1_0_0_16_0_16_16_16_16_16_0_0_1_1_2_2_1_1_16_0_2_16_2_2_2_0_1_1_1_1_1_16_16_1_1_1_3_3_18_3_18_3_3_3_3_3_18_18_18_18_3_3_3_3_18_18_18_18_18_18_18_5_5_5_18_5_18_18_18_18_18_5_5_5_18_18_18_5_6_6_5_5_5_5_3_5_18_3_3_3_18_16_18_16_5_18_18_6_3_6_18_3_18_18_5_5_18_5_5_5_5_5_5_5_5_5_18_3_5_3_18_3_3_3_3_18_18_18_18_3_5_5_18_3_18_6_3_6_3_18_3_3_18_18_5_5_3_18_3_5_34_34_3_3_18_5_18_3_2_3_2_18_5_34_18_3_5_5_3_5_3_3_5_18_3_34_3_5_18_18_18_18_18_18_18_18_18_18_18_18_18_18_18_18_18_18_34_34_5_34_5_34_5_5_6_6_5
7842,75,1332233340,5,6,2,1332239040,5700,6124800,6135000,10200,16_16_16_16_16_16_1_16_16_1_16_16_16_16_16_16_16_16_1_1_2_2_39_39_1_1_3_3_3_3_3_3_3_3_3_3_2_3_3_2_18_18_18_18_18_18_18_18_18_18_18_18_18_18_18_18_18_18_5_5_6_6_6_6_5_5_34_34_6_6_5_5
7843,194,1332233880,5,9,99,1332233880,0,615600,615600,0,53_53_6_6_5_5
7844,42,1332234120,1,6,1,1332237720,3600,100080,953340,853260,16_16_16_16_1
7845,76,1332234360,5,6,5,1332328800,94440,6692760,7552500,859740,3_3_3_3_3_3_3_3_3_18_3_18_18_18_18_18_3_3_3_1_1_3_17_17_17_18_17_17_18_18_18_18_18_17_17_18_3_3_18_17_18_18_17_18_18_17_17_17_5_5_5_5_1_1_17_17_17_2_2_17_17_17_5_5_5_5_5_5_17_17_5_5_5_17_5_5_5_5_5_17_17_17_1_1_1_1_1_1_1_1_2_2_34_34_5_5_5_5_6_6_3_3_4_3_3_4_4_4_4_4_3_3_3_3_3_3_4_3_3_3_3_4_4_4_3_4_4_4_3_4_4_4_3_3_4_4_4_4_5_3_3_5_5_5_5_5_4_5_4_5_4_3_3_3_3_4_3_3_4_4_5_5_5_4_5_5_5_4_6_6_34_34_5_5_34_34_34_34_5_5_5_5_6_6_5_5
7846,6,1332234420,16,20,1,1332237240,2820,51840,133560,81720,16_16_16_16_16_1_16
7847,209,1332234480,16,20,16,1332258960,24480,644880,1091400,446520,16_16_16
7848,15,1332235800,5,18,5,1332243000,7200,1055820,1822860,767040,7_7_7_7_7_7_1_7_1_7_7_7_7_7_7_7_7_7_7_7_7_7_7_7_1_1_1_1_2_2_3_3_17_17_17_17_17_17_17_17_17_17_17_5
7849,196,1332236100,1,18,10,1332261000,24900,2435400,3281700,846300,7_7_7_7_7_7_7_7_7_7_7_7_7_7_7_7_7_7_7_7_1_1_1_1_7_7_1_1_7_7_1_1_7_7_7_1_1_7_7_7_7_7_7_7_7_7_1_1_7_7_7_30_30_7_1_7_7_1_7_1_1_7_7_7_1_7_7_1_1_1_7_7_30_30_1_1_10_10_10_1_1
7850,13,1332236160,1,9,3,1332237480,1320,1669620,2525940,856320,19_19_19_1_1_19_19_19_19_19_19_19_19_19_19_19_1_1_1_19_1_19_19_19_19_19_19_19_19_19_19_1_19_1_19_19_19_19_19_19_1_1_1_1_19_19_19_19_1_1_1_1_1_1_19_19_1_19_1_19_19_19_19_19_2_2_9_9_2_2_1_9_1_3_1
7851,6,1332237240,1,6,1,1332305700,68460,54660,133560,78900,16_16_16_16_16_1_16_1
7852,13,1332237480,3,3,9,1332238380,900,1670940,2525940,855000,19_19_19_1_1_19_19_19_19_19_19_19_19_19_19_19_1_1_1_19_1_19_19_19_19_19_19_19_19_19_19_1_19_1_19_19_19_19_19_19_1_1_1_1_19_19_19_19_1_1_1_1_1_1_19_19_1_19_1_19_19_19_19_19_2_2_9_9_2_2_1_9_1_3_1_3
7853,185,1332237540,3,3,3,1332239700,2160,394560,441420,46860,26_26_3_3_26_26_8_26_8_26_26_26_8_8_8_8_3
7854,42,1332237720,1,6,2,1332243420,5700,103680,953340,849660,16_16_16_16_1_1
7855,13,1332238380,9,17,1,1332240300,1920,1671840,2525940,854100,19_19_19_1_1_19_19_19_19_19_19_19_19_19_19_19_1_1_1_19_1_19_19_19_19_19_19_19_19_19_19_1_19_1_19_19_19_19_19_19_1_1_1_1_19_19_19_19_1_1_1_1_1_1_19_19_1_19_1_19_19_19_19_19_2_2_9_9_2_2_1_9_1_3_1_3_9
7856,213,1332238680,5,9,5,1332238740,60,3202260,3206820,4560,0_0_0_0_0_1_0_1_0_0_0_0_0_0_0_0_1_1_0_0_0_0_0_0_0_1_1_0_0_0_0_0_0_0_0_0_0_0_0_0_0_1_1_1_0_1_0_0_0_0_0_0_0_0_0_0_1_0_1_0_0_0_0_0_0_0_0_0_0_0_0_0_0_0_0_0_0_0_0_1_1_0_0_0_0_0_0_0_0_0_0_0_0_0_1_1_0_0_2_2_3_3_4_3_3_4_2_2_4_4_4_4_4_4_4_4_5_2_3_4_5_2_3_4_6_6_5_5_0_1_0_1_2_2_2_2_3_3_4_4_4_3_3_3_3_4_3_3_4_4_4_4_4_4_3_4_3_4_4_3_3_3_4_4_3_4_4_4_4_4_4_4_6_6_5_5
7857,213,1332238740,5,9,5,1332243240,4500,3202320,3206820,4500,0_0_0_0_0_1_0_1_0_0_0_0_0_0_0_0_1_1_0_0_0_0_0_0_0_1_1_0_0_0_0_0_0_0_0_0_0_0_0_0_0_1_1_1_0_1_0_0_0_0_0_0_0_0_0_0_1_0_1_0_0_0_0_0_0_0_0_0_0_0_0_0_0_0_0_0_0_0_0_1_1_0_0_0_0_0_0_0_0_0_0_0_0_0_1_1_0_0_2_2_3_3_4_3_3_4_2_2_4_4_4_4_4_4_4_4_5_2_3_4_5_2_3_4_6_6_5_5_0_1_0_1_2_2_2_2_3_3_4_4_4_3_3_3_3_4_3_3_4_4_4_4_4_4_3_4_3_4_4_3_3_3_4_4_3_4_4_4_4_4_4_4_6_6_5_5_5
7858,75,1332239040,2,4,2,1332243540,4500,6130500,6135000,4500,16_16_16_16_16_16_1_16_16_1_16_16_16_16_16_16_16_16_1_1_2_2_39_39_1_1_3_3_3_3_3_3_3_3_3_3_2_3_3_2_18_18_18_18_18_18_18_18_18_18_18_18_18_18_18_18_18_18_5_5_6_6_6_6_5_5_34_34_6_6_5_5_2
7859,185,1332239700,3,3,2,1332239760,60,396720,441420,44700,26_26_3_3_26_26_8_26_8_26_26_26_8_8_8_8_3_3
7860,185,1332239760,2,4,2,1332240420,660,396780,441420,44640,26_26_3_3_26_26_8_26_8_26_26_26_8_8_8_8_3_3_2
7861,13,1332240300,1,9,1,1332240660,360,1673760,2525940,852180,19_19_19_1_1_19_19_19_19_19_19_19_19_19_19_19_1_1_1_19_1_19_19_19_19_19_19_19_19_19_19_1_19_1_19_19_19_19_19_19_1_1_1_1_19_19_19_19_1_1_1_1_1_1_19_19_1_19_1_19_19_19_19_19_2_2_9_9_2_2_1_9_1_3_1_3_9_1
7862,185,1332240420,2,4,5,1332243000,2580,397440,441420,43980,26_26_3_3_26_26_8_26_8_26_26_26_8_8_8_8_3_3_2_2
7863,63,1332240600,5,2,6,1332280800,40200,5389140,6232860,843720,16_16_16_16_16_16_16_16_16_0_0_16_16_0_16_16_0_16_16_0_0_16_16_16_0_0_16_0_0_16_0_16_0_0_0_16_1_1_1_16_16_16_0_1_1_1_16_0_0_16_16_0_16_0_16_0_0_2_2_1_1_0_0_0_0_2_2_2_2_2_2_0_1_0_1_1_0_0_0_1_1_0_0_1_1_1_0_0_0_0_0_2_2_2_2_0_0_0_0_0_0_1_1_1_1_0_0_16_0_16_16_16_16_16_0_0_1_1_2_2_1_1_16_0_2_16_2_2_2_0_1_1_1_1_1_16_16_1_1_1_3_3_18_3_18_3_3_3_3_3_18_18_18_18_3_3_3_3_18_18_18_18_18_18_18_5_5_5_18_5_18_18_18_18_18_5_5_5_18_18_18_5_6_6_5_5_5_5_3_5_18_3_3_3_18_16_18_16_5_18_18_6_3_6_18_3_18_18_5_5_18_5_5_5_5_5_5_5_5_5_18_3_5_3_18_3_3_3_3_18_18_18_18_3_5_5_18_3_18_6_3_6_3_18_3_3_18_18_5_5_3_18_3_5_34_34_3_3_18_5_18_3_2_3_2_18_5_34_18_3_5_5_3_5_3_3_5_18_3_34_3_5_18_18_18_18_18_18_18_18_18_18_18_18_18_18_18_18_18_18_34_34_5_34_5_34_5_5_6_6_5_5
7864,219,1332240600,18,23,18,1332241200,600,2957340,3797940,840600,26_26_26_26_26_26_26_26_26_26_8_8_38_38_17_17_17_17_17_17_17_1_17_1_1_1_17_17_1_1_17_17_1_17_1_17_1_1_3_25_3_25_18_18_18_18
7865,13,1332240660,1,9,1,1332243660,3000,1674120,2525940,851820,19_19_19_1_1_19_19_19_19_19_19_19_19_19_19_19_1_1_1_19_1_19_19_19_19_19_19_19_19_19_19_1_19_1_19_19_19_19_19_19_1_1_1_1_19_19_19_19_1_1_1_1_1_1_19_19_1_19_1_19_19_19_19_19_2_2_9_9_2_2_1_9_1_3_1_3_9_1_1
7866,219,1332241200,18,23,18,1332255960,14760,2957940,3797940,840000,26_26_26_26_26_26_26_26_26_26_8_8_38_38_17_17_17_17_17_17_17_1_17_1_1_1_17_17_1_1_17_17_1_17_1_17_1_1_3_25_3_25_18_18_18_18_18
7867,58,1332242940,19,11,1,1332247020,4080,143220,992100,848880,19_19_19_1_19_19_1_19_19_19_19_19_19_19_19_19
7868,185,1332243000,5,18,5,1332246600,3600,400020,441420,41400,26_26_3_3_26_26_8_26_8_26_26_26_8_8_8_8_3_3_2_2_5
7869,15,1332243000,5,18,5,1332252000,9000,1063020,1822860,759840,7_7_7_7_7_7_1_7_1_7_7_7_7_7_7_7_7_7_7_7_7_7_7_7_1_1_1_1_2_2_3_3_17_17_17_17_17_17_17_17_17_17_17_5_5
7870,213,1332243240,5,9,99,1332243240,0,3206820,3206820,0,0_0_0_0_0_1_0_1_0_0_0_0_0_0_0_0_1_1_0_0_0_0_0_0_0_1_1_0_0_0_0_0_0_0_0_0_0_0_0_0_0_1_1_1_0_1_0_0_0_0_0_0_0_0_0_0_1_0_1_0_0_0_0_0_0_0_0_0_0_0_0_0_0_0_0_0_0_0_0_1_1_0_0_0_0_0_0_0_0_0_0_0_0_0_1_1_0_0_2_2_3_3_4_3_3_4_2_2_4_4_4_4_4_4_4_4_5_2_3_4_5_2_3_4_6_6_5_5_0_1_0_1_2_2_2_2_3_3_4_4_4_3_3_3_3_4_3_3_4_4_4_4_4_4_3_4_3_4_4_3_3_3_4_4_3_4_4_4_4_4_4_4_6_6_5_5_5_5
7871,42,1332243420,2,4,2,1332247920,4500,109380,953340,843960,16_16_16_16_1_1_2
7872,75,1332243540,2,4,99,1332243540,0,6135000,6135000,0,16_16_16_16_16_16_1_16_16_1_16_16_16_16_16_16_16_16_1_1_2_2_39_39_1_1_3_3_3_3_3_3_3_3_3_3_2_3_3_2_18_18_18_18_18_18_18_18_18_18_18_18_18_18_18_18_18_18_5_5_6_6_6_6_5_5_34_34_6_6_5_5_2_2
7873,13,1332243660,1,9,19,1332394380,150720,1677120,2525940,848820,19_19_19_1_1_19_19_19_19_19_19_19_19_19_19_19_1_1_1_19_1_19_19_19_19_19_19_19_19_19_19_1_19_1_19_19_19_19_19_19_1_1_1_1_19_19_19_19_1_1_1_1_1_1_19_19_1_19_1_19_19_19_19_19_2_2_9_9_2_2_1_9_1_3_1_3_9_1_1_1
7874,179,1332244200,9,3,9,1332247800,3600,188760,345960,157200,0_0_0_0_0_0_0_1_1_0_0_0_1_1_9
7875,220,1332244260,3,4,3,1332248040,3780,1899900,2714040,814140,0_0_0_0_1_0_1_0_0_0_0_0_1_0_0_1_0_0_0_0_0_0_0_0_0_0_0_0_0_0_0_1_1_0_1_1_1_1_0_0_1_1_2_2_2_2_2_2_2_2_27_27_27_27_27_27_27_27_27_27_27_27_27_27_27_27_3
7876,170,1332246120,19,11,19,1332266700,20580,0,665160,665160,19
7877,185,1332246600,5,18,5,1332255840,9240,403620,441420,37800,26_26_3_3_26_26_8_26_8_26_26_26_8_8_8_8_3_3_2_2_5_5
7878,28,1332246840,0,0,0,1332246900,60,27300,493260,465960,0_0
7879,28,1332246900,0,0,0,1332251880,4980,27360,493260,465900,0_0_0
7880,58,1332247020,1,18,1,1332252000,4980,147300,992100,844800,19_19_19_1_19_19_1_19_19_19_19_19_19_19_19_19_1
7881,179,1332247800,9,3,9,1332247860,60,192360,345960,153600,0_0_0_0_0_0_0_1_1_0_0_0_1_1_9_9
7882,152,1332247800,3,3,3,1332247860,60,3000360,3766500,766140,17_17_17_17_17_17_17_17_17_17_17_17_1_1_2_2_17_17_17_17_3
7883,152,1332247860,3,3,3,1332317400,69540,3000420,3766500,766080,17_17_17_17_17_17_17_17_17_17_17_17_1_1_2_2_17_17_17_17_3_3
7884,179,1332247860,9,3,9,1332252360,4500,192420,345960,153540,0_0_0_0_0_0_0_1_1_0_0_0_1_1_9_9_9
7885,42,1332247920,2,4,3,1332826020,578100,113880,953340,839460,16_16_16_16_1_1_2_2
7886,220,1332248040,3,4,3,1332251460,3420,1903680,2714040,810360,0_0_0_0_1_0_1_0_0_0_0_0_1_0_0_1_0_0_0_0_0_0_0_0_0_0_0_0_0_0_0_1_1_0_1_1_1_1_0_0_1_1_2_2_2_2_2_2_2_2_27_27_27_27_27_27_27_27_27_27_27_27_27_27_27_27_3_3
7887,220,1332251460,3,3,3,1332258780,7320,1907100,2714040,806940,0_0_0_0_1_0_1_0_0_0_0_0_1_0_0_1_0_0_0_0_0_0_0_0_0_0_0_0_0_0_0_1_1_0_1_1_1_1_0_0_1_1_2_2_2_2_2_2_2_2_27_27_27_27_27_27_27_27_27_27_27_27_27_27_27_27_3_3_3
7888,22,1332251820,17,10,17,1332333300,81480,31500,810360,778860,17_17
7889,28,1332251880,0,0,0,1332251940,60,32340,493260,460920,0_0_0_0
7890,28,1332251940,0,20,0,1332258840,6900,32400,493260,460860,0_0_0_0_0
7891,15,1332252000,5,18,5,1332253980,1980,1072020,1822860,750840,7_7_7_7_7_7_1_7_1_7_7_7_7_7_7_7_7_7_7_7_7_7_7_7_1_1_1_1_2_2_3_3_17_17_17_17_17_17_17_17_17_17_17_5_5_5
7892,58,1332252000,1,18,1,1332305100,53100,152280,992100,839820,19_19_19_1_19_19_1_19_19_19_19_19_19_19_19_19_1_1
7893,179,1332252360,9,3,1,1332253800,1440,196920,345960,149040,0_0_0_0_0_0_0_1_1_0_0_0_1_1_9_9_9_9
7894,179,1332253800,1,18,1,1332256740,2940,198360,345960,147600,0_0_0_0_0_0_0_1_1_0_0_0_1_1_9_9_9_9_1
7895,15,1332253980,5,18,17,1332258720,4740,1074000,1822860,748860,7_7_7_7_7_7_1_7_1_7_7_7_7_7_7_7_7_7_7_7_7_7_7_7_1_1_1_1_2_2_3_3_17_17_17_17_17_17_17_17_17_17_17_5_5_5_5
7896,185,1332255840,5,18,5,1332255900,60,412860,441420,28560,26_26_3_3_26_26_8_26_8_26_26_26_8_8_8_8_3_3_2_2_5_5_5
7897,185,1332255900,5,18,6,1332280800,24900,412920,441420,28500,26_26_3_3_26_26_8_26_8_26_26_26_8_8_8_8_3_3_2_2_5_5_5_5
7898,219,1332255960,18,23,18,1332255960,0,2972700,3797940,825240,26_26_26_26_26_26_26_26_26_26_8_8_38_38_17_17_17_17_17_17_17_1_17_1_1_1_17_17_1_1_17_17_1_17_1_17_1_1_3_25_3_25_18_18_18_18_18_18
7899,219,1332255960,18,23,18,1332263580,7620,2972700,3797940,825240,26_26_26_26_26_26_26_26_26_26_8_8_38_38_17_17_17_17_17_17_17_1_17_1_1_1_17_17_1_1_17_17_1_17_1_17_1_1_3_25_3_25_18_18_18_18_18_18_18
7900,179,1332256740,1,18,5,1332256800,60,201300,345960,144660,0_0_0_0_0_0_0_1_1_0_0_0_1_1_9_9_9_9_1_1
7901,179,1332256800,5,18,9,1332256920,120,201360,345960,144600,0_0_0_0_0_0_0_1_1_0_0_0_1_1_9_9_9_9_1_1_5
7902,178,1332256800,9,3,9,1332256860,60,531000,904200,373200,10_10_10_10_10_10_10_10_10_10_10_10_10_1_10_1_10_10_1_1_1_1_2_2_9
7903,178,1332256860,9,3,13,1332340500,83640,531060,904200,373140,10_10_10_10_10_10_10_10_10_10_10_10_10_1_10_1_10_10_1_1_1_1_2_2_9_9
7904,179,1332256920,9,3,9,1332256980,60,201480,345960,144480,0_0_0_0_0_0_0_1_1_0_0_0_1_1_9_9_9_9_1_1_5_9
7905,179,1332256980,3,3,5,1332259200,2220,201540,345960,144420,0_0_0_0_0_0_0_1_1_0_0_0_1_1_9_9_9_9_1_1_5_9_9_3
7906,179,1332256980,9,3,3,1332256980,0,201540,345960,144420,0_0_0_0_0_0_0_1_1_0_0_0_1_1_9_9_9_9_1_1_5_9_9
7907,15,1332258720,17,8,17,1332271800,13080,1078740,1822860,744120,7_7_7_7_7_7_1_7_1_7_7_7_7_7_7_7_7_7_7_7_7_7_7_7_1_1_1_1_2_2_3_3_17_17_17_17_17_17_17_17_17_17_17_5_5_5_5_17
7908,220,1332258780,3,3,3,1332280800,22020,1914420,2714040,799620,0_0_0_0_1_0_1_0_0_0_0_0_1_0_0_1_0_0_0_0_0_0_0_0_0_0_0_0_0_0_0_1_1_0_1_1_1_1_0_0_1_1_2_2_2_2_2_2_2_2_27_27_27_27_27_27_27_27_27_27_27_27_27_27_27_27_3_3_3_3
7909,28,1332258840,0,20,0,1332258840,0,39300,493260,453960,0_0_0_0_0_0
7910,28,1332258840,0,1,0,1332275760,16920,39300,493260,453960,0_0_0_0_0_0_0
7911,209,1332258960,16,20,16,1332275640,16680,669360,1091400,422040,16_16_16_16
7912,179,1332259200,5,18,2,1332259320,120,203760,345960,142200,0_0_0_0_0_0_0_1_1_0_0_0_1_1_9_9_9_9_1_1_5_9_9_3_5
7913,179,1332259320,2,3,2,1332259380,60,203880,345960,142080,0_0_0_0_0_0_0_1_1_0_0_0_1_1_9_9_9_9_1_1_5_9_9_3_5_2
7914,179,1332259380,2,3,3,1332261480,2100,203940,345960,142020,0_0_0_0_0_0_0_1_1_0_0_0_1_1_9_9_9_9_1_1_5_9_9_3_5_2_2
7915,196,1332261000,10,13,10,1332264480,3480,2460300,3281700,821400,7_7_7_7_7_7_7_7_7_7_7_7_7_7_7_7_7_7_7_7_1_1_1_1_7_7_1_1_7_7_1_1_7_7_7_1_1_7_7_7_7_7_7_7_7_7_1_1_7_7_7_30_30_7_1_7_7_1_7_1_1_7_7_7_1_7_7_1_1_1_7_7_30_30_1_1_10_10_10_1_1_10
7916,179,1332261480,3,3,6,1332367200,105720,206040,345960,139920,0_0_0_0_0_0_0_1_1_0_0_0_1_1_9_9_9_9_1_1_5_9_9_3_5_2_2_3
7917,219,1332263580,18,23,18,1332267180,3600,2980320,3797940,817620,26_26_26_26_26_26_26_26_26_26_8_8_38_38_17_17_17_17_17_17_17_1_17_1_1_1_17_17_1_1_17_17_1_17_1_17_1_1_3_25_3_25_18_18_18_18_18_18_18_18
7918,196,1332264480,10,16,10,1332280200,15720,2463780,3281700,817920,7_7_7_7_7_7_7_7_7_7_7_7_7_7_7_7_7_7_7_7_1_1_1_1_7_7_1_1_7_7_1_1_7_7_7_1_1_7_7_7_7_7_7_7_7_7_1_1_7_7_7_30_30_7_1_7_7_1_7_1_1_7_7_7_1_7_7_1_1_1_7_7_30_30_1_1_10_10_10_1_1_10_10
7919,170,1332266700,19,11,19,1332266820,120,20580,665160,644580,19_19
7920,170,1332266820,19,14,19,1332278340,11520,20700,665160,644460,19_19_19
7921,219,1332267180,18,19,18,1332290160,22980,2983920,3797940,814020,26_26_26_26_26_26_26_26_26_26_8_8_38_38_17_17_17_17_17_17_17_1_17_1_1_1_17_17_1_1_17_17_1_17_1_17_1_1_3_25_3_25_18_18_18_18_18_18_18_18_18
7922,15,1332271800,17,12,6,1332280800,9000,1091820,1822860,731040,7_7_7_7_7_7_1_7_1_7_7_7_7_7_7_7_7_7_7_7_7_7_7_7_1_1_1_1_2_2_3_3_17_17_17_17_17_17_17_17_17_17_17_5_5_5_5_17_17
7923,209,1332275640,16,1,16,1332281520,5880,686040,1091400,405360,16_16_16_16_16
7924,28,1332275760,0,1,1,1332325680,49920,56220,493260,437040,0_0_0_0_0_0_0_0
7925,7,1332278280,0,1,0,1332304440,26160,0,40380,40380,0
7926,170,1332278340,19,14,19,1332278460,120,32220,665160,632940,19_19_19_19
7927,170,1332278460,19,14,19,1332292980,14520,32340,665160,632820,19_19_19_19_19
7928,196,1332280200,10,16,10,1332306960,26760,2479500,3281700,802200,7_7_7_7_7_7_7_7_7_7_7_7_7_7_7_7_7_7_7_7_1_1_1_1_7_7_1_1_7_7_1_1_7_7_7_1_1_7_7_7_7_7_7_7_7_7_1_1_7_7_7_30_30_7_1_7_7_1_7_1_1_7_7_7_1_7_7_1_1_1_7_7_30_30_1_1_10_10_10_1_1_10_10_10
7929,26,1332280800,3,4,3,1332285300,4500,1431960,2036760,604800,16_16_16_16_16_16_16_1_1_16_1_1_2_2_25_9_25_9_3_3_18_18_18_18_15_15_15_15_3
7930,15,1332280800,6,7,6,1332280800,0,1100820,1822860,722040,7_7_7_7_7_7_1_7_1_7_7_7_7_7_7_7_7_7_7_7_7_7_7_7_1_1_1_1_2_2_3_3_17_17_17_17_17_17_17_17_17_17_17_5_5_5_5_17_17_6
7931,15,1332280800,6,7,6,1332284400,3600,1100820,1822860,722040,7_7_7_7_7_7_1_7_1_7_7_7_7_7_7_7_7_7_7_7_7_7_7_7_1_1_1_1_2_2_3_3_17_17_17_17_17_17_17_17_17_17_17_5_5_5_5_17_17_6_6
7932,220,1332280800,3,4,3,1332285300,4500,1936440,2714040,777600,0_0_0_0_1_0_1_0_0_0_0_0_1_0_0_1_0_0_0_0_0_0_0_0_0_0_0_0_0_0_0_1_1_0_1_1_1_1_0_0_1_1_2_2_2_2_2_2_2_2_27_27_27_27_27_27_27_27_27_27_27_27_27_27_27_27_3_3_3_3_3_3
7933,220,1332280800,3,4,3,1332280800,0,1936440,2714040,777600,0_0_0_0_1_0_1_0_0_0_0_0_1_0_0_1_0_0_0_0_0_0_0_0_0_0_0_0_0_0_0_1_1_0_1_1_1_1_0_0_1_1_2_2_2_2_2_2_2_2_27_27_27_27_27_27_27_27_27_27_27_27_27_27_27_27_3_3_3_3_3
7934,131,1332280800,6,7,6,1332284400,3600,6020700,6825900,805200,16_16_16_16_16_16_16_16_16_16_16_16_16_16_16_16_16_16_16_16_16_16_16_16_16_16_1_1_1_1_2_2_3_3_3_3_18_18_18_18_18_3_3_3_3_18_18_18_18_18_18_18_18_18_18_18_18_18_18_18_18_18_18_18_5_5_5_5_5_5_5_5_5_5_5_5_6_6_5_5_6_6_5_5_5_5_5_5_5_5_5_5_6_6_5_5_34_34_34_34_3_3_18_18_18_18_18_18_6_6_5_5_34_34_5_5_5_5_5_5_5_5_5_5_6
7935,141,1332280800,6,7,6,1332284400,3600,6627600,7406100,778500,1_1_16_16_16_16_16_1_16_16_1_1_1_16_16_16_16_16_16_16_16_16_16_16_16_16_16_16_1_1_1_1_1_1_1_1_1_1_1_1_16_2_2_16_3_3_3_3_3_3_18_18_18_18_18_3_18_3_3_3_5_5_5_5_5_5_3_3_4_4_4_4_4_3_1_3_1_4_18_3_3_18_18_1_1_18_18_5_5_18_5_5_5_5_6_6_5_5_6_6_6_6_5_5_5_5_5_5_5_5_6_6_5_5_5_5_5_5_5_5_5_5_5_5_34_34_34_34_5_5_5_5_34_34_6_6_5_5_6
7936,185,1332280800,6,7,6,1332284400,3600,437820,441420,3600,26_26_3_3_26_26_8_26_8_26_26_26_8_8_8_8_3_3_2_2_5_5_5_5_6
7937,30,1332280800,0,20,0,1332285300,4500,0,604800,604800,0
7938,2,1332280800,6,7,6,1332284400,3600,2530260,2555640,25380,10_10_10_10_10_10_10_10_1_1_2_2_9_9_3_3_4_4_4_4_11_11_5_5_6
7939,63,1332280800,6,7,6,1332284400,3600,5429340,6232860,803520,16_16_16_16_16_16_16_16_16_0_0_16_16_0_16_16_0_16_16_0_0_16_16_16_0_0_16_0_0_16_0_16_0_0_0_16_1_1_1_16_16_16_0_1_1_1_16_0_0_16_16_0_16_0_16_0_0_2_2_1_1_0_0_0_0_2_2_2_2_2_2_0_1_0_1_1_0_0_0_1_1_0_0_1_1_1_0_0_0_0_0_2_2_2_2_0_0_0_0_0_0_1_1_1_1_0_0_16_0_16_16_16_16_16_0_0_1_1_2_2_1_1_16_0_2_16_2_2_2_0_1_1_1_1_1_16_16_1_1_1_3_3_18_3_18_3_3_3_3_3_18_18_18_18_3_3_3_3_18_18_18_18_18_18_18_5_5_5_18_5_18_18_18_18_18_5_5_5_18_18_18_5_6_6_5_5_5_5_3_5_18_3_3_3_18_16_18_16_5_18_18_6_3_6_18_3_18_18_5_5_18_5_5_5_5_5_5_5_5_5_18_3_5_3_18_3_3_3_3_18_18_18_18_3_5_5_18_3_18_6_3_6_3_18_3_3_18_18_5_5_3_18_3_5_34_34_3_3_18_5_18_3_2_3_2_18_5_34_18_3_5_5_3_5_3_3_5_18_3_34_3_5_18_18_18_18_18_18_18_18_18_18_18_18_18_18_18_18_18_18_34_34_5_34_5_34_5_5_6_6_5_5_6
7940,209,1332281520,16,1,16,1332281580,60,691920,1091400,399480,16_16_16_16_16_16
7941,209,1332281580,16,14,16,1332304320,22740,691980,1091400,399420,16_16_16_16_16_16_16
7942,2,1332284400,6,7,5,1332306120,21720,2533860,2555640,21780,10_10_10_10_10_10_10_10_1_1_2_2_9_9_3_3_4_4_4_4_11_11_5_5_6_6
7943,15,1332284400,6,7,6,1332284400,0,1104420,1822860,718440,7_7_7_7_7_7_1_7_1_7_7_7_7_7_7_7_7_7_7_7_7_7_7_7_1_1_1_1_2_2_3_3_17_17_17_17_17_17_17_17_17_17_17_5_5_5_5_17_17_6_6_6
7944,15,1332284400,6,7,17,1332293340,8940,1104420,1822860,718440,7_7_7_7_7_7_1_7_1_7_7_7_7_7_7_7_7_7_7_7_7_7_7_7_1_1_1_1_2_2_3_3_17_17_17_17_17_17_17_17_17_17_17_5_5_5_5_17_17_6_6_6_6
7945,141,1332284400,6,7,1,1333054800,770400,6631200,7406100,774900,1_1_16_16_16_16_16_1_16_16_1_1_1_16_16_16_16_16_16_16_16_16_16_16_16_16_16_16_1_1_1_1_1_1_1_1_1_1_1_1_16_2_2_16_3_3_3_3_3_3_18_18_18_18_18_3_18_3_3_3_5_5_5_5_5_5_3_3_4_4_4_4_4_3_1_3_1_4_18_3_3_18_18_1_1_18_18_5_5_18_5_5_5_5_6_6_5_5_6_6_6_6_5_5_5_5_5_5_5_5_6_6_5_5_5_5_5_5_5_5_5_5_5_5_34_34_34_34_5_5_5_5_34_34_6_6_5_5_6_6
7946,185,1332284400,6,7,99,1332284400,0,441420,441420,0,26_26_3_3_26_26_8_26_8_26_26_26_8_8_8_8_3_3_2_2_5_5_5_5_6_6
7947,63,1332284400,6,7,5,1332334800,50400,5432940,6232860,799920,16_16_16_16_16_16_16_16_16_0_0_16_16_0_16_16_0_16_16_0_0_16_16_16_0_0_16_0_0_16_0_16_0_0_0_16_1_1_1_16_16_16_0_1_1_1_16_0_0_16_16_0_16_0_16_0_0_2_2_1_1_0_0_0_0_2_2_2_2_2_2_0_1_0_1_1_0_0_0_1_1_0_0_1_1_1_0_0_0_0_0_2_2_2_2_0_0_0_0_0_0_1_1_1_1_0_0_16_0_16_16_16_16_16_0_0_1_1_2_2_1_1_16_0_2_16_2_2_2_0_1_1_1_1_1_16_16_1_1_1_3_3_18_3_18_3_3_3_3_3_18_18_18_18_3_3_3_3_18_18_18_18_18_18_18_5_5_5_18_5_18_18_18_18_18_5_5_5_18_18_18_5_6_6_5_5_5_5_3_5_18_3_3_3_18_16_18_16_5_18_18_6_3_6_18_3_18_18_5_5_18_5_5_5_5_5_5_5_5_5_18_3_5_3_18_3_3_3_3_18_18_18_18_3_5_5_18_3_18_6_3_6_3_18_3_3_18_18_5_5_3_18_3_5_34_34_3_3_18_5_18_3_2_3_2_18_5_34_18_3_5_5_3_5_3_3_5_18_3_34_3_5_18_18_18_18_18_18_18_18_18_18_18_18_18_18_18_18_18_18_34_34_5_34_5_34_5_5_6_6_5_5_6_6
7948,131,1332284400,6,7,5,1332324000,39600,6024300,6825900,801600,16_16_16_16_16_16_16_16_16_16_16_16_16_16_16_16_16_16_16_16_16_16_16_16_16_16_1_1_1_1_2_2_3_3_3_3_18_18_18_18_18_3_3_3_3_18_18_18_18_18_18_18_18_18_18_18_18_18_18_18_18_18_18_18_5_5_5_5_5_5_5_5_5_5_5_5_6_6_5_5_6_6_5_5_5_5_5_5_5_5_5_5_6_6_5_5_34_34_34_34_3_3_18_18_18_18_18_18_6_6_5_5_34_34_5_5_5_5_5_5_5_5_5_5_6_6
7949,220,1332285300,3,4,3,1332328860,43560,1940940,2714040,773100,0_0_0_0_1_0_1_0_0_0_0_0_1_0_0_1_0_0_0_0_0_0_0_0_0_0_0_0_0_0_0_1_1_0_1_1_1_1_0_0_1_1_2_2_2_2_2_2_2_2_27_27_27_27_27_27_27_27_27_27_27_27_27_27_27_27_3_3_3_3_3_3_3_3
7950,220,1332285300,3,4,3,1332285300,0,1940940,2714040,773100,0_0_0_0_1_0_1_0_0_0_0_0_1_0_0_1_0_0_0_0_0_0_0_0_0_0_0_0_0_0_0_1_1_0_1_1_1_1_0_0_1_1_2_2_2_2_2_2_2_2_27_27_27_27_27_27_27_27_27_27_27_27_27_27_27_27_3_3_3_3_3_3_3
7951,26,1332285300,3,4,3,1332311100,25800,1436460,2036760,600300,16_16_16_16_16_16_16_1_1_16_1_1_2_2_25_9_25_9_3_3_18_18_18_18_15_15_15_15_3_3
7952,30,1332285300,0,20,0,1332354420,69120,4500,604800,600300,0_0
7953,219,1332290160,18,19,15,1332306000,15840,3006900,3797940,791040,26_26_26_26_26_26_26_26_26_26_8_8_38_38_17_17_17_17_17_17_17_1_17_1_1_1_17_17_1_1_17_17_1_17_1_17_1_1_3_25_3_25_18_18_18_18_18_18_18_18_18_18
7954,172,1332291600,18,19,18,1332298800,7200,1364760,1443960,79200,10_10_10_1_10_10_1_10_10_10_10_10_1_1_2_2_9_9_3_3_18
7955,170,1332292980,19,14,1,1332306540,13560,46860,665160,618300,19_19_19_19_19_19
7956,15,1332293340,17,12,1,1332311460,18120,1113360,1822860,709500,7_7_7_7_7_7_1_7_1_7_7_7_7_7_7_7_7_7_7_7_7_7_7_7_1_1_1_1_2_2_3_3_17_17_17_17_17_17_17_17_17_17_17_5_5_5_5_17_17_6_6_6_6_17
7957,172,1332298800,18,19,5,1332317760,18960,1371960,1443960,72000,10_10_10_1_10_10_1_10_10_10_10_10_1_1_2_2_9_9_3_3_18_18
7958,11,1332298980,18,19,18,1332303720,4740,1446540,1777560,331020,0_0_0_0_1_0_0_0_1_0_0_1_1_0_1_1_2_2_18
7959,11,1332303720,18,19,18,1332303780,60,1451280,1777560,326280,0_0_0_0_1_0_0_0_1_0_0_1_1_0_1_1_2_2_18_18
7960,11,1332303780,18,19,18,1332305340,1560,1451340,1777560,326220,0_0_0_0_1_0_0_0_1_0_0_1_1_0_1_1_2_2_18_18_18
7961,209,1332304320,16,14,16,1332305820,1500,714720,1091400,376680,16_16_16_16_16_16_16_16
7962,7,1332304440,0,1,0,1332307080,2640,26160,40380,14220,0_0
7963,58,1332305100,1,18,1,1332306960,1860,205380,992100,786720,19_19_19_1_19_19_1_19_19_19_19_19_19_19_19_19_1_1_1
7964,11,1332305340,18,19,18,1332308040,2700,1452900,1777560,324660,0_0_0_0_1_0_0_0_1_0_0_1_1_0_1_1_2_2_18_18_18_18
7965,6,1332305700,1,6,1,1332308460,2760,123120,133560,10440,16_16_16_16_16_1_16_1_1
7966,209,1332305820,16,20,1,1332307800,1980,716220,1091400,375180,16_16_16_16_16_16_16_16_16
7967,219,1332306000,15,2,15,1332312000,6000,3022740,3797940,775200,26_26_26_26_26_26_26_26_26_26_8_8_38_38_17_17_17_17_17_17_17_1_17_1_1_1_17_17_1_1_17_17_1_17_1_17_1_1_3_25_3_25_18_18_18_18_18_18_18_18_18_18_15
7968,2,1332306120,5,9,5,1332306180,60,2555580,2555640,60,10_10_10_10_10_10_10_10_1_1_2_2_9_9_3_3_4_4_4_4_11_11_5_5_6_6_5
7969,2,1332306180,5,9,99,1332306180,0,2555640,2555640,0,10_10_10_10_10_10_10_10_1_1_2_2_9_9_3_3_4_4_4_4_11_11_5_5_6_6_5_5
7970,170,1332306540,1,9,1,1332316980,10440,60420,665160,604740,19_19_19_19_19_19_1
7971,196,1332306960,10,13,1,1332316800,9840,2506260,3281700,775440,7_7_7_7_7_7_7_7_7_7_7_7_7_7_7_7_7_7_7_7_1_1_1_1_7_7_1_1_7_7_1_1_7_7_7_1_1_7_7_7_7_7_7_7_7_7_1_1_7_7_7_30_30_7_1_7_7_1_7_1_1_7_7_7_1_7_7_1_1_1_7_7_30_30_1_1_10_10_10_1_1_10_10_10_10
7972,58,1332306960,1,18,2,1332998760,691800,207240,992100,784860,19_19_19_1_19_19_1_19_19_19_19_19_19_19_19_19_1_1_1_1
7973,7,1332307080,0,0,0,1332318660,11580,28800,40380,11580,0_0_0
7974,211,1332307260,19,11,19,1332341820,34560,0,87180,87180,19
7975,209,1332307800,1,18,1,1332311400,3600,718200,1091400,373200,16_16_16_16_16_16_16_16_16_1
7976,11,1332308040,18,23,18,1332324480,16440,1455600,1777560,321960,0_0_0_0_1_0_0_0_1_0_0_1_1_0_1_1_2_2_18_18_18_18_18
7977,6,1332308460,1,6,2,1332314460,6000,125880,133560,7680,16_16_16_16_16_1_16_1_1_1
7978,26,1332311100,3,3,3,1332317400,6300,1462260,2036760,574500,16_16_16_16_16_16_16_1_1_16_1_1_2_2_25_9_25_9_3_3_18_18_18_18_15_15_15_15_3_3_3
7979,209,1332311400,1,18,16,1332317400,6000,721800,1091400,369600,16_16_16_16_16_16_16_16_16_1_1
7980,25,1332311460,15,6,15,1332318720,7260,1333860,1951380,617520,16_16_16_8_8_16_16_8_8_16_0_0_0_0_0_0_0_0_1_1_2_2_25_25_9_9_3_3_4_4_4_4_15
7981,15,1332311460,1,18,1,1332316800,5340,1131480,1822860,691380,7_7_7_7_7_7_1_7_1_7_7_7_7_7_7_7_7_7_7_7_7_7_7_7_1_1_1_1_2_2_3_3_17_17_17_17_17_17_17_17_17_17_17_5_5_5_5_17_17_6_6_6_6_17_1
7982,219,1332312000,15,2,15,1332313200,1200,3028740,3797940,769200,26_26_26_26_26_26_26_26_26_26_8_8_38_38_17_17_17_17_17_17_17_1_17_1_1_1_17_17_1_1_17_17_1_17_1_17_1_1_3_25_3_25_18_18_18_18_18_18_18_18_18_18_15_15
7983,219,1332313200,15,2,15,1332324000,10800,3029940,3797940,768000,26_26_26_26_26_26_26_26_26_26_8_8_38_38_17_17_17_17_17_17_17_1_17_1_1_1_17_17_1_1_17_17_1_17_1_17_1_1_3_25_3_25_18_18_18_18_18_18_18_18_18_18_15_15_15
7984,183,1332314400,1,9,1,1332317400,3000,257580,445560,187980,19_19_19_19_19_19_1
7985,6,1332314460,2,21,2,1332316140,1680,131880,133560,1680,16_16_16_16_16_1_16_1_1_1_2
7986,6,1332316140,2,21,99,1332316140,0,133560,133560,0,16_16_16_16_16_1_16_1_1_1_2_2
7987,196,1332316800,1,18,1,1332320160,3360,2516100,3281700,765600,7_7_7_7_7_7_7_7_7_7_7_7_7_7_7_7_7_7_7_7_1_1_1_1_7_7_1_1_7_7_1_1_7_7_7_1_1_7_7_7_7_7_7_7_7_7_1_1_7_7_7_30_30_7_1_7_7_1_7_1_1_7_7_7_1_7_7_1_1_1_7_7_30_30_1_1_10_10_10_1_1_10_10_10_10_1
7988,15,1332316800,1,18,2,1332316860,60,1136820,1822860,686040,7_7_7_7_7_7_1_7_1_7_7_7_7_7_7_7_7_7_7_7_7_7_7_7_1_1_1_1_2_2_3_3_17_17_17_17_17_17_17_17_17_17_17_5_5_5_5_17_17_6_6_6_6_17_1_1
7989,15,1332316860,2,21,2,1332325920,9060,1136880,1822860,685980,7_7_7_7_7_7_1_7_1_7_7_7_7_7_7_7_7_7_7_7_7_7_7_7_1_1_1_1_2_2_3_3_17_17_17_17_17_17_17_17_17_17_17_5_5_5_5_17_17_6_6_6_6_17_1_1_2
7990,170,1332316980,1,9,51,1332760860,443880,70860,665160,594300,19_19_19_19_19_19_1_1
7991,26,1332317400,3,3,18,1332330720,13320,1468560,2036760,568200,16_16_16_16_16_16_16_1_1_16_1_1_2_2_25_9_25_9_3_3_18_18_18_18_15_15_15_15_3_3_3_3
7992,209,1332317400,16,20,16,1332318660,1260,727800,1091400,363600,16_16_16_16_16_16_16_16_16_1_1_16
7993,183,1332317400,1,9,2,1332334260,16860,260580,445560,184980,19_19_19_19_19_19_1_1
7994,152,1332317400,3,3,3,1332317760,360,3069960,3766500,696540,17_17_17_17_17_17_17_17_17_17_17_17_1_1_2_2_17_17_17_17_3_3_3
7995,172,1332317760,5,9,5,1332339960,22200,1390920,1443960,53040,10_10_10_1_10_10_1_10_10_10_10_10_1_1_2_2_9_9_3_3_18_18_5
7996,152,1332317760,3,4,3,1332324840,7080,3070320,3766500,696180,17_17_17_17_17_17_17_17_17_17_17_17_1_1_2_2_17_17_17_17_3_3_3_3
7997,7,1332318660,0,0,99,1332318660,0,40380,40380,0,0_0_0_0
7998,209,1332318660,16,0,16,1332338280,19620,729060,1091400,362340,16_16_16_16_16_16_16_16_16_1_1_16_16
7999,25,1332318720,15,6,3,1332834300,515580,1341120,1951380,610260,16_16_16_8_8_16_16_8_8_16_0_0_0_0_0_0_0_0_1_1_2_2_25_25_9_9_3_3_4_4_4_4_15_15
8000,196,1332320160,1,18,10,1332337020,16860,2519460,3281700,762240,7_7_7_7_7_7_7_7_7_7_7_7_7_7_7_7_7_7_7_7_1_1_1_1_7_7_1_1_7_7_1_1_7_7_7_1_1_7_7_7_7_7_7_7_7_7_1_1_7_7_7_30_30_7_1_7_7_1_7_1_1_7_7_7_1_7_7_1_1_1_7_7_30_30_1_1_10_10_10_1_1_10_10_10_10_1_1
8001,18,1332320220,15,18,15,1332326400,6180,1386960,1779540,392580,0_0_0_0_0_0_0_0_0_1_1_1_1_0_9_9_9_9_9_9_1_1_3_3_18_18_18_18_18_18_15_18_15_18_18_18_18_18_15
8002,219,1332324000,15,2,15,1332392460,68460,3040740,3797940,757200,26_26_26_26_26_26_26_26_26_26_8_8_38_38_17_17_17_17_17_17_17_1_17_1_1_1_17_17_1_1_17_17_1_17_1_17_1_1_3_25_3_25_18_18_18_18_18_18_18_18_18_18_15_15_15_15
8003,131,1332324000,5,2,5,1332327000,3000,6063900,6825900,762000,16_16_16_16_16_16_16_16_16_16_16_16_16_16_16_16_16_16_16_16_16_16_16_16_16_16_1_1_1_1_2_2_3_3_3_3_18_18_18_18_18_3_3_3_3_18_18_18_18_18_18_18_18_18_18_18_18_18_18_18_18_18_18_18_5_5_5_5_5_5_5_5_5_5_5_5_6_6_5_5_6_6_5_5_5_5_5_5_5_5_5_5_6_6_5_5_34_34_34_34_3_3_18_18_18_18_18_18_6_6_5_5_34_34_5_5_5_5_5_5_5_5_5_5_6_6_5
8004,11,1332324480,18,23,18,1332456000,131520,1472040,1777560,305520,0_0_0_0_1_0_0_0_1_0_0_1_1_0_1_1_2_2_18_18_18_18_18_18
8005,152,1332324840,3,4,3,1332338400,13560,3077400,3766500,689100,17_17_17_17_17_17_17_17_17_17_17_17_1_1_2_2_17_17_17_17_3_3_3_3_3
8006,28,1332325680,1,18,1,1332331620,5940,106140,493260,387120,0_0_0_0_0_0_0_0_1
8007,15,1332325920,2,21,17,1332336660,10740,1145940,1822860,676920,7_7_7_7_7_7_1_7_1_7_7_7_7_7_7_7_7_7_7_7_7_7_7_7_1_1_1_1_2_2_3_3_17_17_17_17_17_17_17_17_17_17_17_5_5_5_5_17_17_6_6_6_6_17_1_1_2_2
8008,18,1332326400,15,18,2,1332326460,60,1393140,1779540,386400,0_0_0_0_0_0_0_0_0_1_1_1_1_0_9_9_9_9_9_9_1_1_3_3_18_18_18_18_18_18_15_18_15_18_18_18_18_18_15_15
8009,18,1332326460,2,21,2,1332332640,6180,1393200,1779540,386340,0_0_0_0_0_0_0_0_0_1_1_1_1_0_9_9_9_9_9_9_1_1_3_3_18_18_18_18_18_18_15_18_15_18_18_18_18_18_15_15_2
8010,131,1332327000,5,2,34,1332870480,543480,6066900,6825900,759000,16_16_16_16_16_16_16_16_16_16_16_16_16_16_16_16_16_16_16_16_16_16_16_16_16_16_1_1_1_1_2_2_3_3_3_3_18_18_18_18_18_3_3_3_3_18_18_18_18_18_18_18_18_18_18_18_18_18_18_18_18_18_18_18_5_5_5_5_5_5_5_5_5_5_5_5_6_6_5_5_6_6_5_5_5_5_5_5_5_5_5_5_6_6_5_5_34_34_34_34_3_3_18_18_18_18_18_18_6_6_5_5_34_34_5_5_5_5_5_5_5_5_5_5_6_6_5_5
8011,76,1332328800,5,2,5,1332334800,6000,6787200,7552500,765300,3_3_3_3_3_3_3_3_3_18_3_18_18_18_18_18_3_3_3_1_1_3_17_17_17_18_17_17_18_18_18_18_18_17_17_18_3_3_18_17_18_18_17_18_18_17_17_17_5_5_5_5_1_1_17_17_17_2_2_17_17_17_5_5_5_5_5_5_17_17_5_5_5_17_5_5_5_5_5_17_17_17_1_1_1_1_1_1_1_1_2_2_34_34_5_5_5_5_6_6_3_3_4_3_3_4_4_4_4_4_3_3_3_3_3_3_4_3_3_3_3_4_4_4_3_4_4_4_3_4_4_4_3_3_4_4_4_4_5_3_3_5_5_5_5_5_4_5_4_5_4_3_3_3_3_4_3_3_4_4_5_5_5_4_5_5_5_4_6_6_34_34_5_5_34_34_34_34_5_5_5_5_6_6_5_5_5
8012,220,1332328860,3,4,3,1332328980,120,1984500,2714040,729540,0_0_0_0_1_0_1_0_0_0_0_0_1_0_0_1_0_0_0_0_0_0_0_0_0_0_0_0_0_0_0_1_1_0_1_1_1_1_0_0_1_1_2_2_2_2_2_2_2_2_27_27_27_27_27_27_27_27_27_27_27_27_27_27_27_27_3_3_3_3_3_3_3_3_3
8013,220,1332328980,3,4,3,1332338460,9480,1984620,2714040,729420,0_0_0_0_1_0_1_0_0_0_0_0_1_0_0_1_0_0_0_0_0_0_0_0_0_0_0_0_0_0_0_1_1_0_1_1_1_1_0_0_1_1_2_2_2_2_2_2_2_2_27_27_27_27_27_27_27_27_27_27_27_27_27_27_27_27_3_3_3_3_3_3_3_3_3_3
8014,26,1332330720,18,23,18,1332337560,6840,1481880,2036760,554880,16_16_16_16_16_16_16_1_1_16_1_1_2_2_25_9_25_9_3_3_18_18_18_18_15_15_15_15_3_3_3_3_18
8015,28,1332331620,1,18,2,1332338460,6840,112080,493260,381180,0_0_0_0_0_0_0_0_1_1
8016,18,1332332640,2,21,5,1332655200,322560,1399380,1779540,380160,0_0_0_0_0_0_0_0_0_1_1_1_1_0_9_9_9_9_9_9_1_1_3_3_18_18_18_18_18_18_15_18_15_18_18_18_18_18_15_15_2_2
8017,22,1332333300,17,10,17,1332336600,3300,112980,810360,697380,17_17_17
8018,183,1332334260,2,21,2,1332334560,300,277440,445560,168120,19_19_19_19_19_19_1_1_2
8019,183,1332334560,2,21,3,1332341820,7260,277740,445560,167820,19_19_19_19_19_19_1_1_2_2
8020,63,1332334800,5,2,5,1332345660,10860,5483340,6232860,749520,16_16_16_16_16_16_16_16_16_0_0_16_16_0_16_16_0_16_16_0_0_16_16_16_0_0_16_0_0_16_0_16_0_0_0_16_1_1_1_16_16_16_0_1_1_1_16_0_0_16_16_0_16_0_16_0_0_2_2_1_1_0_0_0_0_2_2_2_2_2_2_0_1_0_1_1_0_0_0_1_1_0_0_1_1_1_0_0_0_0_0_2_2_2_2_0_0_0_0_0_0_1_1_1_1_0_0_16_0_16_16_16_16_16_0_0_1_1_2_2_1_1_16_0_2_16_2_2_2_0_1_1_1_1_1_16_16_1_1_1_3_3_18_3_18_3_3_3_3_3_18_18_18_18_3_3_3_3_18_18_18_18_18_18_18_5_5_5_18_5_18_18_18_18_18_5_5_5_18_18_18_5_6_6_5_5_5_5_3_5_18_3_3_3_18_16_18_16_5_18_18_6_3_6_18_3_18_18_5_5_18_5_5_5_5_5_5_5_5_5_18_3_5_3_18_3_3_3_3_18_18_18_18_3_5_5_18_3_18_6_3_6_3_18_3_3_18_18_5_5_3_18_3_5_34_34_3_3_18_5_18_3_2_3_2_18_5_34_18_3_5_5_3_5_3_3_5_18_3_34_3_5_18_18_18_18_18_18_18_18_18_18_18_18_18_18_18_18_18_18_34_34_5_34_5_34_5_5_6_6_5_5_6_6_5
8021,76,1332334800,5,2,34,1332341280,6480,6793200,7552500,759300,3_3_3_3_3_3_3_3_3_18_3_18_18_18_18_18_3_3_3_1_1_3_17_17_17_18_17_17_18_18_18_18_18_17_17_18_3_3_18_17_18_18_17_18_18_17_17_17_5_5_5_5_1_1_17_17_17_2_2_17_17_17_5_5_5_5_5_5_17_17_5_5_5_17_5_5_5_5_5_17_17_17_1_1_1_1_1_1_1_1_2_2_34_34_5_5_5_5_6_6_3_3_4_3_3_4_4_4_4_4_3_3_3_3_3_3_4_3_3_3_3_4_4_4_3_4_4_4_3_4_4_4_3_3_4_4_4_4_5_3_3_5_5_5_5_5_4_5_4_5_4_3_3_3_3_4_3_3_4_4_5_5_5_4_5_5_5_4_6_6_34_34_5_5_34_34_34_34_5_5_5_5_6_6_5_5_5_5
8022,8,1332336420,5,9,5,1332345420,9000,537180,615060,77880,10_10_10_10_1_1_2_2_9_9_5
8023,22,1332336600,17,10,17,1332393480,56880,116280,810360,694080,17_17_17_17
8024,15,1332336660,17,10,17,1332344580,7920,1156680,1822860,666180,7_7_7_7_7_7_1_7_1_7_7_7_7_7_7_7_7_7_7_7_7_7_7_7_1_1_1_1_2_2_3_3_17_17_17_17_17_17_17_17_17_17_17_5_5_5_5_17_17_6_6_6_6_17_1_1_2_2_17
8025,196,1332337020,10,13,10,1332355020,18000,2536320,3281700,745380,7_7_7_7_7_7_7_7_7_7_7_7_7_7_7_7_7_7_7_7_1_1_1_1_7_7_1_1_7_7_1_1_7_7_7_1_1_7_7_7_7_7_7_7_7_7_1_1_7_7_7_30_30_7_1_7_7_1_7_1_1_7_7_7_1_7_7_1_1_1_7_7_30_30_1_1_10_10_10_1_1_10_10_10_10_1_1_10
8026,26,1332337560,18,23,18,1332339600,2040,1488720,2036760,548040,16_16_16_16_16_16_16_1_1_16_1_1_2_2_25_9_25_9_3_3_18_18_18_18_15_15_15_15_3_3_3_3_18_18
8027,209,1332338280,16,0,16,1332338400,120,748680,1091400,342720,16_16_16_16_16_16_16_16_16_1_1_16_16_16
8028,209,1332338400,16,14,16,1332358200,19800,748800,1091400,342600,16_16_16_16_16_16_16_16_16_1_1_16_16_16_16
8029,152,1332338400,3,3,18,1332409860,71460,3090960,3766500,675540,17_17_17_17_17_17_17_17_17_17_17_17_1_1_2_2_17_17_17_17_3_3_3_3_3_3
8030,220,1332338460,3,3,3,1332339480,1020,1994100,2714040,719940,0_0_0_0_1_0_1_0_0_0_0_0_1_0_0_1_0_0_0_0_0_0_0_0_0_0_0_0_0_0_0_1_1_0_1_1_1_1_0_0_1_1_2_2_2_2_2_2_2_2_27_27_27_27_27_27_27_27_27_27_27_27_27_27_27_27_3_3_3_3_3_3_3_3_3_3_3
8031,28,1332338460,2,3,2,1332339600,1140,118920,493260,374340,0_0_0_0_0_0_0_0_1_1_2
8032,159,1332338700,3,22,3,1332340800,2100,1985880,2480580,494700,16_16_16_16_16_16_16_16_1_1_1_1_2_2_3_3_3
8033,98,1332339180,34,15,34,1332341280,2100,6599760,7319880,720120,34_34_2_2_35_35_34_34_2_2_3_3_3_3_3_3_18_18_3_3_3_18_3_3_3_18_18_18_18_3_3_18_18_18_18_18_18_18_18_3_3_18_39_3_3_39_3_3_3_3_4_4_5_5_5_5_5_5_4_4_4_5_3_5_5_3_5_4_4_4_5_5_5_5_6_6_6_6_5_5_5_5_5_5_5_5_5_5_5_5_6_6_5_5_34_34_6_6_5_5_5_5_5_5_5_5_5_5_5_5_2_2_5_18_5_18_18_18_6_6_5_5_5_5_5_5_6_6_34_34_34_34_35_35_6_6_5_5_5_5_34
8034,220,1332339480,3,3,3,1332354480,15000,1995120,2714040,718920,0_0_0_0_1_0_1_0_0_0_0_0_1_0_0_1_0_0_0_0_0_0_0_0_0_0_0_0_0_0_0_1_1_0_1_1_1_1_0_0_1_1_2_2_2_2_2_2_2_2_27_27_27_27_27_27_27_27_27_27_27_27_27_27_27_27_3_3_3_3_3_3_3_3_3_3_3_3
8035,26,1332339600,18,19,18,1332345300,5700,1490760,2036760,546000,16_16_16_16_16_16_16_1_1_16_1_1_2_2_25_9_25_9_3_3_18_18_18_18_15_15_15_15_3_3_3_3_18_18_18
8036,28,1332339600,2,3,3,1332394320,54720,120060,493260,373200,0_0_0_0_0_0_0_0_1_1_2_2
8037,172,1332339960,5,9,6,1332367200,27240,1413120,1443960,30840,10_10_10_1_10_10_1_10_10_10_10_10_1_1_2_2_9_9_3_3_18_18_5_5
8038,178,1332340500,13,3,13,1332344700,4200,614700,904200,289500,10_10_10_10_10_10_10_10_10_10_10_10_10_1_10_1_10_10_1_1_1_1_2_2_9_9_13
8039,159,1332340800,3,22,18,1332359700,18900,1987980,2480580,492600,16_16_16_16_16_16_16_16_1_1_1_1_2_2_3_3_3_3
8040,98,1332341280,34,15,6,1332367200,25920,6601860,7319880,718020,34_34_2_2_35_35_34_34_2_2_3_3_3_3_3_3_18_18_3_3_3_18_3_3_3_18_18_18_18_3_3_18_18_18_18_18_18_18_18_3_3_18_39_3_3_39_3_3_3_3_4_4_5_5_5_5_5_5_4_4_4_5_3_5_5_3_5_4_4_4_5_5_5_5_6_6_6_6_5_5_5_5_5_5_5_5_5_5_5_5_6_6_5_5_34_34_6_6_5_5_5_5_5_5_5_5_5_5_5_5_2_2_5_18_5_18_18_18_6_6_5_5_5_5_5_5_6_6_34_34_34_34_35_35_6_6_5_5_5_5_34_34
8041,76,1332341280,34,15,34,1332347400,6120,6799680,7552500,752820,3_3_3_3_3_3_3_3_3_18_3_18_18_18_18_18_3_3_3_1_1_3_17_17_17_18_17_17_18_18_18_18_18_17_17_18_3_3_18_17_18_18_17_18_18_17_17_17_5_5_5_5_1_1_17_17_17_2_2_17_17_17_5_5_5_5_5_5_17_17_5_5_5_17_5_5_5_5_5_17_17_17_1_1_1_1_1_1_1_1_2_2_34_34_5_5_5_5_6_6_3_3_4_3_3_4_4_4_4_4_3_3_3_3_3_3_4_3_3_3_3_4_4_4_3_4_4_4_3_4_4_4_3_3_4_4_4_4_5_3_3_5_5_5_5_5_4_5_4_5_4_3_3_3_3_4_3_3_4_4_5_5_5_4_5_5_5_4_6_6_34_34_5_5_34_34_34_34_5_5_5_5_6_6_5_5_5_5_34
8042,183,1332341820,3,22,3,1332344100,2280,285000,445560,160560,19_19_19_19_19_19_1_1_2_2_3
8043,211,1332341820,19,11,19,1332341880,60,34560,87180,52620,19_19
8044,211,1332341880,19,11,19,1332345600,3720,34620,87180,52560,19_19_19
8045,183,1332344100,3,22,6,1332367200,23100,287280,445560,158280,19_19_19_19_19_19_1_1_2_2_3_3
8046,15,1332344580,17,10,17,1332354540,9960,1164600,1822860,658260,7_7_7_7_7_7_1_7_1_7_7_7_7_7_7_7_7_7_7_7_7_7_7_7_1_1_1_1_2_2_3_3_17_17_17_17_17_17_17_17_17_17_17_5_5_5_5_17_17_6_6_6_6_17_1_1_2_2_17_17
8047,178,1332344700,13,3,13,1332347400,2700,618900,904200,285300,10_10_10_10_10_10_10_10_10_10_10_10_10_1_10_1_10_10_1_1_1_1_2_2_9_9_13_13
8048,26,1332345300,18,19,18,1332345360,60,1496460,2036760,540300,16_16_16_16_16_16_16_1_1_16_1_1_2_2_25_9_25_9_3_3_18_18_18_18_15_15_15_15_3_3_3_3_18_18_18_18
8049,26,1332345360,18,19,18,1332359700,14340,1496520,2036760,540240,16_16_16_16_16_16_16_1_1_16_1_1_2_2_25_9_25_9_3_3_18_18_18_18_15_15_15_15_3_3_3_3_18_18_18_18_18
8050,8,1332345420,5,9,6,1332367200,21780,546180,615060,68880,10_10_10_10_1_1_2_2_9_9_5_5
8051,211,1332345600,19,11,19,1332354120,8520,38340,87180,48840,19_19_19_19
8052,63,1332345660,5,2,5,1332394200,48540,5494200,6232860,738660,16_16_16_16_16_16_16_16_16_0_0_16_16_0_16_16_0_16_16_0_0_16_16_16_0_0_16_0_0_16_0_16_0_0_0_16_1_1_1_16_16_16_0_1_1_1_16_0_0_16_16_0_16_0_16_0_0_2_2_1_1_0_0_0_0_2_2_2_2_2_2_0_1_0_1_1_0_0_0_1_1_0_0_1_1_1_0_0_0_0_0_2_2_2_2_0_0_0_0_0_0_1_1_1_1_0_0_16_0_16_16_16_16_16_0_0_1_1_2_2_1_1_16_0_2_16_2_2_2_0_1_1_1_1_1_16_16_1_1_1_3_3_18_3_18_3_3_3_3_3_18_18_18_18_3_3_3_3_18_18_18_18_18_18_18_5_5_5_18_5_18_18_18_18_18_5_5_5_18_18_18_5_6_6_5_5_5_5_3_5_18_3_3_3_18_16_18_16_5_18_18_6_3_6_18_3_18_18_5_5_18_5_5_5_5_5_5_5_5_5_18_3_5_3_18_3_3_3_3_18_18_18_18_3_5_5_18_3_18_6_3_6_3_18_3_3_18_18_5_5_3_18_3_5_34_34_3_3_18_5_18_3_2_3_2_18_5_34_18_3_5_5_3_5_3_3_5_18_3_34_3_5_18_18_18_18_18_18_18_18_18_18_18_18_18_18_18_18_18_18_34_34_5_34_5_34_5_5_6_6_5_5_6_6_5_5
8053,76,1332347400,34,15,6,1332367200,19800,6805800,7552500,746700,3_3_3_3_3_3_3_3_3_18_3_18_18_18_18_18_3_3_3_1_1_3_17_17_17_18_17_17_18_18_18_18_18_17_17_18_3_3_18_17_18_18_17_18_18_17_17_17_5_5_5_5_1_1_17_17_17_2_2_17_17_17_5_5_5_5_5_5_17_17_5_5_5_17_5_5_5_5_5_17_17_17_1_1_1_1_1_1_1_1_2_2_34_34_5_5_5_5_6_6_3_3_4_3_3_4_4_4_4_4_3_3_3_3_3_3_4_3_3_3_3_4_4_4_3_4_4_4_3_4_4_4_3_3_4_4_4_4_5_3_3_5_5_5_5_5_4_5_4_5_4_3_3_3_3_4_3_3_4_4_5_5_5_4_5_5_5_4_6_6_34_34_5_5_34_34_34_34_5_5_5_5_6_6_5_5_5_5_34_34
8054,178,1332347400,13,15,13,1332354060,6660,621600,904200,282600,10_10_10_10_10_10_10_10_10_10_10_10_10_1_10_1_10_10_1_1_1_1_2_2_9_9_13_13_13
8055,178,1332354060,13,15,5,1332405000,50940,628260,904200,275940,10_10_10_10_10_10_10_10_10_10_10_10_10_1_10_1_10_10_1_1_1_1_2_2_9_9_13_13_13_13
8056,211,1332354120,19,14,19,1332367200,13080,46860,87180,40320,19_19_19_19_19
8057,30,1332354420,0,1,0,1332391860,37440,73620,604800,531180,0_0_0
8058,220,1332354480,3,5,3,1332370500,16020,2010120,2714040,703920,0_0_0_0_1_0_1_0_0_0_0_0_1_0_0_1_0_0_0_0_0_0_0_0_0_0_0_0_0_0_0_1_1_0_1_1_1_1_0_0_1_1_2_2_2_2_2_2_2_2_27_27_27_27_27_27_27_27_27_27_27_27_27_27_27_27_3_3_3_3_3_3_3_3_3_3_3_3_3
8059,15,1332354540,17,12,17,1332387120,32580,1174560,1822860,648300,7_7_7_7_7_7_1_7_1_7_7_7_7_7_7_7_7_7_7_7_7_7_7_7_1_1_1_1_2_2_3_3_17_17_17_17_17_17_17_17_17_17_17_5_5_5_5_17_17_6_6_6_6_17_1_1_2_2_17_17_17
8060,196,1332355020,10,16,10,1332391440,36420,2554320,3281700,727380,7_7_7_7_7_7_7_7_7_7_7_7_7_7_7_7_7_7_7_7_1_1_1_1_7_7_1_1_7_7_1_1_7_7_7_1_1_7_7_7_7_7_7_7_7_7_1_1_7_7_7_30_30_7_1_7_7_1_7_1_1_7_7_7_1_7_7_1_1_1_7_7_30_30_1_1_10_10_10_1_1_10_10_10_10_1_1_10_10
8061,209,1332358200,16,14,1,1332421200,63000,768600,1091400,322800,16_16_16_16_16_16_16_16_16_1_1_16_16_16_16_16
8062,159,1332359700,18,19,18,1332371100,11400,2006880,2480580,473700,16_16_16_16_16_16_16_16_1_1_1_1_2_2_3_3_3_3_18
8063,26,1332359700,18,19,5,1332491400,131700,1510860,2036760,525900,16_16_16_16_16_16_16_1_1_16_1_1_2_2_25_9_25_9_3_3_18_18_18_18_15_15_15_15_3_3_3_3_18_18_18_18_18_18
8064,37,1332360000,16,14,16,1332390600,30600,0,736020,736020,16
8065,98,1332367200,6,7,6,1332370800,3600,6627780,7319880,692100,34_34_2_2_35_35_34_34_2_2_3_3_3_3_3_3_18_18_3_3_3_18_3_3_3_18_18_18_18_3_3_18_18_18_18_18_18_18_18_3_3_18_39_3_3_39_3_3_3_3_4_4_5_5_5_5_5_5_4_4_4_5_3_5_5_3_5_4_4_4_5_5_5_5_6_6_6_6_5_5_5_5_5_5_5_5_5_5_5_5_6_6_5_5_34_34_6_6_5_5_5_5_5_5_5_5_5_5_5_5_2_2_5_18_5_18_18_18_6_6_5_5_5_5_5_5_6_6_34_34_34_34_35_35_6_6_5_5_5_5_34_34_6
8066,183,1332367200,6,7,6,1332370800,3600,310380,445560,135180,19_19_19_19_19_19_1_1_2_2_3_3_6
8067,172,1332367200,6,7,6,1332370800,3600,1440360,1443960,3600,10_10_10_1_10_10_1_10_10_10_10_10_1_1_2_2_9_9_3_3_18_18_5_5_6
8068,211,1332367200,19,25,19,1332367440,240,59940,87180,27240,19_19_19_19_19_19
8069,8,1332367200,6,7,6,1332370800,3600,567960,615060,47100,10_10_10_10_1_1_2_2_9_9_5_5_6
8070,57,1332367200,6,7,6,1332370800,3600,2099460,2756640,657180,26_26_26_26_26_26_26_26_26_26_26_26_26_26_26_26_26_26_26_26_26_26_26_26_26_8_8_8_8_2_2_26_8_8_26_26_26_26_26_26_26_26_8_8_26_26_26_26_26_26_8_8_8_8_26_26_26_26_6
8071,222,1332367200,6,7,6,1332370800,3600,1081800,1113000,31200,1_1_2_2_2_2_3_3_3_3_9_9_3_3_5_5_5_5_6_6
8072,222,1332367200,6,7,6,1332367200,0,1081800,1113000,31200,1_1_2_2_2_2_3_3_3_3_9_9_3_3_5_5_5_5_6
8073,76,1332367200,6,7,6,1332370800,3600,6825600,7552500,726900,3_3_3_3_3_3_3_3_3_18_3_18_18_18_18_18_3_3_3_1_1_3_17_17_17_18_17_17_18_18_18_18_18_17_17_18_3_3_18_17_18_18_17_18_18_17_17_17_5_5_5_5_1_1_17_17_17_2_2_17_17_17_5_5_5_5_5_5_17_17_5_5_5_17_5_5_5_5_5_17_17_17_1_1_1_1_1_1_1_1_2_2_34_34_5_5_5_5_6_6_3_3_4_3_3_4_4_4_4_4_3_3_3_3_3_3_4_3_3_3_3_4_4_4_3_4_4_4_3_4_4_4_3_3_4_4_4_4_5_3_3_5_5_5_5_5_4_5_4_5_4_3_3_3_3_4_3_3_4_4_5_5_5_4_5_5_5_4_6_6_34_34_5_5_34_34_34_34_5_5_5_5_6_6_5_5_5_5_34_34_6
8074,197,1332367200,6,7,6,1332370800,3600,568620,626580,57960,17_17_17_17_6
8075,179,1332367200,6,7,6,1332370800,3600,311760,345960,34200,0_0_0_0_0_0_0_1_1_0_0_0_1_1_9_9_9_9_1_1_5_9_9_3_5_2_2_3_6
8076,211,1332367440,19,16,19,1332369060,1620,60180,87180,27000,19_19_19_19_19_19_19
8077,211,1332369060,19,14,19,1332371700,2640,61800,87180,25380,19_19_19_19_19_19_19_19
8078,220,1332370500,3,5,4,1332468540,98040,2026140,2714040,687900,0_0_0_0_1_0_1_0_0_0_0_0_1_0_0_1_0_0_0_0_0_0_0_0_0_0_0_0_0_0_0_1_1_0_1_1_1_1_0_0_1_1_2_2_2_2_2_2_2_2_27_27_27_27_27_27_27_27_27_27_27_27_27_27_27_27_3_3_3_3_3_3_3_3_3_3_3_3_3_3
8079,179,1332370800,6,7,5,1332400020,29220,315360,345960,30600,0_0_0_0_0_0_0_1_1_0_0_0_1_1_9_9_9_9_1_1_5_9_9_3_5_2_2_3_6_6
8080,222,1332370800,6,7,5,1332396000,25200,1085400,1113000,27600,1_1_2_2_2_2_3_3_3_3_9_9_3_3_5_5_5_5_6_6_6_6
8081,183,1332370800,6,7,5,1332401220,30420,313980,445560,131580,19_19_19_19_19_19_1_1_2_2_3_3_6_6
8082,222,1332370800,6,7,6,1332370800,0,1085400,1113000,27600,1_1_2_2_2_2_3_3_3_3_9_9_3_3_5_5_5_5_6_6_6
8083,98,1332370800,6,7,5,1332392400,21600,6631380,7319880,688500,34_34_2_2_35_35_34_34_2_2_3_3_3_3_3_3_18_18_3_3_3_18_3_3_3_18_18_18_18_3_3_18_18_18_18_18_18_18_18_3_3_18_39_3_3_39_3_3_3_3_4_4_5_5_5_5_5_5_4_4_4_5_3_5_5_3_5_4_4_4_5_5_5_5_6_6_6_6_5_5_5_5_5_5_5_5_5_5_5_5_6_6_5_5_34_34_6_6_5_5_5_5_5_5_5_5_5_5_5_5_2_2_5_18_5_18_18_18_6_6_5_5_5_5_5_5_6_6_34_34_34_34_35_35_6_6_5_5_5_5_34_34_6_6
8084,197,1332370800,6,7,8,1332402180,31380,572220,626580,54360,17_17_17_17_6_6
8085,57,1332370800,6,7,5,1332415800,45000,2103060,2756640,653580,26_26_26_26_26_26_26_26_26_26_26_26_26_26_26_26_26_26_26_26_26_26_26_26_26_8_8_8_8_2_2_26_8_8_26_26_26_26_26_26_26_26_8_8_26_26_26_26_26_26_8_8_8_8_26_26_26_26_6_6
8086,76,1332370800,6,7,6,1332795600,424800,6829200,7552500,723300,3_3_3_3_3_3_3_3_3_18_3_18_18_18_18_18_3_3_3_1_1_3_17_17_17_18_17_17_18_18_18_18_18_17_17_18_3_3_18_17_18_18_17_18_18_17_17_17_5_5_5_5_1_1_17_17_17_2_2_17_17_17_5_5_5_5_5_5_17_17_5_5_5_17_5_5_5_5_5_17_17_17_1_1_1_1_1_1_1_1_2_2_34_34_5_5_5_5_6_6_3_3_4_3_3_4_4_4_4_4_3_3_3_3_3_3_4_3_3_3_3_4_4_4_3_4_4_4_3_4_4_4_3_3_4_4_4_4_5_3_3_5_5_5_5_5_4_5_4_5_4_3_3_3_3_4_3_3_4_4_5_5_5_4_5_5_5_4_6_6_34_34_5_5_34_34_34_34_5_5_5_5_6_6_5_5_5_5_34_34_6_6
8087,172,1332370800,6,7,99,1332370800,0,1443960,1443960,0,10_10_10_1_10_10_1_10_10_10_10_10_1_1_2_2_9_9_3_3_18_18_5_5_6_6
8088,8,1332370800,6,7,5,1332409800,39000,571560,615060,43500,10_10_10_10_1_1_2_2_9_9_5_5_6_6
8089,159,1332371100,18,19,18,1332371400,300,2018280,2480580,462300,16_16_16_16_16_16_16_16_1_1_1_1_2_2_3_3_3_3_18_18
8090,159,1332371400,18,5,18,1332391740,20340,2018580,2480580,462000,16_16_16_16_16_16_16_16_1_1_1_1_2_2_3_3_3_3_18_18_18
8091,211,1332371700,19,25,19,1332378480,6780,64440,87180,22740,19_19_19_19_19_19_19_19_19
8092,211,1332378480,19,16,1,1332392160,13680,71220,87180,15960,19_19_19_19_19_19_19_19_19_19
8093,15,1332387120,17,12,21,1332394920,7800,1207140,1822860,615720,7_7_7_7_7_7_1_7_1_7_7_7_7_7_7_7_7_7_7_7_7_7_7_7_1_1_1_1_2_2_3_3_17_17_17_17_17_17_17_17_17_17_17_5_5_5_5_17_17_6_6_6_6_17_1_1_2_2_17_17_17_17
8094,37,1332390600,16,14,16,1332392460,1860,30600,736020,705420,16_16
8095,196,1332391440,10,16,10,1332394380,2940,2590740,3281700,690960,7_7_7_7_7_7_7_7_7_7_7_7_7_7_7_7_7_7_7_7_1_1_1_1_7_7_1_1_7_7_1_1_7_7_7_1_1_7_7_7_7_7_7_7_7_7_1_1_7_7_7_30_30_7_1_7_7_1_7_1_1_7_7_7_1_7_7_1_1_1_7_7_30_30_1_1_10_10_10_1_1_10_10_10_10_1_1_10_10_10
8096,159,1332391740,18,5,18,1332392520,780,2038920,2480580,441660,16_16_16_16_16_16_16_16_1_1_1_1_2_2_3_3_3_3_18_18_18_18
8097,30,1332391860,0,1,0,1332392220,360,111060,604800,493740,0_0_0_0
8098,211,1332392160,1,9,1,1332394440,2280,84900,87180,2280,19_19_19_19_19_19_19_19_19_19_1
8099,30,1332392220,0,0,1,1332392400,180,111420,604800,493380,0_0_0_0_0
8100,98,1332392400,5,2,5,1332394200,1800,6652980,7319880,666900,34_34_2_2_35_35_34_34_2_2_3_3_3_3_3_3_18_18_3_3_3_18_3_3_3_18_18_18_18_3_3_18_18_18_18_18_18_18_18_3_3_18_39_3_3_39_3_3_3_3_4_4_5_5_5_5_5_5_4_4_4_5_3_5_5_3_5_4_4_4_5_5_5_5_6_6_6_6_5_5_5_5_5_5_5_5_5_5_5_5_6_6_5_5_34_34_6_6_5_5_5_5_5_5_5_5_5_5_5_5_2_2_5_18_5_18_18_18_6_6_5_5_5_5_5_5_6_6_34_34_34_34_35_35_6_6_5_5_5_5_34_34_6_6_5
8101,30,1332392400,1,18,0,1332395820,3420,111600,604800,493200,0_0_0_0_0_1
8102,190,1332392400,7,8,7,1332396000,3600,0,705600,705600,7
8103,37,1332392460,16,20,16,1332401100,8640,32460,736020,703560,16_16_16
8104,219,1332392460,15,2,15,1332392520,60,3109200,3797940,688740,26_26_26_26_26_26_26_26_26_26_8_8_38_38_17_17_17_17_17_17_17_1_17_1_1_1_17_17_1_1_17_17_1_17_1_17_1_1_3_25_3_25_18_18_18_18_18_18_18_18_18_18_15_15_15_15_15
8105,219,1332392520,15,2,3,1332775320,382800,3109260,3797940,688680,26_26_26_26_26_26_26_26_26_26_8_8_38_38_17_17_17_17_17_17_17_1_17_1_1_1_17_17_1_1_17_17_1_17_1_17_1_1_3_25_3_25_18_18_18_18_18_18_18_18_18_18_15_15_15_15_15_15
8106,159,1332392520,18,23,18,1332405780,13260,2039700,2480580,440880,16_16_16_16_16_16_16_16_1_1_1_1_2_2_3_3_3_3_18_18_18_18_18
8107,22,1332393480,17,10,17,1332431280,37800,173160,810360,637200,17_17_17_17_17
8108,98,1332394200,5,2,34,1332766740,372540,6654780,7319880,665100,34_34_2_2_35_35_34_34_2_2_3_3_3_3_3_3_18_18_3_3_3_18_3_3_3_18_18_18_18_3_3_18_18_18_18_18_18_18_18_3_3_18_39_3_3_39_3_3_3_3_4_4_5_5_5_5_5_5_4_4_4_5_3_5_5_3_5_4_4_4_5_5_5_5_6_6_6_6_5_5_5_5_5_5_5_5_5_5_5_5_6_6_5_5_34_34_6_6_5_5_5_5_5_5_5_5_5_5_5_5_2_2_5_18_5_18_18_18_6_6_5_5_5_5_5_5_6_6_34_34_34_34_35_35_6_6_5_5_5_5_34_34_6_6_5_5
8109,63,1332394200,5,2,5,1332398400,4200,5542740,6232860,690120,16_16_16_16_16_16_16_16_16_0_0_16_16_0_16_16_0_16_16_0_0_16_16_16_0_0_16_0_0_16_0_16_0_0_0_16_1_1_1_16_16_16_0_1_1_1_16_0_0_16_16_0_16_0_16_0_0_2_2_1_1_0_0_0_0_2_2_2_2_2_2_0_1_0_1_1_0_0_0_1_1_0_0_1_1_1_0_0_0_0_0_2_2_2_2_0_0_0_0_0_0_1_1_1_1_0_0_16_0_16_16_16_16_16_0_0_1_1_2_2_1_1_16_0_2_16_2_2_2_0_1_1_1_1_1_16_16_1_1_1_3_3_18_3_18_3_3_3_3_3_18_18_18_18_3_3_3_3_18_18_18_18_18_18_18_5_5_5_18_5_18_18_18_18_18_5_5_5_18_18_18_5_6_6_5_5_5_5_3_5_18_3_3_3_18_16_18_16_5_18_18_6_3_6_18_3_18_18_5_5_18_5_5_5_5_5_5_5_5_5_18_3_5_3_18_3_3_3_3_18_18_18_18_3_5_5_18_3_18_6_3_6_3_18_3_3_18_18_5_5_3_18_3_5_34_34_3_3_18_5_18_3_2_3_2_18_5_34_18_3_5_5_3_5_3_3_5_18_3_34_3_5_18_18_18_18_18_18_18_18_18_18_18_18_18_18_18_18_18_18_34_34_5_34_5_34_5_5_6_6_5_5_6_6_5_5_5
8110,28,1332394320,3,21,3,1332395160,840,174780,493260,318480,0_0_0_0_0_0_0_0_1_1_2_2_3
8111,196,1332394380,10,13,8,1332401400,7020,2593680,3281700,688020,7_7_7_7_7_7_7_7_7_7_7_7_7_7_7_7_7_7_7_7_1_1_1_1_7_7_1_1_7_7_1_1_7_7_7_1_1_7_7_7_7_7_7_7_7_7_1_1_7_7_7_30_30_7_1_7_7_1_7_1_1_7_7_7_1_7_7_1_1_1_7_7_30_30_1_1_10_10_10_1_1_10_10_10_10_1_1_10_10_10_10
8112,13,1332394380,19,11,1,1332408600,14220,1827840,2525940,698100,19_19_19_1_1_19_19_19_19_19_19_19_19_19_19_19_1_1_1_19_1_19_19_19_19_19_19_19_19_19_19_1_19_1_19_19_19_19_19_19_1_1_1_1_19_19_19_19_1_1_1_1_1_1_19_19_1_19_1_19_19_19_19_19_2_2_9_9_2_2_1_9_1_3_1_3_9_1_1_1_19
8113,211,1332394440,1,9,99,1332394440,0,87180,87180,0,19_19_19_19_19_19_19_19_19_19_1_1
8114,15,1332394920,21,4,21,1332398520,3600,1214940,1822860,607920,7_7_7_7_7_7_1_7_1_7_7_7_7_7_7_7_7_7_7_7_7_7_7_7_1_1_1_1_2_2_3_3_17_17_17_17_17_17_17_17_17_17_17_5_5_5_5_17_17_6_6_6_6_17_1_1_2_2_17_17_17_17_21
8115,28,1332395160,3,21,5,1332491460,96300,175620,493260,317640,0_0_0_0_0_0_0_0_1_1_2_2_3_3
8116,30,1332395820,0,0,0,1332395880,60,115020,604800,489780,0_0_0_0_0_1_0
8117,30,1332395880,0,0,1,1332396000,120,115080,604800,489720,0_0_0_0_0_1_0_0
8118,222,1332396000,5,18,5,1332398400,2400,1110600,1113000,2400,1_1_2_2_2_2_3_3_3_3_9_9_3_3_5_5_5_5_6_6_6_6_5
8119,30,1332396000,1,18,0,1332407640,11640,115200,604800,489600,0_0_0_0_0_1_0_0_1
8120,190,1332396000,7,8,1,1332407280,11280,3600,705600,702000,7_7
8121,222,1332398400,5,18,99,1332398400,0,1113000,1113000,0,1_1_2_2_2_2_3_3_3_3_9_9_3_3_5_5_5_5_6_6_6_6_5_5
8122,63,1332398400,5,2,5,1332399600,1200,5546940,6232860,685920,16_16_16_16_16_16_16_16_16_0_0_16_16_0_16_16_0_16_16_0_0_16_16_16_0_0_16_0_0_16_0_16_0_0_0_16_1_1_1_16_16_16_0_1_1_1_16_0_0_16_16_0_16_0_16_0_0_2_2_1_1_0_0_0_0_2_2_2_2_2_2_0_1_0_1_1_0_0_0_1_1_0_0_1_1_1_0_0_0_0_0_2_2_2_2_0_0_0_0_0_0_1_1_1_1_0_0_16_0_16_16_16_16_16_0_0_1_1_2_2_1_1_16_0_2_16_2_2_2_0_1_1_1_1_1_16_16_1_1_1_3_3_18_3_18_3_3_3_3_3_18_18_18_18_3_3_3_3_18_18_18_18_18_18_18_5_5_5_18_5_18_18_18_18_18_5_5_5_18_18_18_5_6_6_5_5_5_5_3_5_18_3_3_3_18_16_18_16_5_18_18_6_3_6_18_3_18_18_5_5_18_5_5_5_5_5_5_5_5_5_18_3_5_3_18_3_3_3_3_18_18_18_18_3_5_5_18_3_18_6_3_6_3_18_3_3_18_18_5_5_3_18_3_5_34_34_3_3_18_5_18_3_2_3_2_18_5_34_18_3_5_5_3_5_3_3_5_18_3_34_3_5_18_18_18_18_18_18_18_18_18_18_18_18_18_18_18_18_18_18_34_34_5_34_5_34_5_5_6_6_5_5_6_6_5_5_5_5
8123,15,1332398520,21,4,21,1332399720,1200,1218540,1822860,604320,7_7_7_7_7_7_1_7_1_7_7_7_7_7_7_7_7_7_7_7_7_7_7_7_1_1_1_1_2_2_3_3_17_17_17_17_17_17_17_17_17_17_17_5_5_5_5_17_17_6_6_6_6_17_1_1_2_2_17_17_17_17_21_21
8124,63,1332399600,5,2,5,1332413400,13800,5548140,6232860,684720,16_16_16_16_16_16_16_16_16_0_0_16_16_0_16_16_0_16_16_0_0_16_16_16_0_0_16_0_0_16_0_16_0_0_0_16_1_1_1_16_16_16_0_1_1_1_16_0_0_16_16_0_16_0_16_0_0_2_2_1_1_0_0_0_0_2_2_2_2_2_2_0_1_0_1_1_0_0_0_1_1_0_0_1_1_1_0_0_0_0_0_2_2_2_2_0_0_0_0_0_0_1_1_1_1_0_0_16_0_16_16_16_16_16_0_0_1_1_2_2_1_1_16_0_2_16_2_2_2_0_1_1_1_1_1_16_16_1_1_1_3_3_18_3_18_3_3_3_3_3_18_18_18_18_3_3_3_3_18_18_18_18_18_18_18_5_5_5_18_5_18_18_18_18_18_5_5_5_18_18_18_5_6_6_5_5_5_5_3_5_18_3_3_3_18_16_18_16_5_18_18_6_3_6_18_3_18_18_5_5_18_5_5_5_5_5_5_5_5_5_18_3_5_3_18_3_3_3_3_18_18_18_18_3_5_5_18_3_18_6_3_6_3_18_3_3_18_18_5_5_3_18_3_5_34_34_3_3_18_5_18_3_2_3_2_18_5_34_18_3_5_5_3_5_3_3_5_18_3_34_3_5_18_18_18_18_18_18_18_18_18_18_18_18_18_18_18_18_18_18_34_34_5_34_5_34_5_5_6_6_5_5_6_6_5_5_5_5_5
8125,15,1332399720,21,4,3,1332403200,3480,1219740,1822860,603120,7_7_7_7_7_7_1_7_1_7_7_7_7_7_7_7_7_7_7_7_7_7_7_7_1_1_1_1_2_2_3_3_17_17_17_17_17_17_17_17_17_17_17_5_5_5_5_17_17_6_6_6_6_17_1_1_2_2_17_17_17_17_21_21_21
8126,179,1332400020,5,18,5,1332401400,1380,344580,345960,1380,0_0_0_0_0_0_0_1_1_0_0_0_1_1_9_9_9_9_1_1_5_9_9_3_5_2_2_3_6_6_5
8127,37,1332401100,16,21,16,1332403140,2040,41100,736020,694920,16_16_16_16
8128,183,1332401220,5,9,5,1332407280,6060,344400,445560,101160,19_19_19_19_19_19_1_1_2_2_3_3_6_6_5
8129,196,1332401400,8,18,8,1332405000,3600,2600700,3281700,681000,7_7_7_7_7_7_7_7_7_7_7_7_7_7_7_7_7_7_7_7_1_1_1_1_7_7_1_1_7_7_1_1_7_7_7_1_1_7_7_7_7_7_7_7_7_7_1_1_7_7_7_30_30_7_1_7_7_1_7_1_1_7_7_7_1_7_7_1_1_1_7_7_30_30_1_1_10_10_10_1_1_10_10_10_10_1_1_10_10_10_10_8
8130,179,1332401400,5,18,99,1332401400,0,345960,345960,0,0_0_0_0_0_0_0_1_1_0_0_0_1_1_9_9_9_9_1_1_5_9_9_3_5_2_2_3_6_6_5_5
8131,197,1332402180,8,9,8,1332402420,240,603600,626580,22980,17_17_17_17_6_6_8
8132,197,1332402420,8,9,2,1332404640,2220,603840,626580,22740,17_17_17_17_6_6_8_8
8133,37,1332403140,16,21,16,1332411420,8280,43140,736020,692880,16_16_16_16_16
8134,15,1332403200,3,21,21,1332411720,8520,1223220,1822860,599640,7_7_7_7_7_7_1_7_1_7_7_7_7_7_7_7_7_7_7_7_7_7_7_7_1_1_1_1_2_2_3_3_17_17_17_17_17_17_17_17_17_17_17_5_5_5_5_17_17_6_6_6_6_17_1_1_2_2_17_17_17_17_21_21_21_3
8135,197,1332404640,2,3,2,1332406800,2160,606060,626580,20520,17_17_17_17_6_6_8_8_2
8136,196,1332405000,8,18,7,1332409440,4440,2604300,3281700,677400,7_7_7_7_7_7_7_7_7_7_7_7_7_7_7_7_7_7_7_7_1_1_1_1_7_7_1_1_7_7_1_1_7_7_7_1_1_7_7_7_7_7_7_7_7_7_1_1_7_7_7_30_30_7_1_7_7_1_7_1_1_7_7_7_1_7_7_1_1_1_7_7_30_30_1_1_10_10_10_1_1_10_10_10_10_1_1_10_10_10_10_8_8
8137,178,1332405000,5,18,5,1332415800,10800,679200,904200,225000,10_10_10_10_10_10_10_10_10_10_10_10_10_1_10_1_10_10_1_1_1_1_2_2_9_9_13_13_13_13_5
8138,159,1332405780,18,23,5,1332741600,335820,2052960,2480580,427620,16_16_16_16_16_16_16_16_1_1_1_1_2_2_3_3_3_3_18_18_18_18_18_18
8139,197,1332406800,2,3,9,1332420540,13740,608220,626580,18360,17_17_17_17_6_6_8_8_2_2
8140,190,1332407280,1,9,1,1332410340,3060,14880,705600,690720,7_7_1
8141,183,1332407280,5,9,1,1332497880,90600,350460,445560,95100,19_19_19_19_19_19_1_1_2_2_3_3_6_6_5_5
8142,30,1332407640,0,0,1,1332429300,21660,126840,604800,477960,0_0_0_0_0_1_0_0_1_0
8143,14,1332407640,0,0,0,1332431400,23760,828240,1327560,499320,20_20_20_20_20_20_20_20_20_20_20_20_8_8_0
8144,13,1332408600,1,9,1,1332409560,960,1842060,2525940,683880,19_19_19_1_1_19_19_19_19_19_19_19_19_19_19_19_1_1_1_19_1_19_19_19_19_19_19_19_19_19_19_1_19_1_19_19_19_19_19_19_1_1_1_1_19_19_19_19_1_1_1_1_1_1_19_19_1_19_1_19_19_19_19_19_2_2_9_9_2_2_1_9_1_3_1_3_9_1_1_1_19_1
8145,196,1332409440,7,8,10,1332412920,3480,2608740,3281700,672960,7_7_7_7_7_7_7_7_7_7_7_7_7_7_7_7_7_7_7_7_1_1_1_1_7_7_1_1_7_7_1_1_7_7_7_1_1_7_7_7_7_7_7_7_7_7_1_1_7_7_7_30_30_7_1_7_7_1_7_1_1_7_7_7_1_7_7_1_1_1_7_7_30_30_1_1_10_10_10_1_1_10_10_10_10_1_1_10_10_10_10_8_8_7
8146,13,1332409560,1,9,19,1332409860,300,1843020,2525940,682920,19_19_19_1_1_19_19_19_19_19_19_19_19_19_19_19_1_1_1_19_1_19_19_19_19_19_19_19_19_19_19_1_19_1_19_19_19_19_19_19_1_1_1_1_19_19_19_19_1_1_1_1_1_1_19_19_1_19_1_19_19_19_19_19_2_2_9_9_2_2_1_9_1_3_1_3_9_1_1_1_19_1_1
8147,8,1332409800,5,9,5,1332414300,4500,610560,615060,4500,10_10_10_10_1_1_2_2_9_9_5_5_6_6_5
8148,152,1332409860,18,23,18,1332418200,8340,3162420,3766500,604080,17_17_17_17_17_17_17_17_17_17_17_17_1_1_2_2_17_17_17_17_3_3_3_3_3_3_18
8149,13,1332409860,19,11,19,1332409860,0,1843320,2525940,682620,19_19_19_1_1_19_19_19_19_19_19_19_19_19_19_19_1_1_1_19_1_19_19_19_19_19_19_19_19_19_19_1_19_1_19_19_19_19_19_19_1_1_1_1_19_19_19_19_1_1_1_1_1_1_19_19_1_19_1_19_19_19_19_19_2_2_9_9_2_2_1_9_1_3_1_3_9_1_1_1_19_1_1_19
8150,13,1332409860,19,11,3,1332411300,1440,1843320,2525940,682620,19_19_19_1_1_19_19_19_19_19_19_19_19_19_19_19_1_1_1_19_1_19_19_19_19_19_19_19_19_19_19_1_19_1_19_19_19_19_19_19_1_1_1_1_19_19_19_19_1_1_1_1_1_1_19_19_1_19_1_19_19_19_19_19_2_2_9_9_2_2_1_9_1_3_1_3_9_1_1_1_19_1_1_19_19
8151,224,1332410340,1,9,1,1332424980,14640,0,648060,648060,1
8152,190,1332410340,1,9,7,1333007880,597540,17940,705600,687660,7_7_1_1
8153,13,1332411300,3,21,19,1332415800,4500,1844760,2525940,681180,19_19_19_1_1_19_19_19_19_19_19_19_19_19_19_19_1_1_1_19_1_19_19_19_19_19_19_19_19_19_19_1_19_1_19_19_19_19_19_19_1_1_1_1_19_19_19_19_1_1_1_1_1_1_19_19_1_19_1_19_19_19_19_19_2_2_9_9_2_2_1_9_1_3_1_3_9_1_1_1_19_1_1_19_19_3
8154,37,1332411420,16,20,16,1332439980,28560,51420,736020,684600,16_16_16_16_16_16
8155,15,1332411720,21,4,3,1332419580,7860,1231740,1822860,591120,7_7_7_7_7_7_1_7_1_7_7_7_7_7_7_7_7_7_7_7_7_7_7_7_1_1_1_1_2_2_3_3_17_17_17_17_17_17_17_17_17_17_17_5_5_5_5_17_17_6_6_6_6_17_1_1_2_2_17_17_17_17_21_21_21_3_21
8156,196,1332412920,10,13,10,1332412920,0,2612220,3281700,669480,7_7_7_7_7_7_7_7_7_7_7_7_7_7_7_7_7_7_7_7_1_1_1_1_7_7_1_1_7_7_1_1_7_7_7_1_1_7_7_7_7_7_7_7_7_7_1_1_7_7_7_30_30_7_1_7_7_1_7_1_1_7_7_7_1_7_7_1_1_1_7_7_30_30_1_1_10_10_10_1_1_10_10_10_10_1_1_10_10_10_10_8_8_7_10
8157,196,1332412920,10,13,7,1332431220,18300,2612220,3281700,669480,7_7_7_7_7_7_7_7_7_7_7_7_7_7_7_7_7_7_7_7_1_1_1_1_7_7_1_1_7_7_1_1_7_7_7_1_1_7_7_7_7_7_7_7_7_7_1_1_7_7_7_30_30_7_1_7_7_1_7_1_1_7_7_7_1_7_7_1_1_1_7_7_30_30_1_1_10_10_10_1_1_10_10_10_10_1_1_10_10_10_10_8_8_7_10_10
8158,63,1332413400,5,2,5,1332415200,1800,5561940,6232860,670920,16_16_16_16_16_16_16_16_16_0_0_16_16_0_16_16_0_16_16_0_0_16_16_16_0_0_16_0_0_16_0_16_0_0_0_16_1_1_1_16_16_16_0_1_1_1_16_0_0_16_16_0_16_0_16_0_0_2_2_1_1_0_0_0_0_2_2_2_2_2_2_0_1_0_1_1_0_0_0_1_1_0_0_1_1_1_0_0_0_0_0_2_2_2_2_0_0_0_0_0_0_1_1_1_1_0_0_16_0_16_16_16_16_16_0_0_1_1_2_2_1_1_16_0_2_16_2_2_2_0_1_1_1_1_1_16_16_1_1_1_3_3_18_3_18_3_3_3_3_3_18_18_18_18_3_3_3_3_18_18_18_18_18_18_18_5_5_5_18_5_18_18_18_18_18_5_5_5_18_18_18_5_6_6_5_5_5_5_3_5_18_3_3_3_18_16_18_16_5_18_18_6_3_6_18_3_18_18_5_5_18_5_5_5_5_5_5_5_5_5_18_3_5_3_18_3_3_3_3_18_18_18_18_3_5_5_18_3_18_6_3_6_3_18_3_3_18_18_5_5_3_18_3_5_34_34_3_3_18_5_18_3_2_3_2_18_5_34_18_3_5_5_3_5_3_3_5_18_3_34_3_5_18_18_18_18_18_18_18_18_18_18_18_18_18_18_18_18_18_18_34_34_5_34_5_34_5_5_6_6_5_5_6_6_5_5_5_5_5_5
8159,8,1332414300,5,9,99,1332414300,0,615060,615060,0,10_10_10_10_1_1_2_2_9_9_5_5_6_6_5_5
8160,63,1332415200,5,2,5,1332432240,17040,5563740,6232860,669120,16_16_16_16_16_16_16_16_16_0_0_16_16_0_16_16_0_16_16_0_0_16_16_16_0_0_16_0_0_16_0_16_0_0_0_16_1_1_1_16_16_16_0_1_1_1_16_0_0_16_16_0_16_0_16_0_0_2_2_1_1_0_0_0_0_2_2_2_2_2_2_0_1_0_1_1_0_0_0_1_1_0_0_1_1_1_0_0_0_0_0_2_2_2_2_0_0_0_0_0_0_1_1_1_1_0_0_16_0_16_16_16_16_16_0_0_1_1_2_2_1_1_16_0_2_16_2_2_2_0_1_1_1_1_1_16_16_1_1_1_3_3_18_3_18_3_3_3_3_3_18_18_18_18_3_3_3_3_18_18_18_18_18_18_18_5_5_5_18_5_18_18_18_18_18_5_5_5_18_18_18_5_6_6_5_5_5_5_3_5_18_3_3_3_18_16_18_16_5_18_18_6_3_6_18_3_18_18_5_5_18_5_5_5_5_5_5_5_5_5_18_3_5_3_18_3_3_3_3_18_18_18_18_3_5_5_18_3_18_6_3_6_3_18_3_3_18_18_5_5_3_18_3_5_34_34_3_3_18_5_18_3_2_3_2_18_5_34_18_3_5_5_3_5_3_3_5_18_3_34_3_5_18_18_18_18_18_18_18_18_18_18_18_18_18_18_18_18_18_18_34_34_5_34_5_34_5_5_6_6_5_5_6_6_5_5_5_5_5_5_5
8161,178,1332415800,5,18,5,1332491400,75600,690000,904200,214200,10_10_10_10_10_10_10_10_10_10_10_10_10_1_10_1_10_10_1_1_1_1_2_2_9_9_13_13_13_13_5_5
8162,57,1332415800,5,18,5,1332419400,3600,2148060,2756640,608580,26_26_26_26_26_26_26_26_26_26_26_26_26_26_26_26_26_26_26_26_26_26_26_26_26_8_8_8_8_2_2_26_8_8_26_26_26_26_26_26_26_26_8_8_26_26_26_26_26_26_8_8_8_8_26_26_26_26_6_6_5
8163,13,1332415800,19,11,3,1332416520,720,1849260,2525940,676680,19_19_19_1_1_19_19_19_19_19_19_19_19_19_19_19_1_1_1_19_1_19_19_19_19_19_19_19_19_19_19_1_19_1_19_19_19_19_19_19_1_1_1_1_19_19_19_19_1_1_1_1_1_1_19_19_1_19_1_19_19_19_19_19_2_2_9_9_2_2_1_9_1_3_1_3_9_1_1_1_19_1_1_19_19_3_19
8164,13,1332416520,3,3,3,1332419580,3060,1849980,2525940,675960,19_19_19_1_1_19_19_19_19_19_19_19_19_19_19_19_1_1_1_19_1_19_19_19_19_19_19_19_19_19_19_1_19_1_19_19_19_19_19_19_1_1_1_1_19_19_19_19_1_1_1_1_1_1_19_19_1_19_1_19_19_19_19_19_2_2_9_9_2_2_1_9_1_3_1_3_9_1_1_1_19_1_1_19_19_3_19_3
8165,44,1332417600,1,18,1,1332425160,7560,0,331800,331800,1
8166,152,1332418200,18,23,18,1332419400,1200,3170760,3766500,595740,17_17_17_17_17_17_17_17_17_17_17_17_1_1_2_2_17_17_17_17_3_3_3_3_3_3_18_18
8167,208,1332419340,21,4,21,1332423780,4440,1315080,1620480,305400,16_16_16_16_16_16_16_16_1_1_2_2_21
8168,152,1332419400,18,22,18,1332424800,5400,3171960,3766500,594540,17_17_17_17_17_17_17_17_17_17_17_17_1_1_2_2_17_17_17_17_3_3_3_3_3_3_18_18_18
8169,56,1332419400,5,18,5,1332421440,2040,6359400,6361440,2040,6_6_5_5_8_8_8_8_26_26_5_5_6_6_5_5_5_5_5_5_6_6_5_5_5
8170,57,1332419400,5,18,26,1332683820,264420,2151660,2756640,604980,26_26_26_26_26_26_26_26_26_26_26_26_26_26_26_26_26_26_26_26_26_26_26_26_26_8_8_8_8_2_2_26_8_8_26_26_26_26_26_26_26_26_8_8_26_26_26_26_26_26_8_8_8_8_26_26_26_26_6_6_5_5
8171,13,1332419580,3,21,3,1332426120,6540,1853040,2525940,672900,19_19_19_1_1_19_19_19_19_19_19_19_19_19_19_19_1_1_1_19_1_19_19_19_19_19_19_19_19_19_19_1_19_1_19_19_19_19_19_19_1_1_1_1_19_19_19_19_1_1_1_1_1_1_19_19_1_19_1_19_19_19_19_19_2_2_9_9_2_2_1_9_1_3_1_3_9_1_1_1_19_1_1_19_19_3_19_3_3
8172,15,1332419580,3,21,5,1332658140,238560,1239600,1822860,583260,7_7_7_7_7_7_1_7_1_7_7_7_7_7_7_7_7_7_7_7_7_7_7_7_1_1_1_1_2_2_3_3_17_17_17_17_17_17_17_17_17_17_17_5_5_5_5_17_17_6_6_6_6_17_1_1_2_2_17_17_17_17_21_21_21_3_21_3
8173,197,1332420540,9,3,9,1332420600,60,621960,626580,4620,17_17_17_17_6_6_8_8_2_2_9
8174,197,1332420600,9,3,5,1332420660,60,622020,626580,4560,17_17_17_17_6_6_8_8_2_2_9_9
8175,197,1332420660,5,9,5,1332425160,4500,622080,626580,4500,17_17_17_17_6_6_8_8_2_2_9_9_5
8176,209,1332421200,1,18,1,1332426600,5400,831600,1091400,259800,16_16_16_16_16_16_16_16_16_1_1_16_16_16_16_16_1
8177,56,1332421440,5,18,99,1332421440,0,6361440,6361440,0,6_6_5_5_8_8_8_8_26_26_5_5_6_6_5_5_5_5_5_5_6_6_5_5_5_5
8178,208,1332423780,21,4,3,1332481980,58200,1319520,1620480,300960,16_16_16_16_16_16_16_16_1_1_2_2_21_21
8179,152,1332424800,18,22,18,1332426000,1200,3177360,3766500,589140,17_17_17_17_17_17_17_17_17_17_17_17_1_1_2_2_17_17_17_17_3_3_3_3_3_3_18_18_18_18
8180,224,1332424980,1,9,1,1332493980,69000,14640,648060,633420,1_1
8181,44,1332425160,1,18,1,1332745200,320040,7560,331800,324240,1_1
8182,197,1332425160,5,9,99,1332425160,0,626580,626580,0,17_17_17_17_6_6_8_8_2_2_9_9_5_5
8183,152,1332426000,18,19,18,1332441480,15480,3178560,3766500,587940,17_17_17_17_17_17_17_17_17_17_17_17_1_1_2_2_17_17_17_17_3_3_3_3_3_3_18_18_18_18_18
8184,13,1332426120,3,3,9,1332426120,0,1859580,2525940,666360,19_19_19_1_1_19_19_19_19_19_19_19_19_19_19_19_1_1_1_19_1_19_19_19_19_19_19_19_19_19_19_1_19_1_19_19_19_19_19_19_1_1_1_1_19_19_19_19_1_1_1_1_1_1_19_19_1_19_1_19_19_19_19_19_2_2_9_9_2_2_1_9_1_3_1_3_9_1_1_1_19_1_1_19_19_3_19_3_3_3
8185,13,1332426120,9,3,19,1332426600,480,1859580,2525940,666360,19_19_19_1_1_19_19_19_19_19_19_19_19_19_19_19_1_1_1_19_1_19_19_19_19_19_19_19_19_19_19_1_19_1_19_19_19_19_19_19_1_1_1_1_19_19_19_19_1_1_1_1_1_1_19_19_1_19_1_19_19_19_19_19_2_2_9_9_2_2_1_9_1_3_1_3_9_1_1_1_19_1_1_19_19_3_19_3_3_3_9
8186,209,1332426600,1,18,3,1332626400,199800,837000,1091400,254400,16_16_16_16_16_16_16_16_16_1_1_16_16_16_16_16_1_1
8187,13,1332426600,19,11,9,1332430620,4020,1860060,2525940,665880,19_19_19_1_1_19_19_19_19_19_19_19_19_19_19_19_1_1_1_19_1_19_19_19_19_19_19_19_19_19_19_1_19_1_19_19_19_19_19_19_1_1_1_1_19_19_19_19_1_1_1_1_1_1_19_19_1_19_1_19_19_19_19_19_2_2_9_9_2_2_1_9_1_3_1_3_9_1_1_1_19_1_1_19_19_3_19_3_3_3_9_19
8188,30,1332429300,1,18,1,1332431580,2280,148500,604800,456300,0_0_0_0_0_1_0_0_1_0_1
8189,13,1332430620,9,3,19,1332451800,21180,1864080,2525940,661860,19_19_19_1_1_19_19_19_19_19_19_19_19_19_19_19_1_1_1_19_1_19_19_19_19_19_19_19_19_19_19_1_19_1_19_19_19_19_19_19_1_1_1_1_19_19_19_19_1_1_1_1_1_1_19_19_1_19_1_19_19_19_19_19_2_2_9_9_2_2_1_9_1_3_1_3_9_1_1_1_19_1_1_19_19_3_19_3_3_3_9_19_9
8190,196,1332431220,7,8,10,1332439560,8340,2630520,3281700,651180,7_7_7_7_7_7_7_7_7_7_7_7_7_7_7_7_7_7_7_7_1_1_1_1_7_7_1_1_7_7_1_1_7_7_7_1_1_7_7_7_7_7_7_7_7_7_1_1_7_7_7_30_30_7_1_7_7_1_7_1_1_7_7_7_1_7_7_1_1_1_7_7_30_30_1_1_10_10_10_1_1_10_10_10_10_1_1_10_10_10_10_8_8_7_10_10_7
8191,22,1332431280,17,10,17,1332458160,26880,210960,810360,599400,17_17_17_17_17_17
8192,14,1332431400,0,0,0,1332439200,7800,852000,1327560,475560,20_20_20_20_20_20_20_20_20_20_20_20_8_8_0_0
8193,30,1332431580,1,18,2,1332679200,247620,150780,604800,454020,0_0_0_0_0_1_0_0_1_0_1_1
8194,63,1332432240,5,2,5,1332478800,46560,5580780,6232860,652080,16_16_16_16_16_16_16_16_16_0_0_16_16_0_16_16_0_16_16_0_0_16_16_16_0_0_16_0_0_16_0_16_0_0_0_16_1_1_1_16_16_16_0_1_1_1_16_0_0_16_16_0_16_0_16_0_0_2_2_1_1_0_0_0_0_2_2_2_2_2_2_0_1_0_1_1_0_0_0_1_1_0_0_1_1_1_0_0_0_0_0_2_2_2_2_0_0_0_0_0_0_1_1_1_1_0_0_16_0_16_16_16_16_16_0_0_1_1_2_2_1_1_16_0_2_16_2_2_2_0_1_1_1_1_1_16_16_1_1_1_3_3_18_3_18_3_3_3_3_3_18_18_18_18_3_3_3_3_18_18_18_18_18_18_18_5_5_5_18_5_18_18_18_18_18_5_5_5_18_18_18_5_6_6_5_5_5_5_3_5_18_3_3_3_18_16_18_16_5_18_18_6_3_6_18_3_18_18_5_5_18_5_5_5_5_5_5_5_5_5_18_3_5_3_18_3_3_3_3_18_18_18_18_3_5_5_18_3_18_6_3_6_3_18_3_3_18_18_5_5_3_18_3_5_34_34_3_3_18_5_18_3_2_3_2_18_5_34_18_3_5_5_3_5_3_3_5_18_3_34_3_5_18_18_18_18_18_18_18_18_18_18_18_18_18_18_18_18_18_18_34_34_5_34_5_34_5_5_6_6_5_5_6_6_5_5_5_5_5_5_5_5
8195,14,1332439200,0,1,0,1332478800,39600,859800,1327560,467760,20_20_20_20_20_20_20_20_20_20_20_20_8_8_0_0_0
8196,196,1332439560,10,13,10,1332439620,60,2638860,3281700,642840,7_7_7_7_7_7_7_7_7_7_7_7_7_7_7_7_7_7_7_7_1_1_1_1_7_7_1_1_7_7_1_1_7_7_7_1_1_7_7_7_7_7_7_7_7_7_1_1_7_7_7_30_30_7_1_7_7_1_7_1_1_7_7_7_1_7_7_1_1_1_7_7_30_30_1_1_10_10_10_1_1_10_10_10_10_1_1_10_10_10_10_8_8_7_10_10_7_10
8197,196,1332439620,10,13,10,1332439860,240,2638920,3281700,642780,7_7_7_7_7_7_7_7_7_7_7_7_7_7_7_7_7_7_7_7_1_1_1_1_7_7_1_1_7_7_1_1_7_7_7_1_1_7_7_7_7_7_7_7_7_7_1_1_7_7_7_30_30_7_1_7_7_1_7_1_1_7_7_7_1_7_7_1_1_1_7_7_30_30_1_1_10_10_10_1_1_10_10_10_10_1_1_10_10_10_10_8_8_7_10_10_7_10_10
8198,196,1332439860,10,16,10,1332444360,4500,2639160,3281700,642540,7_7_7_7_7_7_7_7_7_7_7_7_7_7_7_7_7_7_7_7_1_1_1_1_7_7_1_1_7_7_1_1_7_7_7_1_1_7_7_7_7_7_7_7_7_7_1_1_7_7_7_30_30_7_1_7_7_1_7_1_1_7_7_7_1_7_7_1_1_1_7_7_30_30_1_1_10_10_10_1_1_10_10_10_10_1_1_10_10_10_10_8_8_7_10_10_7_10_10_10
8199,37,1332439980,16,14,16,1332458580,18600,79980,736020,656040,16_16_16_16_16_16_16
8200,152,1332441480,18,19,18,1332445020,3540,3194040,3766500,572460,17_17_17_17_17_17_17_17_17_17_17_17_1_1_2_2_17_17_17_17_3_3_3_3_3_3_18_18_18_18_18_18
8201,196,1332444360,10,13,10,1332478020,33660,2643660,3281700,638040,7_7_7_7_7_7_7_7_7_7_7_7_7_7_7_7_7_7_7_7_1_1_1_1_7_7_1_1_7_7_1_1_7_7_7_1_1_7_7_7_7_7_7_7_7_7_1_1_7_7_7_30_30_7_1_7_7_1_7_1_1_7_7_7_1_7_7_1_1_1_7_7_30_30_1_1_10_10_10_1_1_10_10_10_10_1_1_10_10_10_10_8_8_7_10_10_7_10_10_10_10
8202,152,1332445020,18,5,18,1332455820,10800,3197580,3766500,568920,17_17_17_17_17_17_17_17_17_17_17_17_1_1_2_2_17_17_17_17_3_3_3_3_3_3_18_18_18_18_18_18_18
8203,13,1332451800,19,11,3,1332453600,1800,1885260,2525940,640680,19_19_19_1_1_19_19_19_19_19_19_19_19_19_19_19_1_1_1_19_1_19_19_19_19_19_19_19_19_19_19_1_19_1_19_19_19_19_19_19_1_1_1_1_19_19_19_19_1_1_1_1_1_1_19_19_1_19_1_19_19_19_19_19_2_2_9_9_2_2_1_9_1_3_1_3_9_1_1_1_19_1_1_19_19_3_19_3_3_3_9_19_9_19
8204,13,1332453600,3,4,3,1332458100,4500,1887060,2525940,638880,19_19_19_1_1_19_19_19_19_19_19_19_19_19_19_19_1_1_1_19_1_19_19_19_19_19_19_19_19_19_19_1_19_1_19_19_19_19_19_19_1_1_1_1_19_19_19_19_1_1_1_1_1_1_19_19_1_19_1_19_19_19_19_19_2_2_9_9_2_2_1_9_1_3_1_3_9_1_1_1_19_1_1_19_19_3_19_3_3_3_9_19_9_19_3
8205,152,1332455820,18,5,18,1332479760,23940,3208380,3766500,558120,17_17_17_17_17_17_17_17_17_17_17_17_1_1_2_2_17_17_17_17_3_3_3_3_3_3_18_18_18_18_18_18_18_18
8206,11,1332456000,18,5,18,1332459180,3180,1603560,1777560,174000,0_0_0_0_1_0_0_0_1_0_0_1_1_0_1_1_2_2_18_18_18_18_18_18_18
8207,13,1332458100,3,4,1,1332478980,20880,1891560,2525940,634380,19_19_19_1_1_19_19_19_19_19_19_19_19_19_19_19_1_1_1_19_1_19_19_19_19_19_19_19_19_19_19_1_19_1_19_19_19_19_19_19_1_1_1_1_19_19_19_19_1_1_1_1_1_1_19_19_1_19_1_19_19_19_19_19_2_2_9_9_2_2_1_9_1_3_1_3_9_1_1_1_19_1_1_19_19_3_19_3_3_3_9_19_9_19_3_3
8208,22,1332458160,17,12,17,1332478260,20100,237840,810360,572520,17_17_17_17_17_17_17
8209,37,1332458580,16,14,16,1332464160,5580,98580,736020,637440,16_16_16_16_16_16_16_16
8210,11,1332459180,18,5,18,1332459240,60,1606740,1777560,170820,0_0_0_0_1_0_0_0_1_0_0_1_1_0_1_1_2_2_18_18_18_18_18_18_18_18
8211,11,1332459240,18,5,18,1332468480,9240,1606800,1777560,170760,0_0_0_0_1_0_0_0_1_0_0_1_1_0_1_1_2_2_18_18_18_18_18_18_18_18_18
8212,37,1332464160,16,14,16,1332464220,60,104160,736020,631860,16_16_16_16_16_16_16_16_16
8213,37,1332464220,16,14,16,1332477060,12840,104220,736020,631800,16_16_16_16_16_16_16_16_16_16_16
8214,37,1332464220,16,14,16,1332464220,0,104220,736020,631800,16_16_16_16_16_16_16_16_16_16
8215,11,1332468480,18,5,5,1332480300,11820,1616040,1777560,161520,0_0_0_0_1_0_0_0_1_0_0_1_1_0_1_1_2_2_18_18_18_18_18_18_18_18_18_18
8216,220,1332468540,4,5,4,1332475680,7140,2124180,2714040,589860,0_0_0_0_1_0_1_0_0_0_0_0_1_0_0_1_0_0_0_0_0_0_0_0_0_0_0_0_0_0_0_1_1_0_1_1_1_1_0_0_1_1_2_2_2_2_2_2_2_2_27_27_27_27_27_27_27_27_27_27_27_27_27_27_27_27_3_3_3_3_3_3_3_3_3_3_3_3_3_3_4
8217,220,1332475680,4,5,4,1332475740,60,2131320,2714040,582720,0_0_0_0_1_0_1_0_0_0_0_0_1_0_0_1_0_0_0_0_0_0_0_0_0_0_0_0_0_0_0_1_1_0_1_1_1_1_0_0_1_1_2_2_2_2_2_2_2_2_27_27_27_27_27_27_27_27_27_27_27_27_27_27_27_27_3_3_3_3_3_3_3_3_3_3_3_3_3_3_4_4
8218,220,1332475740,4,5,4,1332478020,2280,2131380,2714040,582660,0_0_0_0_1_0_1_0_0_0_0_0_1_0_0_1_0_0_0_0_0_0_0_0_0_0_0_0_0_0_0_1_1_0_1_1_1_1_0_0_1_1_2_2_2_2_2_2_2_2_27_27_27_27_27_27_27_27_27_27_27_27_27_27_27_27_3_3_3_3_3_3_3_3_3_3_3_3_3_3_4_4_4
8219,37,1332477060,16,14,16,1332478800,1740,117060,736020,618960,16_16_16_16_16_16_16_16_16_16_16_16
8220,196,1332478020,10,16,7,1332564300,86280,2677320,3281700,604380,7_7_7_7_7_7_7_7_7_7_7_7_7_7_7_7_7_7_7_7_1_1_1_1_7_7_1_1_7_7_1_1_7_7_7_1_1_7_7_7_7_7_7_7_7_7_1_1_7_7_7_30_30_7_1_7_7_1_7_1_1_7_7_7_1_7_7_1_1_1_7_7_30_30_1_1_10_10_10_1_1_10_10_10_10_1_1_10_10_10_10_8_8_7_10_10_7_10_10_10_10_10
8221,220,1332478020,4,5,1,1332478200,180,2133660,2714040,580380,0_0_0_0_1_0_1_0_0_0_0_0_1_0_0_1_0_0_0_0_0_0_0_0_0_0_0_0_0_0_0_1_1_0_1_1_1_1_0_0_1_1_2_2_2_2_2_2_2_2_27_27_27_27_27_27_27_27_27_27_27_27_27_27_27_27_3_3_3_3_3_3_3_3_3_3_3_3_3_3_4_4_4_4
8222,220,1332478200,4,22,4,1332480240,2040,2133840,2714040,580200,0_0_0_0_1_0_1_0_0_0_0_0_1_0_0_1_0_0_0_0_0_0_0_0_0_0_0_0_0_0_0_1_1_0_1_1_1_1_0_0_1_1_2_2_2_2_2_2_2_2_27_27_27_27_27_27_27_27_27_27_27_27_27_27_27_27_3_3_3_3_3_3_3_3_3_3_3_3_3_3_4_4_4_4_1_4
8223,220,1332478200,1,9,4,1332478200,0,2133840,2714040,580200,0_0_0_0_1_0_1_0_0_0_0_0_1_0_0_1_0_0_0_0_0_0_0_0_0_0_0_0_0_0_0_1_1_0_1_1_1_1_0_0_1_1_2_2_2_2_2_2_2_2_27_27_27_27_27_27_27_27_27_27_27_27_27_27_27_27_3_3_3_3_3_3_3_3_3_3_3_3_3_3_4_4_4_4_1
8224,22,1332478260,17,12,17,1332649140,170880,257940,810360,552420,17_17_17_17_17_17_17_17
8225,14,1332478800,0,11,20,1332479340,540,899400,1327560,428160,20_20_20_20_20_20_20_20_20_20_20_20_8_8_0_0_0_0_0
8226,14,1332478800,0,1,0,1332478800,0,899400,1327560,428160,20_20_20_20_20_20_20_20_20_20_20_20_8_8_0_0_0_0
8227,37,1332478800,16,20,16,1332498540,19740,118800,736020,617220,16_16_16_16_16_16_16_16_16_16_16_16_16
8228,63,1332478800,5,2,5,1332484800,6000,5627340,6232860,605520,16_16_16_16_16_16_16_16_16_0_0_16_16_0_16_16_0_16_16_0_0_16_16_16_0_0_16_0_0_16_0_16_0_0_0_16_1_1_1_16_16_16_0_1_1_1_16_0_0_16_16_0_16_0_16_0_0_2_2_1_1_0_0_0_0_2_2_2_2_2_2_0_1_0_1_1_0_0_0_1_1_0_0_1_1_1_0_0_0_0_0_2_2_2_2_0_0_0_0_0_0_1_1_1_1_0_0_16_0_16_16_16_16_16_0_0_1_1_2_2_1_1_16_0_2_16_2_2_2_0_1_1_1_1_1_16_16_1_1_1_3_3_18_3_18_3_3_3_3_3_18_18_18_18_3_3_3_3_18_18_18_18_18_18_18_5_5_5_18_5_18_18_18_18_18_5_5_5_18_18_18_5_6_6_5_5_5_5_3_5_18_3_3_3_18_16_18_16_5_18_18_6_3_6_18_3_18_18_5_5_18_5_5_5_5_5_5_5_5_5_18_3_5_3_18_3_3_3_3_18_18_18_18_3_5_5_18_3_18_6_3_6_3_18_3_3_18_18_5_5_3_18_3_5_34_34_3_3_18_5_18_3_2_3_2_18_5_34_18_3_5_5_3_5_3_3_5_18_3_34_3_5_18_18_18_18_18_18_18_18_18_18_18_18_18_18_18_18_18_18_34_34_5_34_5_34_5_5_6_6_5_5_6_6_5_5_5_5_5_5_5_5_5
8229,13,1332478980,1,9,19,1332479520,540,1912440,2525940,613500,19_19_19_1_1_19_19_19_19_19_19_19_19_19_19_19_1_1_1_19_1_19_19_19_19_19_19_19_19_19_19_1_19_1_19_19_19_19_19_19_1_1_1_1_19_19_19_19_1_1_1_1_1_1_19_19_1_19_1_19_19_19_19_19_2_2_9_9_2_2_1_9_1_3_1_3_9_1_1_1_19_1_1_19_19_3_19_3_3_3_9_19_9_19_3_3_1
8230,14,1332479340,20,11,0,1332499260,19920,899940,1327560,427620,20_20_20_20_20_20_20_20_20_20_20_20_8_8_0_0_0_0_0_20
8231,13,1332479520,19,11,1,1332480240,720,1912980,2525940,612960,19_19_19_1_1_19_19_19_19_19_19_19_19_19_19_19_1_1_1_19_1_19_19_19_19_19_19_19_19_19_19_1_19_1_19_19_19_19_19_19_1_1_1_1_19_19_19_19_1_1_1_1_1_1_19_19_1_19_1_19_19_19_19_19_2_2_9_9_2_2_1_9_1_3_1_3_9_1_1_1_19_1_1_19_19_3_19_3_3_3_9_19_9_19_3_3_1_19
8232,152,1332479760,18,23,18,1332496440,16680,3232320,3766500,534180,17_17_17_17_17_17_17_17_17_17_17_17_1_1_2_2_17_17_17_17_3_3_3_3_3_3_18_18_18_18_18_18_18_18_18
8233,220,1332480240,4,22,1,1332497700,17460,2135880,2714040,578160,0_0_0_0_1_0_1_0_0_0_0_0_1_0_0_1_0_0_0_0_0_0_0_0_0_0_0_0_0_0_0_1_1_0_1_1_1_1_0_0_1_1_2_2_2_2_2_2_2_2_27_27_27_27_27_27_27_27_27_27_27_27_27_27_27_27_3_3_3_3_3_3_3_3_3_3_3_3_3_3_4_4_4_4_1_4_4
8234,13,1332480240,1,9,3,1332495480,15240,1913700,2525940,612240,19_19_19_1_1_19_19_19_19_19_19_19_19_19_19_19_1_1_1_19_1_19_19_19_19_19_19_19_19_19_19_1_19_1_19_19_19_19_19_19_1_1_1_1_19_19_19_19_1_1_1_1_1_1_19_19_1_19_1_19_19_19_19_19_2_2_9_9_2_2_1_9_1_3_1_3_9_1_1_1_19_1_1_19_19_3_19_3_3_3_9_19_9_19_3_3_1_19_1
8235,11,1332480300,5,9,5,1332492600,12300,1627860,1777560,149700,0_0_0_0_1_0_0_0_1_0_0_1_1_0_1_1_2_2_18_18_18_18_18_18_18_18_18_18_5
8236,208,1332481980,3,3,3,1332495300,13320,1377720,1620480,242760,16_16_16_16_16_16_16_16_1_1_2_2_21_21_3
8237,63,1332484800,5,2,5,1332486000,1200,5633340,6232860,599520,16_16_16_16_16_16_16_16_16_0_0_16_16_0_16_16_0_16_16_0_0_16_16_16_0_0_16_0_0_16_0_16_0_0_0_16_1_1_1_16_16_16_0_1_1_1_16_0_0_16_16_0_16_0_16_0_0_2_2_1_1_0_0_0_0_2_2_2_2_2_2_0_1_0_1_1_0_0_0_1_1_0_0_1_1_1_0_0_0_0_0_2_2_2_2_0_0_0_0_0_0_1_1_1_1_0_0_16_0_16_16_16_16_16_0_0_1_1_2_2_1_1_16_0_2_16_2_2_2_0_1_1_1_1_1_16_16_1_1_1_3_3_18_3_18_3_3_3_3_3_18_18_18_18_3_3_3_3_18_18_18_18_18_18_18_5_5_5_18_5_18_18_18_18_18_5_5_5_18_18_18_5_6_6_5_5_5_5_3_5_18_3_3_3_18_16_18_16_5_18_18_6_3_6_18_3_18_18_5_5_18_5_5_5_5_5_5_5_5_5_18_3_5_3_18_3_3_3_3_18_18_18_18_3_5_5_18_3_18_6_3_6_3_18_3_3_18_18_5_5_3_18_3_5_34_34_3_3_18_5_18_3_2_3_2_18_5_34_18_3_5_5_3_5_3_3_5_18_3_34_3_5_18_18_18_18_18_18_18_18_18_18_18_18_18_18_18_18_18_18_34_34_5_34_5_34_5_5_6_6_5_5_6_6_5_5_5_5_5_5_5_5_5_5
8238,63,1332486000,5,2,5,1332491400,5400,5634540,6232860,598320,16_16_16_16_16_16_16_16_16_0_0_16_16_0_16_16_0_16_16_0_0_16_16_16_0_0_16_0_0_16_0_16_0_0_0_16_1_1_1_16_16_16_0_1_1_1_16_0_0_16_16_0_16_0_16_0_0_2_2_1_1_0_0_0_0_2_2_2_2_2_2_0_1_0_1_1_0_0_0_1_1_0_0_1_1_1_0_0_0_0_0_2_2_2_2_0_0_0_0_0_0_1_1_1_1_0_0_16_0_16_16_16_16_16_0_0_1_1_2_2_1_1_16_0_2_16_2_2_2_0_1_1_1_1_1_16_16_1_1_1_3_3_18_3_18_3_3_3_3_3_18_18_18_18_3_3_3_3_18_18_18_18_18_18_18_5_5_5_18_5_18_18_18_18_18_5_5_5_18_18_18_5_6_6_5_5_5_5_3_5_18_3_3_3_18_16_18_16_5_18_18_6_3_6_18_3_18_18_5_5_18_5_5_5_5_5_5_5_5_5_18_3_5_3_18_3_3_3_3_18_18_18_18_3_5_5_18_3_18_6_3_6_3_18_3_3_18_18_5_5_3_18_3_5_34_34_3_3_18_5_18_3_2_3_2_18_5_34_18_3_5_5_3_5_3_3_5_18_3_34_3_5_18_18_18_18_18_18_18_18_18_18_18_18_18_18_18_18_18_18_34_34_5_34_5_34_5_5_6_6_5_5_6_6_5_5_5_5_5_5_5_5_5_5_5
8239,63,1332491400,5,2,5,1332655200,163800,5639940,6232860,592920,16_16_16_16_16_16_16_16_16_0_0_16_16_0_16_16_0_16_16_0_0_16_16_16_0_0_16_0_0_16_0_16_0_0_0_16_1_1_1_16_16_16_0_1_1_1_16_0_0_16_16_0_16_0_16_0_0_2_2_1_1_0_0_0_0_2_2_2_2_2_2_0_1_0_1_1_0_0_0_1_1_0_0_1_1_1_0_0_0_0_0_2_2_2_2_0_0_0_0_0_0_1_1_1_1_0_0_16_0_16_16_16_16_16_0_0_1_1_2_2_1_1_16_0_2_16_2_2_2_0_1_1_1_1_1_16_16_1_1_1_3_3_18_3_18_3_3_3_3_3_18_18_18_18_3_3_3_3_18_18_18_18_18_18_18_5_5_5_18_5_18_18_18_18_18_5_5_5_18_18_18_5_6_6_5_5_5_5_3_5_18_3_3_3_18_16_18_16_5_18_18_6_3_6_18_3_18_18_5_5_18_5_5_5_5_5_5_5_5_5_18_3_5_3_18_3_3_3_3_18_18_18_18_3_5_5_18_3_18_6_3_6_3_18_3_3_18_18_5_5_3_18_3_5_34_34_3_3_18_5_18_3_2_3_2_18_5_34_18_3_5_5_3_5_3_3_5_18_3_34_3_5_18_18_18_18_18_18_18_18_18_18_18_18_18_18_18_18_18_18_34_34_5_34_5_34_5_5_6_6_5_5_6_6_5_5_5_5_5_5_5_5_5_5_5_5
8240,178,1332491400,5,18,5,1332492240,840,765600,904200,138600,10_10_10_10_10_10_10_10_10_10_10_10_10_1_10_1_10_10_1_1_1_1_2_2_9_9_13_13_13_13_5_5_5
8241,26,1332491400,5,2,5,1332499860,8460,1642560,2036760,394200,16_16_16_16_16_16_16_1_1_16_1_1_2_2_25_9_25_9_3_3_18_18_18_18_15_15_15_15_3_3_3_3_18_18_18_18_18_18_5
8242,28,1332491460,5,18,5,1332497760,6300,271920,493260,221340,0_0_0_0_0_0_0_0_1_1_2_2_3_3_5
8243,178,1332492240,5,18,6,1332626400,134160,766440,904200,137760,10_10_10_10_10_10_10_10_10_10_10_10_10_1_10_1_10_10_1_1_1_1_2_2_9_9_13_13_13_13_5_5_5_5
8244,11,1332492600,5,9,6,1332626400,133800,1640160,1777560,137400,0_0_0_0_1_0_0_0_1_0_0_1_1_0_1_1_2_2_18_18_18_18_18_18_18_18_18_18_5_5
8245,3,1332493200,3,3,3,1332499200,6000,835980,1055580,219600,12_12_10_10_10_10_10_10_10_10_10_10_10_10_10_10_1_1_9_9_3
8246,224,1332493980,1,9,1,1332494700,720,83640,648060,564420,1_1_1
8247,207,1332494700,1,9,1,1332499440,4740,0,272580,272580,1
8248,224,1332494700,1,9,1,1332666720,172020,84360,648060,563700,1_1_1_1
8249,208,1332495300,3,3,3,1332650520,155220,1391040,1620480,229440,16_16_16_16_16_16_16_16_1_1_2_2_21_21_3_3
8250,13,1332495480,3,3,3,1332495540,60,1928940,2525940,597000,19_19_19_1_1_19_19_19_19_19_19_19_19_19_19_19_1_1_1_19_1_19_19_19_19_19_19_19_19_19_19_1_19_1_19_19_19_19_19_19_1_1_1_1_19_19_19_19_1_1_1_1_1_1_19_19_1_19_1_19_19_19_19_19_2_2_9_9_2_2_1_9_1_3_1_3_9_1_1_1_19_1_1_19_19_3_19_3_3_3_9_19_9_19_3_3_1_19_1_3
8251,13,1332495540,3,3,19,1332499320,3780,1929000,2525940,596940,19_19_19_1_1_19_19_19_19_19_19_19_19_19_19_19_1_1_1_19_1_19_19_19_19_19_19_19_19_19_19_1_19_1_19_19_19_19_19_19_1_1_1_1_19_19_19_19_1_1_1_1_1_1_19_19_1_19_1_19_19_19_19_19_2_2_9_9_2_2_1_9_1_3_1_3_9_1_1_1_19_1_1_19_19_3_19_3_3_3_9_19_9_19_3_3_1_19_1_3_3
8252,152,1332496440,18,23,18,1332652800,156360,3249000,3766500,517500,17_17_17_17_17_17_17_17_17_17_17_17_1_1_2_2_17_17_17_17_3_3_3_3_3_3_18_18_18_18_18_18_18_18_18_18
8253,220,1332497700,1,9,4,1332653940,156240,2153340,2714040,560700,0_0_0_0_1_0_1_0_0_0_0_0_1_0_0_1_0_0_0_0_0_0_0_0_0_0_0_0_0_0_0_1_1_0_1_1_1_1_0_0_1_1_2_2_2_2_2_2_2_2_27_27_27_27_27_27_27_27_27_27_27_27_27_27_27_27_3_3_3_3_3_3_3_3_3_3_3_3_3_3_4_4_4_4_1_4_4_1
8254,28,1332497760,5,18,5,1332658800,161040,278220,493260,215040,0_0_0_0_0_0_0_0_1_1_2_2_3_3_5_5
8255,183,1332497880,1,9,1,1332502380,4500,441060,445560,4500,19_19_19_19_19_19_1_1_2_2_3_3_6_6_5_5_1
8256,37,1332498540,16,20,16,1332588720,90180,138540,736020,597480,16_16_16_16_16_16_16_16_16_16_16_16_16_16
8257,3,1332499200,3,3,13,1332620100,120900,841980,1055580,213600,12_12_10_10_10_10_10_10_10_10_10_10_10_10_10_10_1_1_9_9_3_3
8258,14,1332499260,0,11,20,1332499260,0,919860,1327560,407700,20_20_20_20_20_20_20_20_20_20_20_20_8_8_0_0_0_0_0_20_0
8259,14,1332499260,20,11,20,1332563460,64200,919860,1327560,407700,20_20_20_20_20_20_20_20_20_20_20_20_8_8_0_0_0_0_0_20_0_20
8260,13,1332499320,19,11,19,1332529140,29820,1932780,2525940,593160,19_19_19_1_1_19_19_19_19_19_19_19_19_19_19_19_1_1_1_19_1_19_19_19_19_19_19_19_19_19_19_1_19_1_19_19_19_19_19_19_1_1_1_1_19_19_19_19_1_1_1_1_1_1_19_19_1_19_1_19_19_19_19_19_2_2_9_9_2_2_1_9_1_3_1_3_9_1_1_1_19_1_1_19_19_3_19_3_3_3_9_19_9_19_3_3_1_19_1_3_3_19
8261,207,1332499440,1,9,1,1332665280,165840,4740,272580,267840,1_1
8262,26,1332499860,5,2,5,1332648000,148140,1651020,2036760,385740,16_16_16_16_16_16_16_1_1_16_1_1_2_2_25_9_25_9_3_3_18_18_18_18_15_15_15_15_3_3_3_3_18_18_18_18_18_18_5_5
8263,183,1332502380,1,9,99,1332502380,0,445560,445560,0,19_19_19_19_19_19_1_1_2_2_3_3_6_6_5_5_1_1
8264,13,1332529140,19,1,19,1332565200,36060,1962600,2525940,563340,19_19_19_1_1_19_19_19_19_19_19_19_19_19_19_19_1_1_1_19_1_19_19_19_19_19_19_19_19_19_19_1_19_1_19_19_19_19_19_19_1_1_1_1_19_19_19_19_1_1_1_1_1_1_19_19_1_19_1_19_19_19_19_19_2_2_9_9_2_2_1_9_1_3_1_3_9_1_1_1_19_1_1_19_19_3_19_3_3_3_9_19_9_19_3_3_1_19_1_3_3_19_19
8265,14,1332563460,20,0,0,1332589860,26400,984060,1327560,343500,20_20_20_20_20_20_20_20_20_20_20_20_8_8_0_0_0_0_0_20_0_20_20
8266,196,1332564300,7,8,7,1332569160,4860,2763600,3281700,518100,7_7_7_7_7_7_7_7_7_7_7_7_7_7_7_7_7_7_7_7_1_1_1_1_7_7_1_1_7_7_1_1_7_7_7_1_1_7_7_7_7_7_7_7_7_7_1_1_7_7_7_30_30_7_1_7_7_1_7_1_1_7_7_7_1_7_7_1_1_1_7_7_30_30_1_1_10_10_10_1_1_10_10_10_10_1_1_10_10_10_10_8_8_7_10_10_7_10_10_10_10_10_7
8267,13,1332565200,19,1,19,1332588780,23580,1998660,2525940,527280,19_19_19_1_1_19_19_19_19_19_19_19_19_19_19_19_1_1_1_19_1_19_19_19_19_19_19_19_19_19_19_1_19_1_19_19_19_19_19_19_1_1_1_1_19_19_19_19_1_1_1_1_1_1_19_19_1_19_1_19_19_19_19_19_2_2_9_9_2_2_1_9_1_3_1_3_9_1_1_1_19_1_1_19_19_3_19_3_3_3_9_19_9_19_3_3_1_19_1_3_3_19_19_19
8268,196,1332569160,7,8,7,1332569220,60,2768460,3281700,513240,7_7_7_7_7_7_7_7_7_7_7_7_7_7_7_7_7_7_7_7_1_1_1_1_7_7_1_1_7_7_1_1_7_7_7_1_1_7_7_7_7_7_7_7_7_7_1_1_7_7_7_30_30_7_1_7_7_1_7_1_1_7_7_7_1_7_7_1_1_1_7_7_30_30_1_1_10_10_10_1_1_10_10_10_10_1_1_10_10_10_10_8_8_7_10_10_7_10_10_10_10_10_7_7
8269,196,1332569220,7,8,7,1332583500,14280,2768520,3281700,513180,7_7_7_7_7_7_7_7_7_7_7_7_7_7_7_7_7_7_7_7_1_1_1_1_7_7_1_1_7_7_1_1_7_7_7_1_1_7_7_7_7_7_7_7_7_7_1_1_7_7_7_30_30_7_1_7_7_1_7_1_1_7_7_7_1_7_7_1_1_1_7_7_30_30_1_1_10_10_10_1_1_10_10_10_10_1_1_10_10_10_10_8_8_7_10_10_7_10_10_10_10_10_7_7_7
8270,196,1332583500,7,8,7,1332583500,0,2782800,3281700,498900,7_7_7_7_7_7_7_7_7_7_7_7_7_7_7_7_7_7_7_7_1_1_1_1_7_7_1_1_7_7_1_1_7_7_7_1_1_7_7_7_7_7_7_7_7_7_1_1_7_7_7_30_30_7_1_7_7_1_7_1_1_7_7_7_1_7_7_1_1_1_7_7_30_30_1_1_10_10_10_1_1_10_10_10_10_1_1_10_10_10_10_8_8_7_10_10_7_10_10_10_10_10_7_7_7_7
8271,196,1332583500,7,8,7,1332597060,13560,2782800,3281700,498900,7_7_7_7_7_7_7_7_7_7_7_7_7_7_7_7_7_7_7_7_1_1_1_1_7_7_1_1_7_7_1_1_7_7_7_1_1_7_7_7_7_7_7_7_7_7_1_1_7_7_7_30_30_7_1_7_7_1_7_1_1_7_7_7_1_7_7_1_1_1_7_7_30_30_1_1_10_10_10_1_1_10_10_10_10_1_1_10_10_10_10_8_8_7_10_10_7_10_10_10_10_10_7_7_7_7_7
8272,37,1332588720,16,0,16,1332596940,8220,228720,736020,507300,16_16_16_16_16_16_16_16_16_16_16_16_16_16_16
8273,13,1332588780,19,0,19,1332622260,33480,2022240,2525940,503700,19_19_19_1_1_19_19_19_19_19_19_19_19_19_19_19_1_1_1_19_1_19_19_19_19_19_19_19_19_19_19_1_19_1_19_19_19_19_19_19_1_1_1_1_19_19_19_19_1_1_1_1_1_1_19_19_1_19_1_19_19_19_19_19_2_2_9_9_2_2_1_9_1_3_1_3_9_1_1_1_19_1_1_19_19_3_19_3_3_3_9_19_9_19_3_3_1_19_1_3_3_19_19_19_19
8274,14,1332589860,0,0,0,1332597120,7260,1010460,1327560,317100,20_20_20_20_20_20_20_20_20_20_20_20_8_8_0_0_0_0_0_20_0_20_20_0
8275,37,1332596940,16,0,16,1332597600,660,236940,736020,499080,16_16_16_16_16_16_16_16_16_16_16_16_16_16_16_16
8276,196,1332597060,7,8,8,1332648000,50940,2796360,3281700,485340,7_7_7_7_7_7_7_7_7_7_7_7_7_7_7_7_7_7_7_7_1_1_1_1_7_7_1_1_7_7_1_1_7_7_7_1_1_7_7_7_7_7_7_7_7_7_1_1_7_7_7_30_30_7_1_7_7_1_7_1_1_7_7_7_1_7_7_1_1_1_7_7_30_30_1_1_10_10_10_1_1_10_10_10_10_1_1_10_10_10_10_8_8_7_10_10_7_10_10_10_10_10_7_7_7_7_7_7
8277,14,1332597120,0,0,20,1332597180,60,1017720,1327560,309840,20_20_20_20_20_20_20_20_20_20_20_20_8_8_0_0_0_0_0_20_0_20_20_0_0
8278,14,1332597180,20,0,0,1332622320,25140,1017780,1327560,309780,20_20_20_20_20_20_20_20_20_20_20_20_8_8_0_0_0_0_0_20_0_20_20_0_0_20
8279,37,1332597600,16,11,16,1332622140,24540,237600,736020,498420,16_16_16_16_16_16_16_16_16_16_16_16_16_16_16_16_16
8280,3,1332620100,13,17,13,1332625500,5400,962880,1055580,92700,12_12_10_10_10_10_10_10_10_10_10_10_10_10_10_10_1_1_9_9_3_3_13
8281,37,1332622140,16,11,16,1332622200,60,262140,736020,473880,16_16_16_16_16_16_16_16_16_16_16_16_16_16_16_16_16_16
8282,37,1332622200,16,11,16,1332647100,24900,262200,736020,473820,16_16_16_16_16_16_16_16_16_16_16_16_16_16_16_16_16_16_16
8283,13,1332622260,19,11,19,1332639300,17040,2055720,2525940,470220,19_19_19_1_1_19_19_19_19_19_19_19_19_19_19_19_1_1_1_19_1_19_19_19_19_19_19_19_19_19_19_1_19_1_19_19_19_19_19_19_1_1_1_1_19_19_19_19_1_1_1_1_1_1_19_19_1_19_1_19_19_19_19_19_2_2_9_9_2_2_1_9_1_3_1_3_9_1_1_1_19_1_1_19_19_3_19_3_3_3_9_19_9_19_3_3_1_19_1_3_3_19_19_19_19_19
8284,14,1332622320,0,11,0,1332647100,24780,1042920,1327560,284640,20_20_20_20_20_20_20_20_20_20_20_20_8_8_0_0_0_0_0_20_0_20_20_0_0_20_0
8285,3,1332625500,13,17,13,1332647100,21600,968280,1055580,87300,12_12_10_10_10_10_10_10_10_10_10_10_10_10_10_10_1_1_9_9_3_3_13_13_13
8286,3,1332625500,13,17,13,1332625500,0,968280,1055580,87300,12_12_10_10_10_10_10_10_10_10_10_10_10_10_10_10_1_1_9_9_3_3_13_13
8287,209,1332626400,3,4,3,1332630900,4500,1036800,1091400,54600,16_16_16_16_16_16_16_16_16_1_1_16_16_16_16_16_1_1_3
8288,21,1332626400,19,20,19,1332630900,4500,0,470460,470460,19
8289,178,1332626400,6,24,6,1332630000,3600,900600,904200,3600,10_10_10_10_10_10_10_10_10_10_10_10_10_1_10_1_10_10_1_1_1_1_2_2_9_9_13_13_13_13_5_5_5_5_6
8290,11,1332626400,6,24,6,1332630000,3600,1773960,1777560,3600,0_0_0_0_1_0_0_0_1_0_0_1_1_0_1_1_2_2_18_18_18_18_18_18_18_18_18_18_5_5_6
8291,11,1332630000,6,24,99,1332630000,0,1777560,1777560,0,0_0_0_0_1_0_0_0_1_0_0_1_1_0_1_1_2_2_18_18_18_18_18_18_18_18_18_18_5_5_6_6
8292,178,1332630000,6,24,99,1332630000,0,904200,904200,0,10_10_10_10_10_10_10_10_10_10_10_10_10_1_10_1_10_10_1_1_1_1_2_2_9_9_13_13_13_13_5_5_5_5_6_6
8293,209,1332630900,3,4,2,1332659280,28380,1041300,1091400,50100,16_16_16_16_16_16_16_16_16_1_1_16_16_16_16_16_1_1_3_3
8294,21,1332630900,19,20,19,1332954600,323700,4500,470460,465960,19_19
8295,212,1332637380,19,11,19,1332647040,9660,0,204240,204240,19
8296,13,1332639300,19,11,19,1332669480,30180,2072760,2525940,453180,19_19_19_1_1_19_19_19_19_19_19_19_19_19_19_19_1_1_1_19_1_19_19_19_19_19_19_19_19_19_19_1_19_1_19_19_19_19_19_19_1_1_1_1_19_19_19_19_1_1_1_1_1_1_19_19_1_19_1_19_19_19_19_19_2_2_9_9_2_2_1_9_1_3_1_3_9_1_1_1_19_1_1_19_19_3_19_3_3_3_9_19_9_19_3_3_1_19_1_3_3_19_19_19_19_19_19
8297,212,1332647040,19,11,19,1332658140,11100,9660,204240,194580,19_19
8298,3,1332647100,13,17,5,1332647400,300,989880,1055580,65700,12_12_10_10_10_10_10_10_10_10_10_10_10_10_10_10_1_1_9_9_3_3_13_13_13_13
8299,37,1332647100,16,11,16,1332648480,1380,287100,736020,448920,16_16_16_16_16_16_16_16_16_16_16_16_16_16_16_16_16_16_16_16
8300,14,1332647100,0,11,0,1332648360,1260,1067700,1327560,259860,20_20_20_20_20_20_20_20_20_20_20_20_8_8_0_0_0_0_0_20_0_20_20_0_0_20_0_0
8301,3,1332647400,5,9,3,1332658800,11400,990180,1055580,65400,12_12_10_10_10_10_10_10_10_10_10_10_10_10_10_10_1_1_9_9_3_3_13_13_13_13_5
8302,196,1332648000,8,18,8,1332655200,7200,2847300,3281700,434400,7_7_7_7_7_7_7_7_7_7_7_7_7_7_7_7_7_7_7_7_1_1_1_1_7_7_1_1_7_7_1_1_7_7_7_1_1_7_7_7_7_7_7_7_7_7_1_1_7_7_7_30_30_7_1_7_7_1_7_1_1_7_7_7_1_7_7_1_1_1_7_7_30_30_1_1_10_10_10_1_1_10_10_10_10_1_1_10_10_10_10_8_8_7_10_10_7_10_10_10_10_10_7_7_7_7_7_7_8
8303,26,1332648000,5,2,5,1332654000,6000,1799160,2036760,237600,16_16_16_16_16_16_16_1_1_16_1_1_2_2_25_9_25_9_3_3_18_18_18_18_15_15_15_15_3_3_3_3_18_18_18_18_18_18_5_5_5
8304,14,1332648360,0,1,0,1332678720,30360,1068960,1327560,258600,20_20_20_20_20_20_20_20_20_20_20_20_8_8_0_0_0_0_0_20_0_20_20_0_0_20_0_0_0
8305,37,1332648480,16,14,16,1332661140,12660,288480,736020,447540,16_16_16_16_16_16_16_16_16_16_16_16_16_16_16_16_16_16_16_16_16
8306,22,1332649140,17,10,17,1332686700,37560,428820,810360,381540,17_17_17_17_17_17_17_17_17
8307,208,1332650520,3,4,3,1332655380,4860,1546260,1620480,74220,16_16_16_16_16_16_16_16_1_1_2_2_21_21_3_3_3
8308,152,1332652800,18,19,18,1332663780,10980,3405360,3766500,361140,17_17_17_17_17_17_17_17_17_17_17_17_1_1_2_2_17_17_17_17_3_3_3_3_3_3_18_18_18_18_18_18_18_18_18_18_18
8309,220,1332653940,4,5,4,1332680220,26280,2309580,2714040,404460,0_0_0_0_1_0_1_0_0_0_0_0_1_0_0_1_0_0_0_0_0_0_0_0_0_0_0_0_0_0_0_1_1_0_1_1_1_1_0_0_1_1_2_2_2_2_2_2_2_2_27_27_27_27_27_27_27_27_27_27_27_27_27_27_27_27_3_3_3_3_3_3_3_3_3_3_3_3_3_3_4_4_4_4_1_4_4_1_4
8310,26,1332654000,2,3,2,1332659400,5400,1805160,2036760,231600,16_16_16_16_16_16_16_1_1_16_1_1_2_2_25_9_25_9_3_3_18_18_18_18_15_15_15_15_3_3_3_3_18_18_18_18_18_18_5_5_5_5_2
8311,26,1332654000,5,2,2,1332654000,0,1805160,2036760,231600,16_16_16_16_16_16_16_1_1_16_1_1_2_2_25_9_25_9_3_3_18_18_18_18_15_15_15_15_3_3_3_3_18_18_18_18_18_18_5_5_5_5
8312,18,1332655200,5,18,5,1332658800,3600,1721940,1779540,57600,0_0_0_0_0_0_0_0_0_1_1_1_1_0_9_9_9_9_9_9_1_1_3_3_18_18_18_18_18_18_15_18_15_18_18_18_18_18_15_15_2_2_5
8313,196,1332655200,8,18,10,1332657240,2040,2854500,3281700,427200,7_7_7_7_7_7_7_7_7_7_7_7_7_7_7_7_7_7_7_7_1_1_1_1_7_7_1_1_7_7_1_1_7_7_7_1_1_7_7_7_7_7_7_7_7_7_1_1_7_7_7_30_30_7_1_7_7_1_7_1_1_7_7_7_1_7_7_1_1_1_7_7_30_30_1_1_10_10_10_1_1_10_10_10_10_1_1_10_10_10_10_8_8_7_10_10_7_10_10_10_10_10_7_7_7_7_7_7_8_8
8314,63,1332655200,5,2,5,1332669000,13800,5803740,6232860,429120,16_16_16_16_16_16_16_16_16_0_0_16_16_0_16_16_0_16_16_0_0_16_16_16_0_0_16_0_0_16_0_16_0_0_0_16_1_1_1_16_16_16_0_1_1_1_16_0_0_16_16_0_16_0_16_0_0_2_2_1_1_0_0_0_0_2_2_2_2_2_2_0_1_0_1_1_0_0_0_1_1_0_0_1_1_1_0_0_0_0_0_2_2_2_2_0_0_0_0_0_0_1_1_1_1_0_0_16_0_16_16_16_16_16_0_0_1_1_2_2_1_1_16_0_2_16_2_2_2_0_1_1_1_1_1_16_16_1_1_1_3_3_18_3_18_3_3_3_3_3_18_18_18_18_3_3_3_3_18_18_18_18_18_18_18_5_5_5_18_5_18_18_18_18_18_5_5_5_18_18_18_5_6_6_5_5_5_5_3_5_18_3_3_3_18_16_18_16_5_18_18_6_3_6_18_3_18_18_5_5_18_5_5_5_5_5_5_5_5_5_18_3_5_3_18_3_3_3_3_18_18_18_18_3_5_5_18_3_18_6_3_6_3_18_3_3_18_18_5_5_3_18_3_5_34_34_3_3_18_5_18_3_2_3_2_18_5_34_18_3_5_5_3_5_3_3_5_18_3_34_3_5_18_18_18_18_18_18_18_18_18_18_18_18_18_18_18_18_18_18_34_34_5_34_5_34_5_5_6_6_5_5_6_6_5_5_5_5_5_5_5_5_5_5_5_5_5
8315,208,1332655380,3,4,18,1332665400,10020,1551120,1620480,69360,16_16_16_16_16_16_16_16_1_1_2_2_21_21_3_3_3_3
8316,196,1332657240,10,16,10,1332679860,22620,2856540,3281700,425160,7_7_7_7_7_7_7_7_7_7_7_7_7_7_7_7_7_7_7_7_1_1_1_1_7_7_1_1_7_7_1_1_7_7_7_1_1_7_7_7_7_7_7_7_7_7_1_1_7_7_7_30_30_7_1_7_7_1_7_1_1_7_7_7_1_7_7_1_1_1_7_7_30_30_1_1_10_10_10_1_1_10_10_10_10_1_1_10_10_10_10_8_8_7_10_10_7_10_10_10_10_10_7_7_7_7_7_7_8_8_10
8317,212,1332658140,19,21,19,1332680280,22140,20760,204240,183480,19_19_19
8318,15,1332658140,5,18,5,1332680580,22440,1478160,1822860,344700,7_7_7_7_7_7_1_7_1_7_7_7_7_7_7_7_7_7_7_7_7_7_7_7_1_1_1_1_2_2_3_3_17_17_17_17_17_17_17_17_17_17_17_5_5_5_5_17_17_6_6_6_6_17_1_1_2_2_17_17_17_17_21_21_21_3_21_3_5
8319,28,1332658800,5,18,5,1332659700,900,439260,493260,54000,0_0_0_0_0_0_0_0_1_1_2_2_3_3_5_5_5
8320,18,1332658800,5,18,6,1332709200,50400,1725540,1779540,54000,0_0_0_0_0_0_0_0_0_1_1_1_1_0_9_9_9_9_9_9_1_1_3_3_18_18_18_18_18_18_15_18_15_18_18_18_18_18_15_15_2_2_5_5
8321,3,1332658800,3,3,3,1332662400,3600,1001580,1055580,54000,12_12_10_10_10_10_10_10_10_10_10_10_10_10_10_10_1_1_9_9_3_3_13_13_13_13_5_3
8322,209,1332659280,2,4,2,1332661260,1980,1069680,1091400,21720,16_16_16_16_16_16_16_16_16_1_1_16_16_16_16_16_1_1_3_3_2
8323,26,1332659400,2,3,11,1332695280,35880,1810560,2036760,226200,16_16_16_16_16_16_16_1_1_16_1_1_2_2_25_9_25_9_3_3_18_18_18_18_15_15_15_15_3_3_3_3_18_18_18_18_18_18_5_5_5_5_2_2
8324,65,1332659700,5,18,5,1332663000,3300,7118100,7544400,426300,17_17_34_34_6_6_6_6_5_5_1_1_1_1_2_2_3_3_5_5_5
8325,28,1332659700,5,18,6,1332709200,49500,440160,493260,53100,0_0_0_0_0_0_0_0_1_1_2_2_3_3_5_5_5_5
8326,37,1332661140,16,14,16,1332666540,5400,301140,736020,434880,16_16_16_16_16_16_16_16_16_16_16_16_16_16_16_16_16_16_16_16_16_16
8327,209,1332661260,2,4,9,1332664680,3420,1071660,1091400,19740,16_16_16_16_16_16_16_16_16_1_1_16_16_16_16_16_1_1_3_3_2_2
8328,3,1332662400,3,3,2,1332663300,900,1005180,1055580,50400,12_12_10_10_10_10_10_10_10_10_10_10_10_10_10_10_1_1_9_9_3_3_13_13_13_13_5_3_3
8329,65,1332663000,5,18,3,1332676020,13020,7121400,7544400,423000,17_17_34_34_6_6_6_6_5_5_1_1_1_1_2_2_3_3_5_5_5_5
8330,3,1332663300,2,3,2,1332664140,840,1006080,1055580,49500,12_12_10_10_10_10_10_10_10_10_10_10_10_10_10_10_1_1_9_9_3_3_13_13_13_13_5_3_3_2
8331,152,1332663780,18,19,18,1332663780,0,3416340,3766500,350160,17_17_17_17_17_17_17_17_17_17_17_17_1_1_2_2_17_17_17_17_3_3_3_3_3_3_18_18_18_18_18_18_18_18_18_18_18_18
8332,152,1332663780,18,19,18,1332665220,1440,3416340,3766500,350160,17_17_17_17_17_17_17_17_17_17_17_17_1_1_2_2_17_17_17_17_3_3_3_3_3_3_18_18_18_18_18_18_18_18_18_18_18_18_18
8333,3,1332664140,2,3,5,1332664260,120,1006920,1055580,48660,12_12_10_10_10_10_10_10_10_10_10_10_10_10_10_10_1_1_9_9_3_3_13_13_13_13_5_3_3_2_2
8334,3,1332664260,5,9,6,1332709200,44940,1007040,1055580,48540,12_12_10_10_10_10_10_10_10_10_10_10_10_10_10_10_1_1_9_9_3_3_13_13_13_13_5_3_3_2_2_5
8335,209,1332664680,9,3,9,1332669240,4560,1075080,1091400,16320,16_16_16_16_16_16_16_16_16_1_1_16_16_16_16_16_1_1_3_3_2_2_9
8336,152,1332665220,18,19,5,1332919260,254040,3417780,3766500,348720,17_17_17_17_17_17_17_17_17_17_17_17_1_1_2_2_17_17_17_17_3_3_3_3_3_3_18_18_18_18_18_18_18_18_18_18_18_18_18_18
8337,207,1332665280,1,9,1,1332687540,22260,170580,272580,102000,1_1_1
8338,208,1332665400,18,19,18,1332673260,7860,1561140,1620480,59340,16_16_16_16_16_16_16_16_1_1_2_2_21_21_3_3_3_3_18
8339,37,1332666540,16,14,16,1332667620,1080,306540,736020,429480,16_16_16_16_16_16_16_16_16_16_16_16_16_16_16_16_16_16_16_16_16_16_16
8340,224,1332666720,1,9,1,1332671220,4500,256380,648060,391680,1_1_1_1_1
8341,37,1332667620,16,14,16,1332693540,25920,307620,736020,428400,16_16_16_16_16_16_16_16_16_16_16_16_16_16_16_16_16_16_16_16_16_16_16_16
8342,63,1332669000,5,2,5,1332670800,1800,5817540,6232860,415320,16_16_16_16_16_16_16_16_16_0_0_16_16_0_16_16_0_16_16_0_0_16_16_16_0_0_16_0_0_16_0_16_0_0_0_16_1_1_1_16_16_16_0_1_1_1_16_0_0_16_16_0_16_0_16_0_0_2_2_1_1_0_0_0_0_2_2_2_2_2_2_0_1_0_1_1_0_0_0_1_1_0_0_1_1_1_0_0_0_0_0_2_2_2_2_0_0_0_0_0_0_1_1_1_1_0_0_16_0_16_16_16_16_16_0_0_1_1_2_2_1_1_16_0_2_16_2_2_2_0_1_1_1_1_1_16_16_1_1_1_3_3_18_3_18_3_3_3_3_3_18_18_18_18_3_3_3_3_18_18_18_18_18_18_18_5_5_5_18_5_18_18_18_18_18_5_5_5_18_18_18_5_6_6_5_5_5_5_3_5_18_3_3_3_18_16_18_16_5_18_18_6_3_6_18_3_18_18_5_5_18_5_5_5_5_5_5_5_5_5_18_3_5_3_18_3_3_3_3_18_18_18_18_3_5_5_18_3_18_6_3_6_3_18_3_3_18_18_5_5_3_18_3_5_34_34_3_3_18_5_18_3_2_3_2_18_5_34_18_3_5_5_3_5_3_3_5_18_3_34_3_5_18_18_18_18_18_18_18_18_18_18_18_18_18_18_18_18_18_18_34_34_5_34_5_34_5_5_6_6_5_5_6_6_5_5_5_5_5_5_5_5_5_5_5_5_5_5
8343,209,1332669240,9,3,3,1332669240,0,1079640,1091400,11760,16_16_16_16_16_16_16_16_16_1_1_16_16_16_16_16_1_1_3_3_2_2_9_9
8344,209,1332669240,3,3,3,1332677940,8700,1079640,1091400,11760,16_16_16_16_16_16_16_16_16_1_1_16_16_16_16_16_1_1_3_3_2_2_9_9_3
8345,13,1332669480,19,0,3,1332709200,39720,2102940,2525940,423000,19_19_19_1_1_19_19_19_19_19_19_19_19_19_19_19_1_1_1_19_1_19_19_19_19_19_19_19_19_19_19_1_19_1_19_19_19_19_19_19_1_1_1_1_19_19_19_19_1_1_1_1_1_1_19_19_1_19_1_19_19_19_19_19_2_2_9_9_2_2_1_9_1_3_1_3_9_1_1_1_19_1_1_19_19_3_19_3_3_3_9_19_9_19_3_3_1_19_1_3_3_19_19_19_19_19_19_19
8346,63,1332670800,5,2,5,1332678600,7800,5819340,6232860,413520,16_16_16_16_16_16_16_16_16_0_0_16_16_0_16_16_0_16_16_0_0_16_16_16_0_0_16_0_0_16_0_16_0_0_0_16_1_1_1_16_16_16_0_1_1_1_16_0_0_16_16_0_16_0_16_0_0_2_2_1_1_0_0_0_0_2_2_2_2_2_2_0_1_0_1_1_0_0_0_1_1_0_0_1_1_1_0_0_0_0_0_2_2_2_2_0_0_0_0_0_0_1_1_1_1_0_0_16_0_16_16_16_16_16_0_0_1_1_2_2_1_1_16_0_2_16_2_2_2_0_1_1_1_1_1_16_16_1_1_1_3_3_18_3_18_3_3_3_3_3_18_18_18_18_3_3_3_3_18_18_18_18_18_18_18_5_5_5_18_5_18_18_18_18_18_5_5_5_18_18_18_5_6_6_5_5_5_5_3_5_18_3_3_3_18_16_18_16_5_18_18_6_3_6_18_3_18_18_5_5_18_5_5_5_5_5_5_5_5_5_18_3_5_3_18_3_3_3_3_18_18_18_18_3_5_5_18_3_18_6_3_6_3_18_3_3_18_18_5_5_3_18_3_5_34_34_3_3_18_5_18_3_2_3_2_18_5_34_18_3_5_5_3_5_3_3_5_18_3_34_3_5_18_18_18_18_18_18_18_18_18_18_18_18_18_18_18_18_18_18_34_34_5_34_5_34_5_5_6_6_5_5_6_6_5_5_5_5_5_5_5_5_5_5_5_5_5_5_5
8347,224,1332671220,1,9,3,1332709200,37980,260880,648060,387180,1_1_1_1_1_1
8348,208,1332673260,18,19,18,1332673320,60,1569000,1620480,51480,16_16_16_16_16_16_16_16_1_1_2_2_21_21_3_3_3_3_18_18
8349,208,1332673320,18,19,18,1332686460,13140,1569060,1620480,51420,16_16_16_16_16_16_16_16_1_1_2_2_21_21_3_3_3_3_18_18_18
8350,65,1332676020,3,3,3,1332677940,1920,7134420,7544400,409980,17_17_34_34_6_6_6_6_5_5_1_1_1_1_2_2_3_3_5_5_5_5_3
8351,209,1332677940,9,3,9,1332679260,1320,1088340,1091400,3060,16_16_16_16_16_16_16_16_16_1_1_16_16_16_16_16_1_1_3_3_2_2_9_9_3_3_9
8352,209,1332677940,3,3,9,1332677940,0,1088340,1091400,3060,16_16_16_16_16_16_16_16_16_1_1_16_16_16_16_16_1_1_3_3_2_2_9_9_3_3
8353,65,1332677940,3,3,18,1332724800,46860,7136340,7544400,408060,17_17_34_34_6_6_6_6_5_5_1_1_1_1_2_2_3_3_5_5_5_5_3_3
8354,63,1332678600,5,2,34,1332701760,23160,5827140,6232860,405720,16_16_16_16_16_16_16_16_16_0_0_16_16_0_16_16_0_16_16_0_0_16_16_16_0_0_16_0_0_16_0_16_0_0_0_16_1_1_1_16_16_16_0_1_1_1_16_0_0_16_16_0_16_0_16_0_0_2_2_1_1_0_0_0_0_2_2_2_2_2_2_0_1_0_1_1_0_0_0_1_1_0_0_1_1_1_0_0_0_0_0_2_2_2_2_0_0_0_0_0_0_1_1_1_1_0_0_16_0_16_16_16_16_16_0_0_1_1_2_2_1_1_16_0_2_16_2_2_2_0_1_1_1_1_1_16_16_1_1_1_3_3_18_3_18_3_3_3_3_3_18_18_18_18_3_3_3_3_18_18_18_18_18_18_18_5_5_5_18_5_18_18_18_18_18_5_5_5_18_18_18_5_6_6_5_5_5_5_3_5_18_3_3_3_18_16_18_16_5_18_18_6_3_6_18_3_18_18_5_5_18_5_5_5_5_5_5_5_5_5_18_3_5_3_18_3_3_3_3_18_18_18_18_3_5_5_18_3_18_6_3_6_3_18_3_3_18_18_5_5_3_18_3_5_34_34_3_3_18_5_18_3_2_3_2_18_5_34_18_3_5_5_3_5_3_3_5_18_3_34_3_5_18_18_18_18_18_18_18_18_18_18_18_18_18_18_18_18_18_18_34_34_5_34_5_34_5_5_6_6_5_5_6_6_5_5_5_5_5_5_5_5_5_5_5_5_5_5_5_5
8355,14,1332678720,0,1,0,1332694440,15720,1099320,1327560,228240,20_20_20_20_20_20_20_20_20_20_20_20_8_8_0_0_0_0_0_20_0_20_20_0_0_20_0_0_0_0
8356,30,1332679200,2,3,2,1332679260,60,398400,604800,206400,0_0_0_0_0_1_0_0_1_0_1_1_2
8357,209,1332679260,3,3,3,1332681000,1740,1089660,1091400,1740,16_16_16_16_16_16_16_16_16_1_1_16_16_16_16_16_1_1_3_3_2_2_9_9_3_3_9_9_3
8358,209,1332679260,9,3,3,1332679260,0,1089660,1091400,1740,16_16_16_16_16_16_16_16_16_1_1_16_16_16_16_16_1_1_3_3_2_2_9_9_3_3_9_9
8359,30,1332679260,2,3,3,1332709200,29940,398460,604800,206340,0_0_0_0_0_1_0_0_1_0_1_1_2_2
8360,64,1332679500,2,3,2,1332684000,4500,6579420,6845160,265740,1_1_11_11_5_5_1_1_6_6_1_1_19_19_2
8361,196,1332679860,10,16,7,1332684060,4200,2879160,3281700,402540,7_7_7_7_7_7_7_7_7_7_7_7_7_7_7_7_7_7_7_7_1_1_1_1_7_7_1_1_7_7_1_1_7_7_7_1_1_7_7_7_7_7_7_7_7_7_1_1_7_7_7_30_30_7_1_7_7_1_7_1_1_7_7_7_1_7_7_1_1_1_7_7_30_30_1_1_10_10_10_1_1_10_10_10_10_1_1_10_10_10_10_8_8_7_10_10_7_10_10_10_10_10_7_7_7_7_7_7_8_8_10_10
8362,220,1332680220,4,5,4,1332681240,1020,2335860,2714040,378180,0_0_0_0_1_0_1_0_0_0_0_0_1_0_0_1_0_0_0_0_0_0_0_0_0_0_0_0_0_0_0_1_1_0_1_1_1_1_0_0_1_1_2_2_2_2_2_2_2_2_27_27_27_27_27_27_27_27_27_27_27_27_27_27_27_27_3_3_3_3_3_3_3_3_3_3_3_3_3_3_4_4_4_4_1_4_4_1_4_4
8363,212,1332680280,19,21,19,1332681600,1320,42900,204240,161340,19_19_19_19
8364,15,1332680580,5,18,6,1332968400,287820,1500600,1822860,322260,7_7_7_7_7_7_1_7_1_7_7_7_7_7_7_7_7_7_7_7_7_7_7_7_1_1_1_1_2_2_3_3_17_17_17_17_17_17_17_17_17_17_17_5_5_5_5_17_17_6_6_6_6_17_1_1_2_2_17_17_17_17_21_21_21_3_21_3_5_5
8365,209,1332681000,3,3,99,1332681000,0,1091400,1091400,0,16_16_16_16_16_16_16_16_16_1_1_16_16_16_16_16_1_1_3_3_2_2_9_9_3_3_9_9_3_3
8366,220,1332681240,4,19,4,1332687480,6240,2336880,2714040,377160,0_0_0_0_1_0_1_0_0_0_0_0_1_0_0_1_0_0_0_0_0_0_0_0_0_0_0_0_0_0_0_1_1_0_1_1_1_1_0_0_1_1_2_2_2_2_2_2_2_2_27_27_27_27_27_27_27_27_27_27_27_27_27_27_27_27_3_3_3_3_3_3_3_3_3_3_3_3_3_3_4_4_4_4_1_4_4_1_4_4_4
8367,212,1332681600,19,14,19,1332687240,5640,44220,204240,160020,19_19_19_19_19
8368,57,1332683820,26,13,26,1332697980,14160,2416080,2756640,340560,26_26_26_26_26_26_26_26_26_26_26_26_26_26_26_26_26_26_26_26_26_26_26_26_26_8_8_8_8_2_2_26_8_8_26_26_26_26_26_26_26_26_8_8_26_26_26_26_26_26_8_8_8_8_26_26_26_26_6_6_5_5_26
8369,64,1332684000,2,3,3,1332829980,145980,6583920,6845160,261240,1_1_11_11_5_5_1_1_6_6_1_1_19_19_2_2
8370,196,1332684060,7,8,7,1332708480,24420,2883360,3281700,398340,7_7_7_7_7_7_7_7_7_7_7_7_7_7_7_7_7_7_7_7_1_1_1_1_7_7_1_1_7_7_1_1_7_7_7_1_1_7_7_7_7_7_7_7_7_7_1_1_7_7_7_30_30_7_1_7_7_1_7_1_1_7_7_7_1_7_7_1_1_1_7_7_30_30_1_1_10_10_10_1_1_10_10_10_10_1_1_10_10_10_10_8_8_7_10_10_7_10_10_10_10_10_7_7_7_7_7_7_8_8_10_10_7
8371,208,1332686460,18,19,18,1332697260,10800,1582200,1620480,38280,16_16_16_16_16_16_16_16_1_1_2_2_21_21_3_3_3_3_18_18_18_18
8372,22,1332686700,17,10,17,1332739800,53100,466380,810360,343980,17_17_17_17_17_17_17_17_17_17
8373,212,1332687240,19,14,19,1332695340,8100,49860,204240,154380,19_19_19_19_19_19
8374,220,1332687480,4,19,4,1332694800,7320,2343120,2714040,370920,0_0_0_0_1_0_1_0_0_0_0_0_1_0_0_1_0_0_0_0_0_0_0_0_0_0_0_0_0_0_0_1_1_0_1_1_1_1_0_0_1_1_2_2_2_2_2_2_2_2_27_27_27_27_27_27_27_27_27_27_27_27_27_27_27_27_3_3_3_3_3_3_3_3_3_3_3_3_3_3_4_4_4_4_1_4_4_1_4_4_4_4
8375,207,1332687540,1,9,1,1332733680,46140,192840,272580,79740,1_1_1_1
8376,37,1332693540,16,20,16,1332707760,14220,333540,736020,402480,16_16_16_16_16_16_16_16_16_16_16_16_16_16_16_16_16_16_16_16_16_16_16_16_16
8377,14,1332694440,0,0,0,1332733380,38940,1115040,1327560,212520,20_20_20_20_20_20_20_20_20_20_20_20_8_8_0_0_0_0_0_20_0_20_20_0_0_20_0_0_0_0_0
8378,220,1332694800,4,22,4,1332707400,12600,2350440,2714040,363600,0_0_0_0_1_0_1_0_0_0_0_0_1_0_0_1_0_0_0_0_0_0_0_0_0_0_0_0_0_0_0_1_1_0_1_1_1_1_0_0_1_1_2_2_2_2_2_2_2_2_27_27_27_27_27_27_27_27_27_27_27_27_27_27_27_27_3_3_3_3_3_3_3_3_3_3_3_3_3_3_4_4_4_4_1_4_4_1_4_4_4_4_4
8379,26,1332695280,11,17,11,1332701700,6420,1846440,2036760,190320,16_16_16_16_16_16_16_1_1_16_1_1_2_2_25_9_25_9_3_3_18_18_18_18_15_15_15_15_3_3_3_3_18_18_18_18_18_18_5_5_5_5_2_2_11
8380,212,1332695340,19,11,19,1332733080,37740,57960,204240,146280,19_19_19_19_19_19_19
8381,208,1332697260,18,23,18,1332724740,27480,1593000,1620480,27480,16_16_16_16_16_16_16_16_1_1_2_2_21_21_3_3_3_3_18_18_18_18_18
8382,57,1332697980,26,13,26,1332706380,8400,2430240,2756640,326400,26_26_26_26_26_26_26_26_26_26_26_26_26_26_26_26_26_26_26_26_26_26_26_26_26_8_8_8_8_2_2_26_8_8_26_26_26_26_26_26_26_26_8_8_26_26_26_26_26_26_8_8_8_8_26_26_26_26_6_6_5_5_26_26_26
8383,57,1332697980,26,13,26,1332697980,0,2430240,2756640,326400,26_26_26_26_26_26_26_26_26_26_26_26_26_26_26_26_26_26_26_26_26_26_26_26_26_8_8_8_8_2_2_26_8_8_26_26_26_26_26_26_26_26_8_8_26_26_26_26_26_26_8_8_8_8_26_26_26_26_6_6_5_5_26_26
8384,26,1332701700,11,17,5,1332734400,32700,1852860,2036760,183900,16_16_16_16_16_16_16_1_1_16_1_1_2_2_25_9_25_9_3_3_18_18_18_18_15_15_15_15_3_3_3_3_18_18_18_18_18_18_5_5_5_5_2_2_11_11
8385,63,1332701760,34,17,34,1332708060,6300,5850300,6232860,382560,16_16_16_16_16_16_16_16_16_0_0_16_16_0_16_16_0_16_16_0_0_16_16_16_0_0_16_0_0_16_0_16_0_0_0_16_1_1_1_16_16_16_0_1_1_1_16_0_0_16_16_0_16_0_16_0_0_2_2_1_1_0_0_0_0_2_2_2_2_2_2_0_1_0_1_1_0_0_0_1_1_0_0_1_1_1_0_0_0_0_0_2_2_2_2_0_0_0_0_0_0_1_1_1_1_0_0_16_0_16_16_16_16_16_0_0_1_1_2_2_1_1_16_0_2_16_2_2_2_0_1_1_1_1_1_16_16_1_1_1_3_3_18_3_18_3_3_3_3_3_18_18_18_18_3_3_3_3_18_18_18_18_18_18_18_5_5_5_18_5_18_18_18_18_18_5_5_5_18_18_18_5_6_6_5_5_5_5_3_5_18_3_3_3_18_16_18_16_5_18_18_6_3_6_18_3_18_18_5_5_18_5_5_5_5_5_5_5_5_5_18_3_5_3_18_3_3_3_3_18_18_18_18_3_5_5_18_3_18_6_3_6_3_18_3_3_18_18_5_5_3_18_3_5_34_34_3_3_18_5_18_3_2_3_2_18_5_34_18_3_5_5_3_5_3_3_5_18_3_34_3_5_18_18_18_18_18_18_18_18_18_18_18_18_18_18_18_18_18_18_34_34_5_34_5_34_5_5_6_6_5_5_6_6_5_5_5_5_5_5_5_5_5_5_5_5_5_5_5_5_34
8386,57,1332706380,26,13,26,1332706440,60,2438640,2756640,318000,26_26_26_26_26_26_26_26_26_26_26_26_26_26_26_26_26_26_26_26_26_26_26_26_26_8_8_8_8_2_2_26_8_8_26_26_26_26_26_26_26_26_8_8_26_26_26_26_26_26_8_8_8_8_26_26_26_26_6_6_5_5_26_26_26_26
8387,57,1332706440,26,13,26,1332717600,11160,2438700,2756640,317940,26_26_26_26_26_26_26_26_26_26_26_26_26_26_26_26_26_26_26_26_26_26_26_26_26_8_8_8_8_2_2_26_8_8_26_26_26_26_26_26_26_26_8_8_26_26_26_26_26_26_8_8_8_8_26_26_26_26_6_6_5_5_26_26_26_26_26
8388,220,1332707400,4,22,4,1332708300,900,2363040,2714040,351000,0_0_0_0_1_0_1_0_0_0_0_0_1_0_0_1_0_0_0_0_0_0_0_0_0_0_0_0_0_0_0_1_1_0_1_1_1_1_0_0_1_1_2_2_2_2_2_2_2_2_27_27_27_27_27_27_27_27_27_27_27_27_27_27_27_27_3_3_3_3_3_3_3_3_3_3_3_3_3_3_4_4_4_4_1_4_4_1_4_4_4_4_4_4
8389,37,1332707760,16,20,16,1332708120,360,347760,736020,388260,16_16_16_16_16_16_16_16_16_16_16_16_16_16_16_16_16_16_16_16_16_16_16_16_16_16
8390,63,1332708060,34,17,34,1332774360,66300,5856600,6232860,376260,16_16_16_16_16_16_16_16_16_0_0_16_16_0_16_16_0_16_16_0_0_16_16_16_0_0_16_0_0_16_0_16_0_0_0_16_1_1_1_16_16_16_0_1_1_1_16_0_0_16_16_0_16_0_16_0_0_2_2_1_1_0_0_0_0_2_2_2_2_2_2_0_1_0_1_1_0_0_0_1_1_0_0_1_1_1_0_0_0_0_0_2_2_2_2_0_0_0_0_0_0_1_1_1_1_0_0_16_0_16_16_16_16_16_0_0_1_1_2_2_1_1_16_0_2_16_2_2_2_0_1_1_1_1_1_16_16_1_1_1_3_3_18_3_18_3_3_3_3_3_18_18_18_18_3_3_3_3_18_18_18_18_18_18_18_5_5_5_18_5_18_18_18_18_18_5_5_5_18_18_18_5_6_6_5_5_5_5_3_5_18_3_3_3_18_16_18_16_5_18_18_6_3_6_18_3_18_18_5_5_18_5_5_5_5_5_5_5_5_5_18_3_5_3_18_3_3_3_3_18_18_18_18_3_5_5_18_3_18_6_3_6_3_18_3_3_18_18_5_5_3_18_3_5_34_34_3_3_18_5_18_3_2_3_2_18_5_34_18_3_5_5_3_5_3_3_5_18_3_34_3_5_18_18_18_18_18_18_18_18_18_18_18_18_18_18_18_18_18_18_34_34_5_34_5_34_5_5_6_6_5_5_6_6_5_5_5_5_5_5_5_5_5_5_5_5_5_5_5_5_34_34
8391,37,1332708120,16,11,16,1332733080,24960,348120,736020,387900,16_16_16_16_16_16_16_16_16_16_16_16_16_16_16_16_16_16_16_16_16_16_16_16_16_16_16
8392,220,1332708300,4,22,4,1332733200,24900,2363940,2714040,350100,0_0_0_0_1_0_1_0_0_0_0_0_1_0_0_1_0_0_0_0_0_0_0_0_0_0_0_0_0_0_0_1_1_0_1_1_1_1_0_0_1_1_2_2_2_2_2_2_2_2_27_27_27_27_27_27_27_27_27_27_27_27_27_27_27_27_3_3_3_3_3_3_3_3_3_3_3_3_3_3_4_4_4_4_1_4_4_1_4_4_4_4_4_4_4
8393,196,1332708480,7,8,1,1332734400,25920,2907780,3281700,373920,7_7_7_7_7_7_7_7_7_7_7_7_7_7_7_7_7_7_7_7_1_1_1_1_7_7_1_1_7_7_1_1_7_7_7_1_1_7_7_7_7_7_7_7_7_7_1_1_7_7_7_30_30_7_1_7_7_1_7_1_1_7_7_7_1_7_7_1_1_1_7_7_30_30_1_1_10_10_10_1_1_10_10_10_10_1_1_10_10_10_10_8_8_7_10_10_7_10_10_10_10_10_7_7_7_7_7_7_8_8_10_10_7_7
8394,18,1332709200,6,7,6,1332712800,3600,1775940,1779540,3600,0_0_0_0_0_0_0_0_0_1_1_1_1_0_9_9_9_9_9_9_1_1_3_3_18_18_18_18_18_18_15_18_15_18_18_18_18_18_15_15_2_2_5_5_6
8395,13,1332709200,3,4,3,1332713700,4500,2142660,2525940,383280,19_19_19_1_1_19_19_19_19_19_19_19_19_19_19_19_1_1_1_19_1_19_19_19_19_19_19_19_19_19_19_1_19_1_19_19_19_19_19_19_1_1_1_1_19_19_19_19_1_1_1_1_1_1_19_19_1_19_1_19_19_19_19_19_2_2_9_9_2_2_1_9_1_3_1_3_9_1_1_1_19_1_1_19_19_3_19_3_3_3_9_19_9_19_3_3_1_19_1_3_3_19_19_19_19_19_19_19_3
8396,43,1332709200,0,20,0,1332713700,4500,0,4500,4500,0
8397,224,1332709200,3,4,3,1332713700,4500,298860,648060,349200,1_1_1_1_1_1_3
8398,30,1332709200,3,4,3,1332713700,4500,428400,604800,176400,0_0_0_0_0_1_0_0_1_0_1_1_2_2_3
8399,28,1332709200,6,7,6,1332712800,3600,489660,493260,3600,0_0_0_0_0_0_0_0_1_1_2_2_3_3_5_5_5_5_6
8400,3,1332709200,6,7,6,1332712800,3600,1051980,1055580,3600,12_12_10_10_10_10_10_10_10_10_10_10_10_10_10_10_1_1_9_9_3_3_13_13_13_13_5_3_3_2_2_5_6
8401,133,1332709200,3,4,3,1332713700,4500,5918400,6181200,262800,17_17_17_17_17_17_17_17_17_17_17_17_17_17_17_17_17_17_17_17_17_17_17_17_17_17_17_17_17_17_1_1_17_17_17_17_1_1_1_1_17_17_17_17_17_17_17_17_17_17_17_17_17_17_17_17_17_17_17_17_17_17_19_19_17_17_2_2_3_3_3_3_3_3_5_5_6_6_17_17_17_17_3
8402,3,1332712800,6,7,99,1332712800,0,1055580,1055580,0,12_12_10_10_10_10_10_10_10_10_10_10_10_10_10_10_1_1_9_9_3_3_13_13_13_13_5_3_3_2_2_5_6_6
8403,28,1332712800,6,7,99,1332712800,0,493260,493260,0,0_0_0_0_0_0_0_0_1_1_2_2_3_3_5_5_5_5_6_6
8404,18,1332712800,6,7,99,1332712800,0,1779540,1779540,0,0_0_0_0_0_0_0_0_0_1_1_1_1_0_9_9_9_9_9_9_1_1_3_3_18_18_18_18_18_18_15_18_15_18_18_18_18_18_15_15_2_2_5_5_6_6
8405,13,1332713700,3,4,2,1332734580,20880,2147160,2525940,378780,19_19_19_1_1_19_19_19_19_19_19_19_19_19_19_19_1_1_1_19_1_19_19_19_19_19_19_19_19_19_19_1_19_1_19_19_19_19_19_19_1_1_1_1_19_19_19_19_1_1_1_1_1_1_19_19_1_19_1_19_19_19_19_19_2_2_9_9_2_2_1_9_1_3_1_3_9_1_1_1_19_1_1_19_19_3_19_3_3_3_9_19_9_19_3_3_1_19_1_3_3_19_19_19_19_19_19_19_3_3
8406,43,1332713700,0,20,99,1332713700,0,4500,4500,0,0_0
8407,224,1332713700,3,4,2,1332742440,28740,303360,648060,344700,1_1_1_1_1_1_3_3
8408,133,1332713700,3,4,1,1332753240,39540,5922900,6181200,258300,17_17_17_17_17_17_17_17_17_17_17_17_17_17_17_17_17_17_17_17_17_17_17_17_17_17_17_17_17_17_1_1_17_17_17_17_1_1_1_1_17_17_17_17_17_17_17_17_17_17_17_17_17_17_17_17_17_17_17_17_17_17_19_19_17_17_2_2_3_3_3_3_3_3_5_5_6_6_17_17_17_17_3_3
8409,30,1332713700,3,4,3,1332739080,25380,432900,604800,171900,0_0_0_0_0_1_0_0_1_0_1_1_2_2_3_3
8410,57,1332717600,26,13,26,1332781200,63600,2449860,2756640,306780,26_26_26_26_26_26_26_26_26_26_26_26_26_26_26_26_26_26_26_26_26_26_26_26_26_8_8_8_8_2_2_26_8_8_26_26_26_26_26_26_26_26_8_8_26_26_26_26_26_26_8_8_8_8_26_26_26_26_6_6_5_5_26_26_26_26_26_26
8411,208,1332724740,18,23,99,1332724740,0,1620480,1620480,0,16_16_16_16_16_16_16_16_1_1_2_2_21_21_3_3_3_3_18_18_18_18_18_18
8412,65,1332724800,18,23,18,1332734520,9720,7183200,7544400,361200,17_17_34_34_6_6_6_6_5_5_1_1_1_1_2_2_3_3_5_5_5_5_3_3_18
8413,212,1332733080,19,11,19,1332733860,780,95700,204240,108540,19_19_19_19_19_19_19_19
8414,37,1332733080,16,11,16,1332733980,900,373080,736020,362940,16_16_16_16_16_16_16_16_16_16_16_16_16_16_16_16_16_16_16_16_16_16_16_16_16_16_16_16
8415,220,1332733200,4,22,4,1332734400,1200,2388840,2714040,325200,0_0_0_0_1_0_1_0_0_0_0_0_1_0_0_1_0_0_0_0_0_0_0_0_0_0_0_0_0_0_0_1_1_0_1_1_1_1_0_0_1_1_2_2_2_2_2_2_2_2_27_27_27_27_27_27_27_27_27_27_27_27_27_27_27_27_3_3_3_3_3_3_3_3_3_3_3_3_3_3_4_4_4_4_1_4_4_1_4_4_4_4_4_4_4_4
8416,14,1332733380,0,0,1,1332735660,2280,1153980,1327560,173580,20_20_20_20_20_20_20_20_20_20_20_20_8_8_0_0_0_0_0_20_0_20_20_0_0_20_0_0_0_0_0_0
8417,207,1332733680,1,9,1,1332767280,33600,238980,272580,33600,1_1_1_1_1
8418,212,1332733860,19,21,19,1332738060,4200,96480,204240,107760,19_19_19_19_19_19_19_19_19
8419,37,1332733980,16,14,1,1332734400,420,373980,736020,362040,16_16_16_16_16_16_16_16_16_16_16_16_16_16_16_16_16_16_16_16_16_16_16_16_16_16_16_16_16
8420,26,1332734400,5,2,5,1332740400,6000,1885560,2036760,151200,16_16_16_16_16_16_16_1_1_16_1_1_2_2_25_9_25_9_3_3_18_18_18_18_15_15_15_15_3_3_3_3_18_18_18_18_18_18_5_5_5_5_2_2_11_11_5
8421,196,1332734400,1,18,30,1332743400,9000,2933700,3281700,348000,7_7_7_7_7_7_7_7_7_7_7_7_7_7_7_7_7_7_7_7_1_1_1_1_7_7_1_1_7_7_1_1_7_7_7_1_1_7_7_7_7_7_7_7_7_7_1_1_7_7_7_30_30_7_1_7_7_1_7_1_1_7_7_7_1_7_7_1_1_1_7_7_30_30_1_1_10_10_10_1_1_10_10_10_10_1_1_10_10_10_10_8_8_7_10_10_7_10_10_10_10_10_7_7_7_7_7_7_8_8_10_10_7_7_1
8422,220,1332734400,4,5,4,1332772980,38580,2390040,2714040,324000,0_0_0_0_1_0_1_0_0_0_0_0_1_0_0_1_0_0_0_0_0_0_0_0_0_0_0_0_0_0_0_1_1_0_1_1_1_1_0_0_1_1_2_2_2_2_2_2_2_2_27_27_27_27_27_27_27_27_27_27_27_27_27_27_27_27_3_3_3_3_3_3_3_3_3_3_3_3_3_3_4_4_4_4_1_4_4_1_4_4_4_4_4_4_4_4_4
8423,37,1332734400,1,6,1,1332738000,3600,374400,736020,361620,16_16_16_16_16_16_16_16_16_16_16_16_16_16_16_16_16_16_16_16_16_16_16_16_16_16_16_16_16_1
8424,65,1332734520,18,23,18,1332734640,120,7192920,7544400,351480,17_17_34_34_6_6_6_6_5_5_1_1_1_1_2_2_3_3_5_5_5_5_3_3_18_18
8425,13,1332734580,2,4,2,1332735360,780,2168040,2525940,357900,19_19_19_1_1_19_19_19_19_19_19_19_19_19_19_19_1_1_1_19_1_19_19_19_19_19_19_19_19_19_19_1_19_1_19_19_19_19_19_19_1_1_1_1_19_19_19_19_1_1_1_1_1_1_19_19_1_19_1_19_19_19_19_19_2_2_9_9_2_2_1_9_1_3_1_3_9_1_1_1_19_1_1_19_19_3_19_3_3_3_9_19_9_19_3_3_1_19_1_3_3_19_19_19_19_19_19_19_3_3_2
8426,65,1332734640,18,19,18,1332743580,8940,7193040,7544400,351360,17_17_34_34_6_6_6_6_5_5_1_1_1_1_2_2_3_3_5_5_5_5_3_3_18_18_18
8427,13,1332735360,2,4,3,1332795600,60240,2168820,2525940,357120,19_19_19_1_1_19_19_19_19_19_19_19_19_19_19_19_1_1_1_19_1_19_19_19_19_19_19_19_19_19_19_1_19_1_19_19_19_19_19_19_1_1_1_1_19_19_19_19_1_1_1_1_1_1_19_19_1_19_1_19_19_19_19_19_2_2_9_9_2_2_1_9_1_3_1_3_9_1_1_1_19_1_1_19_19_3_19_3_3_3_9_19_9_19_3_3_1_19_1_3_3_19_19_19_19_19_19_19_3_3_2_2
8428,14,1332735660,1,6,1,1332742920,7260,1156260,1327560,171300,20_20_20_20_20_20_20_20_20_20_20_20_8_8_0_0_0_0_0_20_0_20_20_0_0_20_0_0_0_0_0_0_1
8429,37,1332738000,1,6,16,1332742260,4260,378000,736020,358020,16_16_16_16_16_16_16_16_16_16_16_16_16_16_16_16_16_16_16_16_16_16_16_16_16_16_16_16_16_1_1
8430,212,1332738060,19,21,19,1332740220,2160,100680,204240,103560,19_19_19_19_19_19_19_19_19_19
8431,30,1332739080,3,3,3,1332741900,2820,458280,604800,146520,0_0_0_0_0_1_0_0_1_0_1_1_2_2_3_3_3
8432,22,1332739800,17,10,17,1332774000,34200,519480,810360,290880,17_17_17_17_17_17_17_17_17_17_17
8433,212,1332740220,19,21,19,1332740280,60,102840,204240,101400,19_19_19_19_19_19_19_19_19_19_19
8434,212,1332740280,19,21,1,1332766800,26520,102900,204240,101340,19_19_19_19_19_19_19_19_19_19_19_19
8435,139,1332740280,19,21,19,1332764880,24600,0,273900,273900,19
8436,26,1332740400,5,2,5,1332833400,93000,1891560,2036760,145200,16_16_16_16_16_16_16_1_1_16_1_1_2_2_25_9_25_9_3_3_18_18_18_18_15_15_15_15_3_3_3_3_18_18_18_18_18_18_5_5_5_5_2_2_11_11_5_5
8437,159,1332741600,5,2,5,1332750000,8400,2388780,2480580,91800,16_16_16_16_16_16_16_16_1_1_1_1_2_2_3_3_3_3_18_18_18_18_18_18_5
8438,30,1332741900,3,4,3,1332742440,540,461100,604800,143700,0_0_0_0_0_1_0_0_1_0_1_1_2_2_3_3_3_3
8439,37,1332742260,16,14,16,1332753000,10740,382260,736020,353760,16_16_16_16_16_16_16_16_16_16_16_16_16_16_16_16_16_16_16_16_16_16_16_16_16_16_16_16_16_1_1_16
8440,30,1332742440,3,3,3,1332744720,2280,461640,604800,143160,0_0_0_0_0_1_0_0_1_0_1_1_2_2_3_3_3_3_3
8441,224,1332742440,2,3,2,1332745920,3480,332100,648060,315960,1_1_1_1_1_1_3_3_2
8442,14,1332742920,1,6,2,1332765720,22800,1163520,1327560,164040,20_20_20_20_20_20_20_20_20_20_20_20_8_8_0_0_0_0_0_20_0_20_20_0_0_20_0_0_0_0_0_0_1_1
8443,196,1332743400,30,27,1,1332744780,1380,2942700,3281700,339000,7_7_7_7_7_7_7_7_7_7_7_7_7_7_7_7_7_7_7_7_1_1_1_1_7_7_1_1_7_7_1_1_7_7_7_1_1_7_7_7_7_7_7_7_7_7_1_1_7_7_7_30_30_7_1_7_7_1_7_1_1_7_7_7_1_7_7_1_1_1_7_7_30_30_1_1_10_10_10_1_1_10_10_10_10_1_1_10_10_10_10_8_8_7_10_10_7_10_10_10_10_10_7_7_7_7_7_7_8_8_10_10_7_7_1_30
8444,65,1332743580,18,19,18,1332743640,60,7201980,7544400,342420,17_17_34_34_6_6_6_6_5_5_1_1_1_1_2_2_3_3_5_5_5_5_3_3_18_18_18_18
8445,65,1332743640,18,19,18,1332750540,6900,7202040,7544400,342360,17_17_34_34_6_6_6_6_5_5_1_1_1_1_2_2_3_3_5_5_5_5_3_3_18_18_18_18_18
8446,30,1332744720,3,4,13,1332792000,47280,463920,604800,140880,0_0_0_0_0_1_0_0_1_0_1_1_2_2_3_3_3_3_3_3
8447,196,1332744780,1,18,30,1332747000,2220,2944080,3281700,337620,7_7_7_7_7_7_7_7_7_7_7_7_7_7_7_7_7_7_7_7_1_1_1_1_7_7_1_1_7_7_1_1_7_7_7_1_1_7_7_7_7_7_7_7_7_7_1_1_7_7_7_30_30_7_1_7_7_1_7_1_1_7_7_7_1_7_7_1_1_1_7_7_30_30_1_1_10_10_10_1_1_10_10_10_10_1_1_10_10_10_10_8_8_7_10_10_7_10_10_10_10_10_7_7_7_7_7_7_8_8_10_10_7_7_1_30_1
8448,44,1332745200,1,18,1,1332749400,4200,327600,331800,4200,1_1_1
8449,224,1332745920,2,3,3,1332745920,0,335580,648060,312480,1_1_1_1_1_1_3_3_2_2
8450,224,1332745920,3,3,3,1332753120,7200,335580,648060,312480,1_1_1_1_1_1_3_3_2_2_3
8451,196,1332747000,30,27,8,1332750060,3060,2946300,3281700,335400,7_7_7_7_7_7_7_7_7_7_7_7_7_7_7_7_7_7_7_7_1_1_1_1_7_7_1_1_7_7_1_1_7_7_7_1_1_7_7_7_7_7_7_7_7_7_1_1_7_7_7_30_30_7_1_7_7_1_7_1_1_7_7_7_1_7_7_1_1_1_7_7_30_30_1_1_10_10_10_1_1_10_10_10_10_1_1_10_10_10_10_8_8_7_10_10_7_10_10_10_10_10_7_7_7_7_7_7_8_8_10_10_7_7_1_30_1_30
8452,44,1332749400,1,18,99,1332749400,0,331800,331800,0,1_1_1_1
8453,188,1332750000,5,2,5,1332755400,5400,4077960,4327560,249600,0_0_0_0_0_1_1_0_0_0_0_0_0_0_0_0_1_1_2_2_2_2_3_3_3_3_21_21_3_3_3_3_3_3_3_3_18_18_18_18_18_18_18_18_18_18_18_18_18_18_18_18_18_18_1_1_18_18_18_18_1_1_18_3_18_18_3_18_18_18_18_18_18_18_18_18_18_18_18_18_18_18_5
8454,159,1332750000,5,2,5,1332765000,15000,2397180,2480580,83400,16_16_16_16_16_16_16_16_1_1_1_1_2_2_3_3_3_3_18_18_18_18_18_18_5_5
8455,196,1332750060,8,18,7,1332769560,19500,2949360,3281700,332340,7_7_7_7_7_7_7_7_7_7_7_7_7_7_7_7_7_7_7_7_1_1_1_1_7_7_1_1_7_7_1_1_7_7_7_1_1_7_7_7_7_7_7_7_7_7_1_1_7_7_7_30_30_7_1_7_7_1_7_1_1_7_7_7_1_7_7_1_1_1_7_7_30_30_1_1_10_10_10_1_1_10_10_10_10_1_1_10_10_10_10_8_8_7_10_10_7_10_10_10_10_10_7_7_7_7_7_7_8_8_10_10_7_7_1_30_1_30_8
8456,65,1332750540,18,19,18,1332760560,10020,7208940,7544400,335460,17_17_34_34_6_6_6_6_5_5_1_1_1_1_2_2_3_3_5_5_5_5_3_3_18_18_18_18_18_18_18
8457,65,1332750540,18,19,18,1332750540,0,7208940,7544400,335460,17_17_34_34_6_6_6_6_5_5_1_1_1_1_2_2_3_3_5_5_5_5_3_3_18_18_18_18_18_18
8458,37,1332753000,16,14,16,1332765660,12660,393000,736020,343020,16_16_16_16_16_16_16_16_16_16_16_16_16_16_16_16_16_16_16_16_16_16_16_16_16_16_16_16_16_1_1_16_16
8459,224,1332753120,3,3,5,1332945300,192180,342780,648060,305280,1_1_1_1_1_1_3_3_2_2_3_3
8460,133,1332753240,1,9,2,1332753660,420,5962440,6181200,218760,17_17_17_17_17_17_17_17_17_17_17_17_17_17_17_17_17_17_17_17_17_17_17_17_17_17_17_17_17_17_1_1_17_17_17_17_1_1_1_1_17_17_17_17_17_17_17_17_17_17_17_17_17_17_17_17_17_17_17_17_17_17_19_19_17_17_2_2_3_3_3_3_3_3_5_5_6_6_17_17_17_17_3_3_1
8461,133,1332753660,2,3,2,1332753720,60,5962860,6181200,218340,17_17_17_17_17_17_17_17_17_17_17_17_17_17_17_17_17_17_17_17_17_17_17_17_17_17_17_17_17_17_1_1_17_17_17_17_1_1_1_1_17_17_17_17_17_17_17_17_17_17_17_17_17_17_17_17_17_17_17_17_17_17_19_19_17_17_2_2_3_3_3_3_3_3_5_5_6_6_17_17_17_17_3_3_1_2
8462,133,1332753720,2,3,2,1332753720,0,5962920,6181200,218280,17_17_17_17_17_17_17_17_17_17_17_17_17_17_17_17_17_17_17_17_17_17_17_17_17_17_17_17_17_17_1_1_17_17_17_17_1_1_1_1_17_17_17_17_17_17_17_17_17_17_17_17_17_17_17_17_17_17_17_17_17_17_19_19_17_17_2_2_3_3_3_3_3_3_5_5_6_6_17_17_17_17_3_3_1_2_2
8463,133,1332753720,2,3,1,1332757740,4020,5962920,6181200,218280,17_17_17_17_17_17_17_17_17_17_17_17_17_17_17_17_17_17_17_17_17_17_17_17_17_17_17_17_17_17_1_1_17_17_17_17_1_1_1_1_17_17_17_17_17_17_17_17_17_17_17_17_17_17_17_17_17_17_17_17_17_17_19_19_17_17_2_2_3_3_3_3_3_3_5_5_6_6_17_17_17_17_3_3_1_2_2_2
8464,188,1332755400,5,2,5,1332757200,1800,4083360,4327560,244200,0_0_0_0_0_1_1_0_0_0_0_0_0_0_0_0_1_1_2_2_2_2_3_3_3_3_21_21_3_3_3_3_3_3_3_3_18_18_18_18_18_18_18_18_18_18_18_18_18_18_18_18_18_18_1_1_18_18_18_18_1_1_18_3_18_18_3_18_18_18_18_18_18_18_18_18_18_18_18_18_18_18_5_5
8465,188,1332757200,5,2,5,1332767460,10260,4085160,4327560,242400,0_0_0_0_0_1_1_0_0_0_0_0_0_0_0_0_1_1_2_2_2_2_3_3_3_3_21_21_3_3_3_3_3_3_3_3_18_18_18_18_18_18_18_18_18_18_18_18_18_18_18_18_18_18_1_1_18_18_18_18_1_1_18_3_18_18_3_18_18_18_18_18_18_18_18_18_18_18_18_18_18_18_5_5_5
8466,133,1332757740,1,9,2,1332759240,1500,5966940,6181200,214260,17_17_17_17_17_17_17_17_17_17_17_17_17_17_17_17_17_17_17_17_17_17_17_17_17_17_17_17_17_17_1_1_17_17_17_17_1_1_1_1_17_17_17_17_17_17_17_17_17_17_17_17_17_17_17_17_17_17_17_17_17_17_19_19_17_17_2_2_3_3_3_3_3_3_5_5_6_6_17_17_17_17_3_3_1_2_2_2_1
8467,133,1332759240,2,3,3,1332759300,60,5968440,6181200,212760,17_17_17_17_17_17_17_17_17_17_17_17_17_17_17_17_17_17_17_17_17_17_17_17_17_17_17_17_17_17_1_1_17_17_17_17_1_1_1_1_17_17_17_17_17_17_17_17_17_17_17_17_17_17_17_17_17_17_17_17_17_17_19_19_17_17_2_2_3_3_3_3_3_3_5_5_6_6_17_17_17_17_3_3_1_2_2_2_1_2
8468,133,1332759300,3,3,3,1332764220,4920,5968500,6181200,212700,17_17_17_17_17_17_17_17_17_17_17_17_17_17_17_17_17_17_17_17_17_17_17_17_17_17_17_17_17_17_1_1_17_17_17_17_1_1_1_1_17_17_17_17_17_17_17_17_17_17_17_17_17_17_17_17_17_17_17_17_17_17_19_19_17_17_2_2_3_3_3_3_3_3_5_5_6_6_17_17_17_17_3_3_1_2_2_2_1_2_3
8469,65,1332760560,18,19,18,1332767640,7080,7218960,7544400,325440,17_17_34_34_6_6_6_6_5_5_1_1_1_1_2_2_3_3_5_5_5_5_3_3_18_18_18_18_18_18_18_18_18
8470,65,1332760560,18,19,18,1332760560,0,7218960,7544400,325440,17_17_34_34_6_6_6_6_5_5_1_1_1_1_2_2_3_3_5_5_5_5_3_3_18_18_18_18_18_18_18_18
8471,170,1332760860,51,16,51,1332766620,5760,514740,665160,150420,19_19_19_19_19_19_1_1_51
8472,133,1332764220,3,3,2,1332764340,120,5973420,6181200,207780,17_17_17_17_17_17_17_17_17_17_17_17_17_17_17_17_17_17_17_17_17_17_17_17_17_17_17_17_17_17_1_1_17_17_17_17_1_1_1_1_17_17_17_17_17_17_17_17_17_17_17_17_17_17_17_17_17_17_17_17_17_17_19_19_17_17_2_2_3_3_3_3_3_3_5_5_6_6_17_17_17_17_3_3_1_2_2_2_1_2_3_3
8473,133,1332764340,3,3,3,1332764340,0,5973540,6181200,207660,17_17_17_17_17_17_17_17_17_17_17_17_17_17_17_17_17_17_17_17_17_17_17_17_17_17_17_17_17_17_1_1_17_17_17_17_1_1_1_1_17_17_17_17_17_17_17_17_17_17_17_17_17_17_17_17_17_17_17_17_17_17_19_19_17_17_2_2_3_3_3_3_3_3_5_5_6_6_17_17_17_17_3_3_1_2_2_2_1_2_3_3_2_3
8474,133,1332764340,3,3,2,1332768840,4500,5973540,6181200,207660,17_17_17_17_17_17_17_17_17_17_17_17_17_17_17_17_17_17_17_17_17_17_17_17_17_17_17_17_17_17_1_1_17_17_17_17_1_1_1_1_17_17_17_17_17_17_17_17_17_17_17_17_17_17_17_17_17_17_17_17_17_17_19_19_17_17_2_2_3_3_3_3_3_3_5_5_6_6_17_17_17_17_3_3_1_2_2_2_1_2_3_3_2_3_3
8475,133,1332764340,2,3,3,1332764340,0,5973540,6181200,207660,17_17_17_17_17_17_17_17_17_17_17_17_17_17_17_17_17_17_17_17_17_17_17_17_17_17_17_17_17_17_1_1_17_17_17_17_1_1_1_1_17_17_17_17_17_17_17_17_17_17_17_17_17_17_17_17_17_17_17_17_17_17_19_19_17_17_2_2_3_3_3_3_3_3_5_5_6_6_17_17_17_17_3_3_1_2_2_2_1_2_3_3_2
8476,139,1332764880,19,21,19,1332765720,840,24600,273900,249300,19_19_19
8477,139,1332764880,19,21,19,1332764880,0,24600,273900,249300,19_19
8478,159,1332765000,5,2,5,1332774000,9000,2412180,2480580,68400,16_16_16_16_16_16_16_16_1_1_1_1_2_2_3_3_3_3_18_18_18_18_18_18_5_5_5
8479,37,1332765660,16,14,16,1332766200,540,405660,736020,330360,16_16_16_16_16_16_16_16_16_16_16_16_16_16_16_16_16_16_16_16_16_16_16_16_16_16_16_16_16_1_1_16_16_16
8480,14,1332765720,2,3,2,1332766800,1080,1186320,1327560,141240,20_20_20_20_20_20_20_20_20_20_20_20_8_8_0_0_0_0_0_20_0_20_20_0_0_20_0_0_0_0_0_0_1_1_2
8481,139,1332765720,19,14,19,1332766860,1140,25440,273900,248460,19_19_19_19
8482,37,1332766200,16,20,16,1332794220,28020,406200,736020,329820,16_16_16_16_16_16_16_16_16_16_16_16_16_16_16_16_16_16_16_16_16_16_16_16_16_16_16_16_16_1_1_16_16_16_16
8483,170,1332766620,51,16,1,1332906780,140160,520500,665160,144660,19_19_19_19_19_19_1_1_51_51
8484,98,1332766740,34,17,34,1332774360,7620,7027320,7319880,292560,34_34_2_2_35_35_34_34_2_2_3_3_3_3_3_3_18_18_3_3_3_18_3_3_3_18_18_18_18_3_3_18_18_18_18_18_18_18_18_3_3_18_39_3_3_39_3_3_3_3_4_4_5_5_5_5_5_5_4_4_4_5_3_5_5_3_5_4_4_4_5_5_5_5_6_6_6_6_5_5_5_5_5_5_5_5_5_5_5_5_6_6_5_5_34_34_6_6_5_5_5_5_5_5_5_5_5_5_5_5_2_2_5_18_5_18_18_18_6_6_5_5_5_5_5_5_6_6_34_34_34_34_35_35_6_6_5_5_5_5_34_34_6_6_5_5_34
8485,212,1332766800,1,18,1,1332769200,2400,129420,204240,74820,19_19_19_19_19_19_19_19_19_19_19_19_1
8486,14,1332766800,2,3,2,1332766920,120,1187400,1327560,140160,20_20_20_20_20_20_20_20_20_20_20_20_8_8_0_0_0_0_0_20_0_20_20_0_0_20_0_0_0_0_0_0_1_1_2_2
8487,139,1332766860,19,21,19,1332773520,6660,26580,273900,247320,19_19_19_19_19
8488,14,1332766920,2,4,2,1332772980,6060,1187520,1327560,140040,20_20_20_20_20_20_20_20_20_20_20_20_8_8_0_0_0_0_0_20_0_20_20_0_0_20_0_0_0_0_0_0_1_1_2_2_2
8489,207,1332767280,1,9,99,1332767280,0,272580,272580,0,1_1_1_1_1_1
8490,188,1332767460,5,2,5,1332820800,53340,4095420,4327560,232140,0_0_0_0_0_1_1_0_0_0_0_0_0_0_0_0_1_1_2_2_2_2_3_3_3_3_21_21_3_3_3_3_3_3_3_3_18_18_18_18_18_18_18_18_18_18_18_18_18_18_18_18_18_18_1_1_18_18_18_18_1_1_18_3_18_18_3_18_18_18_18_18_18_18_18_18_18_18_18_18_18_18_5_5_5_5
8491,65,1332767640,18,19,5,1332914400,146760,7226040,7544400,318360,17_17_34_34_6_6_6_6_5_5_1_1_1_1_2_2_3_3_5_5_5_5_3_3_18_18_18_18_18_18_18_18_18_18
8492,133,1332768840,2,3,5,1332915000,146160,5978040,6181200,203160,17_17_17_17_17_17_17_17_17_17_17_17_17_17_17_17_17_17_17_17_17_17_17_17_17_17_17_17_17_17_1_1_17_17_17_17_1_1_1_1_17_17_17_17_17_17_17_17_17_17_17_17_17_17_17_17_17_17_17_17_17_17_19_19_17_17_2_2_3_3_3_3_3_3_5_5_6_6_17_17_17_17_3_3_1_2_2_2_1_2_3_3_2_3_3_2
8493,212,1332769200,1,18,1,1332835200,66000,131820,204240,72420,19_19_19_19_19_19_19_19_19_19_19_19_1_1
8494,196,1332769560,7,8,8,1332774240,4680,2968860,3281700,312840,7_7_7_7_7_7_7_7_7_7_7_7_7_7_7_7_7_7_7_7_1_1_1_1_7_7_1_1_7_7_1_1_7_7_7_1_1_7_7_7_7_7_7_7_7_7_1_1_7_7_7_30_30_7_1_7_7_1_7_1_1_7_7_7_1_7_7_1_1_1_7_7_30_30_1_1_10_10_10_1_1_10_10_10_10_1_1_10_10_10_10_8_8_7_10_10_7_10_10_10_10_10_7_7_7_7_7_7_8_8_10_10_7_7_1_30_1_30_8_7
8495,40,1332771180,0,1,0,1332774060,2880,0,163800,163800,0
8496,14,1332772980,2,4,0,1332798660,25680,1193580,1327560,133980,20_20_20_20_20_20_20_20_20_20_20_20_8_8_0_0_0_0_0_20_0_20_20_0_0_20_0_0_0_0_0_0_1_1_2_2_2_2
8497,220,1332772980,4,5,4,1332782340,9360,2428620,2714040,285420,0_0_0_0_1_0_1_0_0_0_0_0_1_0_0_1_0_0_0_0_0_0_0_0_0_0_0_0_0_0_0_1_1_0_1_1_1_1_0_0_1_1_2_2_2_2_2_2_2_2_27_27_27_27_27_27_27_27_27_27_27_27_27_27_27_27_3_3_3_3_3_3_3_3_3_3_3_3_3_3_4_4_4_4_1_4_4_1_4_4_4_4_4_4_4_4_4_4
8498,139,1332773520,19,14,19,1332782460,8940,33240,273900,240660,19_19_19_19_19_19
8499,159,1332774000,5,2,6,1332795600,21600,2421180,2480580,59400,16_16_16_16_16_16_16_16_1_1_1_1_2_2_3_3_3_3_18_18_18_18_18_18_5_5_5_5
8500,22,1332774000,17,10,17,1332825420,51420,553680,810360,256680,17_17_17_17_17_17_17_17_17_17_17_17
8501,40,1332774060,0,1,0,1332780120,6060,2880,163800,160920,0_0
8502,196,1332774240,8,18,11,1332786600,12360,2973540,3281700,308160,7_7_7_7_7_7_7_7_7_7_7_7_7_7_7_7_7_7_7_7_1_1_1_1_7_7_1_1_7_7_1_1_7_7_7_1_1_7_7_7_7_7_7_7_7_7_1_1_7_7_7_30_30_7_1_7_7_1_7_1_1_7_7_7_1_7_7_1_1_1_7_7_30_30_1_1_10_10_10_1_1_10_10_10_10_1_1_10_10_10_10_8_8_7_10_10_7_10_10_10_10_10_7_7_7_7_7_7_8_8_10_10_7_7_1_30_1_30_8_7_8
8503,98,1332774360,34,17,2,1333054800,280440,7034940,7319880,284940,34_34_2_2_35_35_34_34_2_2_3_3_3_3_3_3_18_18_3_3_3_18_3_3_3_18_18_18_18_3_3_18_18_18_18_18_18_18_18_3_3_18_39_3_3_39_3_3_3_3_4_4_5_5_5_5_5_5_4_4_4_5_3_5_5_3_5_4_4_4_5_5_5_5_6_6_6_6_5_5_5_5_5_5_5_5_5_5_5_5_6_6_5_5_34_34_6_6_5_5_5_5_5_5_5_5_5_5_5_5_2_2_5_18_5_18_18_18_6_6_5_5_5_5_5_5_6_6_34_34_34_34_35_35_6_6_5_5_5_5_34_34_6_6_5_5_34_34
8504,63,1332774360,34,17,34,1332775260,900,5922900,6232860,309960,16_16_16_16_16_16_16_16_16_0_0_16_16_0_16_16_0_16_16_0_0_16_16_16_0_0_16_0_0_16_0_16_0_0_0_16_1_1_1_16_16_16_0_1_1_1_16_0_0_16_16_0_16_0_16_0_0_2_2_1_1_0_0_0_0_2_2_2_2_2_2_0_1_0_1_1_0_0_0_1_1_0_0_1_1_1_0_0_0_0_0_2_2_2_2_0_0_0_0_0_0_1_1_1_1_0_0_16_0_16_16_16_16_16_0_0_1_1_2_2_1_1_16_0_2_16_2_2_2_0_1_1_1_1_1_16_16_1_1_1_3_3_18_3_18_3_3_3_3_3_18_18_18_18_3_3_3_3_18_18_18_18_18_18_18_5_5_5_18_5_18_18_18_18_18_5_5_5_18_18_18_5_6_6_5_5_5_5_3_5_18_3_3_3_18_16_18_16_5_18_18_6_3_6_18_3_18_18_5_5_18_5_5_5_5_5_5_5_5_5_18_3_5_3_18_3_3_3_3_18_18_18_18_3_5_5_18_3_18_6_3_6_3_18_3_3_18_18_5_5_3_18_3_5_34_34_3_3_18_5_18_3_2_3_2_18_5_34_18_3_5_5_3_5_3_3_5_18_3_34_3_5_18_18_18_18_18_18_18_18_18_18_18_18_18_18_18_18_18_18_34_34_5_34_5_34_5_5_6_6_5_5_6_6_5_5_5_5_5_5_5_5_5_5_5_5_5_5_5_5_34_34_34
8505,63,1332775260,34,17,34,1332780300,5040,5923800,6232860,309060,16_16_16_16_16_16_16_16_16_0_0_16_16_0_16_16_0_16_16_0_0_16_16_16_0_0_16_0_0_16_0_16_0_0_0_16_1_1_1_16_16_16_0_1_1_1_16_0_0_16_16_0_16_0_16_0_0_2_2_1_1_0_0_0_0_2_2_2_2_2_2_0_1_0_1_1_0_0_0_1_1_0_0_1_1_1_0_0_0_0_0_2_2_2_2_0_0_0_0_0_0_1_1_1_1_0_0_16_0_16_16_16_16_16_0_0_1_1_2_2_1_1_16_0_2_16_2_2_2_0_1_1_1_1_1_16_16_1_1_1_3_3_18_3_18_3_3_3_3_3_18_18_18_18_3_3_3_3_18_18_18_18_18_18_18_5_5_5_18_5_18_18_18_18_18_5_5_5_18_18_18_5_6_6_5_5_5_5_3_5_18_3_3_3_18_16_18_16_5_18_18_6_3_6_18_3_18_18_5_5_18_5_5_5_5_5_5_5_5_5_18_3_5_3_18_3_3_3_3_18_18_18_18_3_5_5_18_3_18_6_3_6_3_18_3_3_18_18_5_5_3_18_3_5_34_34_3_3_18_5_18_3_2_3_2_18_5_34_18_3_5_5_3_5_3_3_5_18_3_34_3_5_18_18_18_18_18_18_18_18_18_18_18_18_18_18_18_18_18_18_34_34_5_34_5_34_5_5_6_6_5_5_6_6_5_5_5_5_5_5_5_5_5_5_5_5_5_5_5_5_34_34_34_34
8506,219,1332775320,3,17,3,1332780240,4920,3492060,3797940,305880,26_26_26_26_26_26_26_26_26_26_8_8_38_38_17_17_17_17_17_17_17_1_17_1_1_1_17_17_1_1_17_17_1_17_1_17_1_1_3_25_3_25_18_18_18_18_18_18_18_18_18_18_15_15_15_15_15_15_3
8507,40,1332780120,0,0,0,1332798240,18120,8940,163800,154860,0_0_0
8508,219,1332780240,3,17,18,1332782280,2040,3496980,3797940,300960,26_26_26_26_26_26_26_26_26_26_8_8_38_38_17_17_17_17_17_17_17_1_17_1_1_1_17_17_1_1_17_17_1_17_1_17_1_1_3_25_3_25_18_18_18_18_18_18_18_18_18_18_15_15_15_15_15_15_3_3
8509,63,1332780300,34,17,34,1332786180,5880,5928840,6232860,304020,16_16_16_16_16_16_16_16_16_0_0_16_16_0_16_16_0_16_16_0_0_16_16_16_0_0_16_0_0_16_0_16_0_0_0_16_1_1_1_16_16_16_0_1_1_1_16_0_0_16_16_0_16_0_16_0_0_2_2_1_1_0_0_0_0_2_2_2_2_2_2_0_1_0_1_1_0_0_0_1_1_0_0_1_1_1_0_0_0_0_0_2_2_2_2_0_0_0_0_0_0_1_1_1_1_0_0_16_0_16_16_16_16_16_0_0_1_1_2_2_1_1_16_0_2_16_2_2_2_0_1_1_1_1_1_16_16_1_1_1_3_3_18_3_18_3_3_3_3_3_18_18_18_18_3_3_3_3_18_18_18_18_18_18_18_5_5_5_18_5_18_18_18_18_18_5_5_5_18_18_18_5_6_6_5_5_5_5_3_5_18_3_3_3_18_16_18_16_5_18_18_6_3_6_18_3_18_18_5_5_18_5_5_5_5_5_5_5_5_5_18_3_5_3_18_3_3_3_3_18_18_18_18_3_5_5_18_3_18_6_3_6_3_18_3_3_18_18_5_5_3_18_3_5_34_34_3_3_18_5_18_3_2_3_2_18_5_34_18_3_5_5_3_5_3_3_5_18_3_34_3_5_18_18_18_18_18_18_18_18_18_18_18_18_18_18_18_18_18_18_34_34_5_34_5_34_5_5_6_6_5_5_6_6_5_5_5_5_5_5_5_5_5_5_5_5_5_5_5_5_34_34_34_34_34
8510,57,1332781200,26,32,26,1332820500,39300,2513460,2756640,243180,26_26_26_26_26_26_26_26_26_26_26_26_26_26_26_26_26_26_26_26_26_26_26_26_26_8_8_8_8_2_2_26_8_8_26_26_26_26_26_26_26_26_8_8_26_26_26_26_26_26_8_8_8_8_26_26_26_26_6_6_5_5_26_26_26_26_26_26_26
8511,219,1332782280,18,23,18,1332792240,9960,3499020,3797940,298920,26_26_26_26_26_26_26_26_26_26_8_8_38_38_17_17_17_17_17_17_17_1_17_1_1_1_17_17_1_1_17_17_1_17_1_17_1_1_3_25_3_25_18_18_18_18_18_18_18_18_18_18_15_15_15_15_15_15_3_3_18
8512,220,1332782340,4,22,4,1332819840,37500,2437980,2714040,276060,0_0_0_0_1_0_1_0_0_0_0_0_1_0_0_1_0_0_0_0_0_0_0_0_0_0_0_0_0_0_0_1_1_0_1_1_1_1_0_0_1_1_2_2_2_2_2_2_2_2_27_27_27_27_27_27_27_27_27_27_27_27_27_27_27_27_3_3_3_3_3_3_3_3_3_3_3_3_3_3_4_4_4_4_1_4_4_1_4_4_4_4_4_4_4_4_4_4_4
8513,139,1332782460,19,11,19,1332819240,36780,42180,273900,231720,19_19_19_19_19_19_19
8514,63,1332786180,34,17,5,1332828000,41820,5934720,6232860,298140,16_16_16_16_16_16_16_16_16_0_0_16_16_0_16_16_0_16_16_0_0_16_16_16_0_0_16_0_0_16_0_16_0_0_0_16_1_1_1_16_16_16_0_1_1_1_16_0_0_16_16_0_16_0_16_0_0_2_2_1_1_0_0_0_0_2_2_2_2_2_2_0_1_0_1_1_0_0_0_1_1_0_0_1_1_1_0_0_0_0_0_2_2_2_2_0_0_0_0_0_0_1_1_1_1_0_0_16_0_16_16_16_16_16_0_0_1_1_2_2_1_1_16_0_2_16_2_2_2_0_1_1_1_1_1_16_16_1_1_1_3_3_18_3_18_3_3_3_3_3_18_18_18_18_3_3_3_3_18_18_18_18_18_18_18_5_5_5_18_5_18_18_18_18_18_5_5_5_18_18_18_5_6_6_5_5_5_5_3_5_18_3_3_3_18_16_18_16_5_18_18_6_3_6_18_3_18_18_5_5_18_5_5_5_5_5_5_5_5_5_18_3_5_3_18_3_3_3_3_18_18_18_18_3_5_5_18_3_18_6_3_6_3_18_3_3_18_18_5_5_3_18_3_5_34_34_3_3_18_5_18_3_2_3_2_18_5_34_18_3_5_5_3_5_3_3_5_18_3_34_3_5_18_18_18_18_18_18_18_18_18_18_18_18_18_18_18_18_18_18_34_34_5_34_5_34_5_5_6_6_5_5_6_6_5_5_5_5_5_5_5_5_5_5_5_5_5_5_5_5_34_34_34_34_34_34
8515,196,1332786600,11,17,11,1332792000,5400,2985900,3281700,295800,7_7_7_7_7_7_7_7_7_7_7_7_7_7_7_7_7_7_7_7_1_1_1_1_7_7_1_1_7_7_1_1_7_7_7_1_1_7_7_7_7_7_7_7_7_7_1_1_7_7_7_30_30_7_1_7_7_1_7_1_1_7_7_7_1_7_7_1_1_1_7_7_30_30_1_1_10_10_10_1_1_10_10_10_10_1_1_10_10_10_10_8_8_7_10_10_7_10_10_10_10_10_7_7_7_7_7_7_8_8_10_10_7_7_1_30_1_30_8_7_8_11
8516,30,1332792000,13,17,13,1332794700,2700,511200,604800,93600,0_0_0_0_0_1_0_0_1_0_1_1_2_2_3_3_3_3_3_3_13
8517,196,1332792000,11,17,7,1332794760,2760,2991300,3281700,290400,7_7_7_7_7_7_7_7_7_7_7_7_7_7_7_7_7_7_7_7_1_1_1_1_7_7_1_1_7_7_1_1_7_7_7_1_1_7_7_7_7_7_7_7_7_7_1_1_7_7_7_30_30_7_1_7_7_1_7_1_1_7_7_7_1_7_7_1_1_1_7_7_30_30_1_1_10_10_10_1_1_10_10_10_10_1_1_10_10_10_10_8_8_7_10_10_7_10_10_10_10_10_7_7_7_7_7_7_8_8_10_10_7_7_1_30_1_30_8_7_8_11_11
8518,219,1332792240,18,23,18,1332792300,60,3508980,3797940,288960,26_26_26_26_26_26_26_26_26_26_8_8_38_38_17_17_17_17_17_17_17_1_17_1_1_1_17_17_1_1_17_17_1_17_1_17_1_1_3_25_3_25_18_18_18_18_18_18_18_18_18_18_15_15_15_15_15_15_3_3_18_18
8519,219,1332792300,18,23,18,1332806460,14160,3509040,3797940,288900,26_26_26_26_26_26_26_26_26_26_8_8_38_38_17_17_17_17_17_17_17_1_17_1_1_1_17_17_1_1_17_17_1_17_1_17_1_1_3_25_3_25_18_18_18_18_18_18_18_18_18_18_15_15_15_15_15_15_3_3_18_18_18
8520,37,1332794220,16,20,16,1332794580,360,434220,736020,301800,16_16_16_16_16_16_16_16_16_16_16_16_16_16_16_16_16_16_16_16_16_16_16_16_16_16_16_16_16_1_1_16_16_16_16_16
8521,37,1332794580,16,11,16,1332819180,24600,434580,736020,301440,16_16_16_16_16_16_16_16_16_16_16_16_16_16_16_16_16_16_16_16_16_16_16_16_16_16_16_16_16_1_1_16_16_16_16_16_16
8522,30,1332794700,13,17,13,1332820560,25860,513900,604800,90900,0_0_0_0_0_1_0_0_1_0_1_1_2_2_3_3_3_3_3_3_13_13
8523,196,1332794760,7,8,10,1332795840,1080,2994060,3281700,287640,7_7_7_7_7_7_7_7_7_7_7_7_7_7_7_7_7_7_7_7_1_1_1_1_7_7_1_1_7_7_1_1_7_7_7_1_1_7_7_7_7_7_7_7_7_7_1_1_7_7_7_30_30_7_1_7_7_1_7_1_1_7_7_7_1_7_7_1_1_1_7_7_30_30_1_1_10_10_10_1_1_10_10_10_10_1_1_10_10_10_10_8_8_7_10_10_7_10_10_10_10_10_7_7_7_7_7_7_8_8_10_10_7_7_1_30_1_30_8_7_8_11_11_7
8524,160,1332795600,3,4,3,1332800100,4500,1262760,1564260,301500,16_16_16_16_0_16_0_16_1_16_1_16_16_16_16_16_16_16_1_1_2_2_3
8525,192,1332795600,3,4,3,1332800100,4500,4590840,4648740,57900,16_16_16_16_16_0_0_16_16_16_16_16_0_0_0_1_1_0_0_0_0_0_0_0_0_0_0_0_0_0_0_0_1_1_2_2_2_2_3
8526,159,1332795600,6,7,6,1332799200,3600,2442780,2480580,37800,16_16_16_16_16_16_16_16_1_1_1_1_2_2_3_3_3_3_18_18_18_18_18_18_5_5_5_5_6
8527,76,1332795600,6,7,6,1332799200,3600,7254000,7552500,298500,3_3_3_3_3_3_3_3_3_18_3_18_18_18_18_18_3_3_3_1_1_3_17_17_17_18_17_17_18_18_18_18_18_17_17_18_3_3_18_17_18_18_17_18_18_17_17_17_5_5_5_5_1_1_17_17_17_2_2_17_17_17_5_5_5_5_5_5_17_17_5_5_5_17_5_5_5_5_5_17_17_17_1_1_1_1_1_1_1_1_2_2_34_34_5_5_5_5_6_6_3_3_4_3_3_4_4_4_4_4_3_3_3_3_3_3_4_3_3_3_3_4_4_4_3_4_4_4_3_4_4_4_3_3_4_4_4_4_5_3_3_5_5_5_5_5_4_5_4_5_4_3_3_3_3_4_3_3_4_4_5_5_5_4_5_5_5_4_6_6_34_34_5_5_34_34_34_34_5_5_5_5_6_6_5_5_5_5_34_34_6_6_6_6
8528,76,1332795600,6,7,6,1332795600,0,7254000,7552500,298500,3_3_3_3_3_3_3_3_3_18_3_18_18_18_18_18_3_3_3_1_1_3_17_17_17_18_17_17_18_18_18_18_18_17_17_18_3_3_18_17_18_18_17_18_18_17_17_17_5_5_5_5_1_1_17_17_17_2_2_17_17_17_5_5_5_5_5_5_17_17_5_5_5_17_5_5_5_5_5_17_17_17_1_1_1_1_1_1_1_1_2_2_34_34_5_5_5_5_6_6_3_3_4_3_3_4_4_4_4_4_3_3_3_3_3_3_4_3_3_3_3_4_4_4_3_4_4_4_3_4_4_4_3_3_4_4_4_4_5_3_3_5_5_5_5_5_4_5_4_5_4_3_3_3_3_4_3_3_4_4_5_5_5_4_5_5_5_4_6_6_34_34_5_5_34_34_34_34_5_5_5_5_6_6_5_5_5_5_34_34_6_6_6
8529,13,1332795600,3,4,3,1332800100,4500,2229060,2525940,296880,19_19_19_1_1_19_19_19_19_19_19_19_19_19_19_19_1_1_1_19_1_19_19_19_19_19_19_19_19_19_19_1_19_1_19_19_19_19_19_19_1_1_1_1_19_19_19_19_1_1_1_1_1_1_19_19_1_19_1_19_19_19_19_19_2_2_9_9_2_2_1_9_1_3_1_3_9_1_1_1_19_1_1_19_19_3_19_3_3_3_9_19_9_19_3_3_1_19_1_3_3_19_19_19_19_19_19_19_3_3_2_2_3
8530,196,1332795840,10,13,10,1332804540,8700,2995140,3281700,286560,7_7_7_7_7_7_7_7_7_7_7_7_7_7_7_7_7_7_7_7_1_1_1_1_7_7_1_1_7_7_1_1_7_7_7_1_1_7_7_7_7_7_7_7_7_7_1_1_7_7_7_30_30_7_1_7_7_1_7_1_1_7_7_7_1_7_7_1_1_1_7_7_30_30_1_1_10_10_10_1_1_10_10_10_10_1_1_10_10_10_10_8_8_7_10_10_7_10_10_10_10_10_7_7_7_7_7_7_8_8_10_10_7_7_1_30_1_30_8_7_8_11_11_7_10
8531,40,1332798240,0,0,0,1332798300,60,27060,163800,136740,0_0_0_0
8532,40,1332798300,0,0,0,1332819240,20940,27120,163800,136680,0_0_0_0_0
8533,14,1332798660,0,1,1,1332820800,22140,1219260,1327560,108300,20_20_20_20_20_20_20_20_20_20_20_20_8_8_0_0_0_0_0_20_0_20_20_0_0_20_0_0_0_0_0_0_1_1_2_2_2_2_0
8534,159,1332799200,6,7,5,1332829800,30600,2446380,2480580,34200,16_16_16_16_16_16_16_16_1_1_1_1_2_2_3_3_3_3_18_18_18_18_18_18_5_5_5_5_6_6
8535,76,1332799200,6,7,34,1332954720,155520,7257600,7552500,294900,3_3_3_3_3_3_3_3_3_18_3_18_18_18_18_18_3_3_3_1_1_3_17_17_17_18_17_17_18_18_18_18_18_17_17_18_3_3_18_17_18_18_17_18_18_17_17_17_5_5_5_5_1_1_17_17_17_2_2_17_17_17_5_5_5_5_5_5_17_17_5_5_5_17_5_5_5_5_5_17_17_17_1_1_1_1_1_1_1_1_2_2_34_34_5_5_5_5_6_6_3_3_4_3_3_4_4_4_4_4_3_3_3_3_3_3_4_3_3_3_3_4_4_4_3_4_4_4_3_4_4_4_3_3_4_4_4_4_5_3_3_5_5_5_5_5_4_5_4_5_4_3_3_3_3_4_3_3_4_4_5_5_5_4_5_5_5_4_6_6_34_34_5_5_34_34_34_34_5_5_5_5_6_6_5_5_5_5_34_34_6_6_6_6_6_6
8536,76,1332799200,6,7,6,1332799200,0,7257600,7552500,294900,3_3_3_3_3_3_3_3_3_18_3_18_18_18_18_18_3_3_3_1_1_3_17_17_17_18_17_17_18_18_18_18_18_17_17_18_3_3_18_17_18_18_17_18_18_17_17_17_5_5_5_5_1_1_17_17_17_2_2_17_17_17_5_5_5_5_5_5_17_17_5_5_5_17_5_5_5_5_5_17_17_17_1_1_1_1_1_1_1_1_2_2_34_34_5_5_5_5_6_6_3_3_4_3_3_4_4_4_4_4_3_3_3_3_3_3_4_3_3_3_3_4_4_4_3_4_4_4_3_4_4_4_3_3_4_4_4_4_5_3_3_5_5_5_5_5_4_5_4_5_4_3_3_3_3_4_3_3_4_4_5_5_5_4_5_5_5_4_6_6_34_34_5_5_34_34_34_34_5_5_5_5_6_6_5_5_5_5_34_34_6_6_6_6_6
8537,160,1332800100,3,4,3,1332853500,53400,1267260,1564260,297000,16_16_16_16_0_16_0_16_1_16_1_16_16_16_16_16_16_16_1_1_2_2_3_3
8538,13,1332800100,3,4,1,1332917220,117120,2233560,2525940,292380,19_19_19_1_1_19_19_19_19_19_19_19_19_19_19_19_1_1_1_19_1_19_19_19_19_19_19_19_19_19_19_1_19_1_19_19_19_19_19_19_1_1_1_1_19_19_19_19_1_1_1_1_1_1_19_19_1_19_1_19_19_19_19_19_2_2_9_9_2_2_1_9_1_3_1_3_9_1_1_1_19_1_1_19_19_3_19_3_3_3_9_19_9_19_3_3_1_19_1_3_3_19_19_19_19_19_19_19_3_3_2_2_3_3
8539,192,1332800100,3,4,21,1332838140,38040,4595340,4648740,53400,16_16_16_16_16_0_0_16_16_16_16_16_0_0_0_1_1_0_0_0_0_0_0_0_0_0_0_0_0_0_0_0_1_1_2_2_2_2_3_3
8540,196,1332804540,10,13,8,1332820800,16260,3003840,3281700,277860,7_7_7_7_7_7_7_7_7_7_7_7_7_7_7_7_7_7_7_7_1_1_1_1_7_7_1_1_7_7_1_1_7_7_7_1_1_7_7_7_7_7_7_7_7_7_1_1_7_7_7_30_30_7_1_7_7_1_7_1_1_7_7_7_1_7_7_1_1_1_7_7_30_30_1_1_10_10_10_1_1_10_10_10_10_1_1_10_10_10_10_8_8_7_10_10_7_10_10_10_10_10_7_7_7_7_7_7_8_8_10_10_7_7_1_30_1_30_8_7_8_11_11_7_10_10
8541,219,1332806460,18,23,18,1332812640,6180,3523200,3797940,274740,26_26_26_26_26_26_26_26_26_26_8_8_38_38_17_17_17_17_17_17_17_1_17_1_1_1_17_17_1_1_17_17_1_17_1_17_1_1_3_25_3_25_18_18_18_18_18_18_18_18_18_18_15_15_15_15_15_15_3_3_18_18_18_18_18
8542,219,1332806460,18,23,18,1332806460,0,3523200,3797940,274740,26_26_26_26_26_26_26_26_26_26_8_8_38_38_17_17_17_17_17_17_17_1_17_1_1_1_17_17_1_1_17_17_1_17_1_17_1_1_3_25_3_25_18_18_18_18_18_18_18_18_18_18_15_15_15_15_15_15_3_3_18_18_18_18
8543,219,1332812640,18,23,18,1332820800,8160,3529380,3797940,268560,26_26_26_26_26_26_26_26_26_26_8_8_38_38_17_17_17_17_17_17_17_1_17_1_1_1_17_17_1_1_17_17_1_17_1_17_1_1_3_25_3_25_18_18_18_18_18_18_18_18_18_18_15_15_15_15_15_15_3_3_18_18_18_18_18_18
8544,37,1332819180,16,11,16,1332820800,1620,459180,736020,276840,16_16_16_16_16_16_16_16_16_16_16_16_16_16_16_16_16_16_16_16_16_16_16_16_16_16_16_16_16_1_1_16_16_16_16_16_16_16
8545,139,1332819240,19,11,1,1332821340,2100,78960,273900,194940,19_19_19_19_19_19_19_19
8546,40,1332819240,0,0,0,1332824760,5520,48060,163800,115740,0_0_0_0_0_0
8547,220,1332819840,4,22,4,1332821400,1560,2475480,2714040,238560,0_0_0_0_1_0_1_0_0_0_0_0_1_0_0_1_0_0_0_0_0_0_0_0_0_0_0_0_0_0_0_1_1_0_1_1_1_1_0_0_1_1_2_2_2_2_2_2_2_2_27_27_27_27_27_27_27_27_27_27_27_27_27_27_27_27_3_3_3_3_3_3_3_3_3_3_3_3_3_3_4_4_4_4_1_4_4_1_4_4_4_4_4_4_4_4_4_4_4_4
8548,57,1332820500,26,32,26,1332823140,2640,2552760,2756640,203880,26_26_26_26_26_26_26_26_26_26_26_26_26_26_26_26_26_26_26_26_26_26_26_26_26_8_8_8_8_2_2_26_8_8_26_26_26_26_26_26_26_26_8_8_26_26_26_26_26_26_8_8_8_8_26_26_26_26_6_6_5_5_26_26_26_26_26_26_26_26
8549,30,1332820560,13,15,13,1332823680,3120,539760,604800,65040,0_0_0_0_0_1_0_0_1_0_1_1_2_2_3_3_3_3_3_3_13_13_13
8550,219,1332820800,18,19,18,1332840600,19800,3537540,3797940,260400,26_26_26_26_26_26_26_26_26_26_8_8_38_38_17_17_17_17_17_17_17_1_17_1_1_1_17_17_1_1_17_17_1_17_1_17_1_1_3_25_3_25_18_18_18_18_18_18_18_18_18_18_15_15_15_15_15_15_3_3_18_18_18_18_18_18_18
8551,188,1332820800,5,2,5,1332826800,6000,4148760,4327560,178800,0_0_0_0_0_1_1_0_0_0_0_0_0_0_0_0_1_1_2_2_2_2_3_3_3_3_21_21_3_3_3_3_3_3_3_3_18_18_18_18_18_18_18_18_18_18_18_18_18_18_18_18_18_18_1_1_18_18_18_18_1_1_18_3_18_18_3_18_18_18_18_18_18_18_18_18_18_18_18_18_18_18_5_5_5_5_5
8552,14,1332820800,1,6,1,1332822900,2100,1241400,1327560,86160,20_20_20_20_20_20_20_20_20_20_20_20_8_8_0_0_0_0_0_20_0_20_20_0_0_20_0_0_0_0_0_0_1_1_2_2_2_2_0_1_1
8553,37,1332820800,16,1,1,1332825900,5100,460800,736020,275220,16_16_16_16_16_16_16_16_16_16_16_16_16_16_16_16_16_16_16_16_16_16_16_16_16_16_16_16_16_1_1_16_16_16_16_16_16_16_16
8554,196,1332820800,8,18,10,1332823740,2940,3020100,3281700,261600,7_7_7_7_7_7_7_7_7_7_7_7_7_7_7_7_7_7_7_7_1_1_1_1_7_7_1_1_7_7_1_1_7_7_7_1_1_7_7_7_7_7_7_7_7_7_1_1_7_7_7_30_30_7_1_7_7_1_7_1_1_7_7_7_1_7_7_1_1_1_7_7_30_30_1_1_10_10_10_1_1_10_10_10_10_1_1_10_10_10_10_8_8_7_10_10_7_10_10_10_10_10_7_7_7_7_7_7_8_8_10_10_7_7_1_30_1_30_8_7_8_11_11_7_10_10_8
8555,14,1332820800,1,6,1,1332820800,0,1241400,1327560,86160,20_20_20_20_20_20_20_20_20_20_20_20_8_8_0_0_0_0_0_20_0_20_20_0_0_20_0_0_0_0_0_0_1_1_2_2_2_2_0_1
8556,139,1332821340,1,9,1,1332822360,1020,81060,273900,192840,19_19_19_19_19_19_19_19_1
8557,220,1332821400,4,5,5,1332822420,1020,2477040,2714040,237000,0_0_0_0_1_0_1_0_0_0_0_0_1_0_0_1_0_0_0_0_0_0_0_0_0_0_0_0_0_0_0_1_1_0_1_1_1_1_0_0_1_1_2_2_2_2_2_2_2_2_27_27_27_27_27_27_27_27_27_27_27_27_27_27_27_27_3_3_3_3_3_3_3_3_3_3_3_3_3_3_4_4_4_4_1_4_4_1_4_4_4_4_4_4_4_4_4_4_4_4_4
8558,139,1332822360,1,9,19,1332824640,2280,82080,273900,191820,19_19_19_19_19_19_19_19_1_1
8559,220,1332822420,5,9,5,1332830100,7680,2478060,2714040,235980,0_0_0_0_1_0_1_0_0_0_0_0_1_0_0_1_0_0_0_0_0_0_0_0_0_0_0_0_0_0_0_1_1_0_1_1_1_1_0_0_1_1_2_2_2_2_2_2_2_2_27_27_27_27_27_27_27_27_27_27_27_27_27_27_27_27_3_3_3_3_3_3_3_3_3_3_3_3_3_3_4_4_4_4_1_4_4_1_4_4_4_4_4_4_4_4_4_4_4_4_4_5
8560,14,1332822900,1,6,0,1332823920,1020,1243500,1327560,84060,20_20_20_20_20_20_20_20_20_20_20_20_8_8_0_0_0_0_0_20_0_20_20_0_0_20_0_0_0_0_0_0_1_1_2_2_2_2_0_1_1_1
8561,57,1332823140,26,33,26,1332858360,35220,2555400,2756640,201240,26_26_26_26_26_26_26_26_26_26_26_26_26_26_26_26_26_26_26_26_26_26_26_26_26_8_8_8_8_2_2_26_8_8_26_26_26_26_26_26_26_26_8_8_26_26_26_26_26_26_8_8_8_8_26_26_26_26_6_6_5_5_26_26_26_26_26_26_26_26_26
8562,30,1332823680,13,15,13,1332833040,9360,542880,604800,61920,0_0_0_0_0_1_0_0_1_0_1_1_2_2_3_3_3_3_3_3_13_13_13_13_13
8563,30,1332823680,13,15,13,1332823680,0,542880,604800,61920,0_0_0_0_0_1_0_0_1_0_1_1_2_2_3_3_3_3_3_3_13_13_13_13
8564,196,1332823740,10,16,7,1332824400,660,3023040,3281700,258660,7_7_7_7_7_7_7_7_7_7_7_7_7_7_7_7_7_7_7_7_1_1_1_1_7_7_1_1_7_7_1_1_7_7_7_1_1_7_7_7_7_7_7_7_7_7_1_1_7_7_7_30_30_7_1_7_7_1_7_1_1_7_7_7_1_7_7_1_1_1_7_7_30_30_1_1_10_10_10_1_1_10_10_10_10_1_1_10_10_10_10_8_8_7_10_10_7_10_10_10_10_10_7_7_7_7_7_7_8_8_10_10_7_7_1_30_1_30_8_7_8_11_11_7_10_10_8_10
8565,14,1332823920,0,1,0,1332834960,11040,1244520,1327560,83040,20_20_20_20_20_20_20_20_20_20_20_20_8_8_0_0_0_0_0_20_0_20_20_0_0_20_0_0_0_0_0_0_1_1_2_2_2_2_0_1_1_1_0
8566,196,1332824400,7,12,10,1332829800,5400,3023700,3281700,258000,7_7_7_7_7_7_7_7_7_7_7_7_7_7_7_7_7_7_7_7_1_1_1_1_7_7_1_1_7_7_1_1_7_7_7_1_1_7_7_7_7_7_7_7_7_7_1_1_7_7_7_30_30_7_1_7_7_1_7_1_1_7_7_7_1_7_7_1_1_1_7_7_30_30_1_1_10_10_10_1_1_10_10_10_10_1_1_10_10_10_10_8_8_7_10_10_7_10_10_10_10_10_7_7_7_7_7_7_8_8_10_10_7_7_1_30_1_30_8_7_8_11_11_7_10_10_8_10_7
8567,139,1332824640,19,1,19,1332852960,28320,84360,273900,189540,19_19_19_19_19_19_19_19_1_1_19
8568,40,1332824760,0,1,0,1332853440,28680,53580,163800,110220,0_0_0_0_0_0_0
8569,22,1332825420,17,10,17,1332859620,34200,605100,810360,205260,17_17_17_17_17_17_17_17_17_17_17_17_17
8570,37,1332825900,1,6,1,1332829560,3660,465900,736020,270120,16_16_16_16_16_16_16_16_16_16_16_16_16_16_16_16_16_16_16_16_16_16_16_16_16_16_16_16_16_1_1_16_16_16_16_16_16_16_16_1
8571,42,1332826020,3,3,3,1332832920,6900,691980,953340,261360,16_16_16_16_1_1_2_2_3
8572,188,1332826800,5,2,5,1332835200,8400,4154760,4327560,172800,0_0_0_0_0_1_1_0_0_0_0_0_0_0_0_0_1_1_2_2_2_2_3_3_3_3_21_21_3_3_3_3_3_3_3_3_18_18_18_18_18_18_18_18_18_18_18_18_18_18_18_18_18_18_1_1_18_18_18_18_1_1_18_3_18_18_3_18_18_18_18_18_18_18_18_18_18_18_18_18_18_18_5_5_5_5_5_5
8573,63,1332828000,5,2,5,1332829800,1800,5976540,6232860,256320,16_16_16_16_16_16_16_16_16_0_0_16_16_0_16_16_0_16_16_0_0_16_16_16_0_0_16_0_0_16_0_16_0_0_0_16_1_1_1_16_16_16_0_1_1_1_16_0_0_16_16_0_16_0_16_0_0_2_2_1_1_0_0_0_0_2_2_2_2_2_2_0_1_0_1_1_0_0_0_1_1_0_0_1_1_1_0_0_0_0_0_2_2_2_2_0_0_0_0_0_0_1_1_1_1_0_0_16_0_16_16_16_16_16_0_0_1_1_2_2_1_1_16_0_2_16_2_2_2_0_1_1_1_1_1_16_16_1_1_1_3_3_18_3_18_3_3_3_3_3_18_18_18_18_3_3_3_3_18_18_18_18_18_18_18_5_5_5_18_5_18_18_18_18_18_5_5_5_18_18_18_5_6_6_5_5_5_5_3_5_18_3_3_3_18_16_18_16_5_18_18_6_3_6_18_3_18_18_5_5_18_5_5_5_5_5_5_5_5_5_18_3_5_3_18_3_3_3_3_18_18_18_18_3_5_5_18_3_18_6_3_6_3_18_3_3_18_18_5_5_3_18_3_5_34_34_3_3_18_5_18_3_2_3_2_18_5_34_18_3_5_5_3_5_3_3_5_18_3_34_3_5_18_18_18_18_18_18_18_18_18_18_18_18_18_18_18_18_18_18_34_34_5_34_5_34_5_5_6_6_5_5_6_6_5_5_5_5_5_5_5_5_5_5_5_5_5_5_5_5_34_34_34_34_34_34_5
8574,37,1332829560,1,6,16,1332849600,20040,469560,736020,266460,16_16_16_16_16_16_16_16_16_16_16_16_16_16_16_16_16_16_16_16_16_16_16_16_16_16_16_16_16_1_1_16_16_16_16_16_16_16_16_1_1
8575,196,1332829800,10,16,8,1332835260,5460,3029100,3281700,252600,7_7_7_7_7_7_7_7_7_7_7_7_7_7_7_7_7_7_7_7_1_1_1_1_7_7_1_1_7_7_1_1_7_7_7_1_1_7_7_7_7_7_7_7_7_7_1_1_7_7_7_30_30_7_1_7_7_1_7_1_1_7_7_7_1_7_7_1_1_1_7_7_30_30_1_1_10_10_10_1_1_10_10_10_10_1_1_10_10_10_10_8_8_7_10_10_7_10_10_10_10_10_7_7_7_7_7_7_8_8_10_10_7_7_1_30_1_30_8_7_8_11_11_7_10_10_8_10_7_10
8576,63,1332829800,5,2,34,1332833100,3300,5978340,6232860,254520,16_16_16_16_16_16_16_16_16_0_0_16_16_0_16_16_0_16_16_0_0_16_16_16_0_0_16_0_0_16_0_16_0_0_0_16_1_1_1_16_16_16_0_1_1_1_16_0_0_16_16_0_16_0_16_0_0_2_2_1_1_0_0_0_0_2_2_2_2_2_2_0_1_0_1_1_0_0_0_1_1_0_0_1_1_1_0_0_0_0_0_2_2_2_2_0_0_0_0_0_0_1_1_1_1_0_0_16_0_16_16_16_16_16_0_0_1_1_2_2_1_1_16_0_2_16_2_2_2_0_1_1_1_1_1_16_16_1_1_1_3_3_18_3_18_3_3_3_3_3_18_18_18_18_3_3_3_3_18_18_18_18_18_18_18_5_5_5_18_5_18_18_18_18_18_5_5_5_18_18_18_5_6_6_5_5_5_5_3_5_18_3_3_3_18_16_18_16_5_18_18_6_3_6_18_3_18_18_5_5_18_5_5_5_5_5_5_5_5_5_18_3_5_3_18_3_3_3_3_18_18_18_18_3_5_5_18_3_18_6_3_6_3_18_3_3_18_18_5_5_3_18_3_5_34_34_3_3_18_5_18_3_2_3_2_18_5_34_18_3_5_5_3_5_3_3_5_18_3_34_3_5_18_18_18_18_18_18_18_18_18_18_18_18_18_18_18_18_18_18_34_34_5_34_5_34_5_5_6_6_5_5_6_6_5_5_5_5_5_5_5_5_5_5_5_5_5_5_5_5_34_34_34_34_34_34_5_5
8577,159,1332829800,5,2,5,1332833400,3600,2476980,2480580,3600,16_16_16_16_16_16_16_16_1_1_1_1_2_2_3_3_3_3_18_18_18_18_18_18_5_5_5_5_6_6_5
8578,64,1332829980,3,4,3,1332830040,60,6729900,6845160,115260,1_1_11_11_5_5_1_1_6_6_1_1_19_19_2_2_3
8579,64,1332830040,3,4,1,1332831840,1800,6729960,6845160,115200,1_1_11_11_5_5_1_1_6_6_1_1_19_19_2_2_3_3
8580,220,1332830100,5,9,4,1332853200,23100,2485740,2714040,228300,0_0_0_0_1_0_1_0_0_0_0_0_1_0_0_1_0_0_0_0_0_0_0_0_0_0_0_0_0_0_0_1_1_0_1_1_1_1_0_0_1_1_2_2_2_2_2_2_2_2_27_27_27_27_27_27_27_27_27_27_27_27_27_27_27_27_3_3_3_3_3_3_3_3_3_3_3_3_3_3_4_4_4_4_1_4_4_1_4_4_4_4_4_4_4_4_4_4_4_4_4_5_5
8581,64,1332831840,1,9,1,1332860460,28620,6731760,6845160,113400,1_1_11_11_5_5_1_1_6_6_1_1_19_19_2_2_3_3_1
8582,42,1332832920,3,3,18,1332840840,7920,698880,953340,254460,16_16_16_16_1_1_2_2_3_3
8583,30,1332833040,13,15,5,1332843960,10920,552240,604800,52560,0_0_0_0_0_1_0_0_1_0_1_1_2_2_3_3_3_3_3_3_13_13_13_13_13_13
8584,63,1332833100,34,15,34,1332837600,4500,5981640,6232860,251220,16_16_16_16_16_16_16_16_16_0_0_16_16_0_16_16_0_16_16_0_0_16_16_16_0_0_16_0_0_16_0_16_0_0_0_16_1_1_1_16_16_16_0_1_1_1_16_0_0_16_16_0_16_0_16_0_0_2_2_1_1_0_0_0_0_2_2_2_2_2_2_0_1_0_1_1_0_0_0_1_1_0_0_1_1_1_0_0_0_0_0_2_2_2_2_0_0_0_0_0_0_1_1_1_1_0_0_16_0_16_16_16_16_16_0_0_1_1_2_2_1_1_16_0_2_16_2_2_2_0_1_1_1_1_1_16_16_1_1_1_3_3_18_3_18_3_3_3_3_3_18_18_18_18_3_3_3_3_18_18_18_18_18_18_18_5_5_5_18_5_18_18_18_18_18_5_5_5_18_18_18_5_6_6_5_5_5_5_3_5_18_3_3_3_18_16_18_16_5_18_18_6_3_6_18_3_18_18_5_5_18_5_5_5_5_5_5_5_5_5_18_3_5_3_18_3_3_3_3_18_18_18_18_3_5_5_18_3_18_6_3_6_3_18_3_3_18_18_5_5_3_18_3_5_34_34_3_3_18_5_18_3_2_3_2_18_5_34_18_3_5_5_3_5_3_3_5_18_3_34_3_5_18_18_18_18_18_18_18_18_18_18_18_18_18_18_18_18_18_18_34_34_5_34_5_34_5_5_6_6_5_5_6_6_5_5_5_5_5_5_5_5_5_5_5_5_5_5_5_5_34_34_34_34_34_34_5_5_34
8585,26,1332833400,5,2,5,1332835200,1800,1984560,2036760,52200,16_16_16_16_16_16_16_1_1_16_1_1_2_2_25_9_25_9_3_3_18_18_18_18_15_15_15_15_3_3_3_3_18_18_18_18_18_18_5_5_5_5_2_2_11_11_5_5_5
8586,159,1332833400,5,2,99,1332833400,0,2480580,2480580,0,16_16_16_16_16_16_16_16_1_1_1_1_2_2_3_3_3_3_18_18_18_18_18_18_5_5_5_5_6_6_5_5
8587,25,1332834300,3,3,3,1332843960,9660,1856700,1951380,94680,16_16_16_8_8_16_16_8_8_16_0_0_0_0_0_0_0_0_1_1_2_2_25_25_9_9_3_3_4_4_4_4_15_15_3
8588,14,1332834960,0,1,1,1332835140,180,1255560,1327560,72000,20_20_20_20_20_20_20_20_20_20_20_20_8_8_0_0_0_0_0_20_0_20_20_0_0_20_0_0_0_0_0_0_1_1_2_2_2_2_0_1_1_1_0_0
8589,14,1332835140,1,6,2,1332835800,660,1255740,1327560,71820,20_20_20_20_20_20_20_20_20_20_20_20_8_8_0_0_0_0_0_20_0_20_20_0_0_20_0_0_0_0_0_0_1_1_2_2_2_2_0_1_1_1_0_0_1
8590,26,1332835200,5,2,6,1332882000,46800,1986360,2036760,50400,16_16_16_16_16_16_16_1_1_16_1_1_2_2_25_9_25_9_3_3_18_18_18_18_15_15_15_15_3_3_3_3_18_18_18_18_18_18_5_5_5_5_2_2_11_11_5_5_5_5
8591,188,1332835200,5,2,5,1332841800,6600,4163160,4327560,164400,0_0_0_0_0_1_1_0_0_0_0_0_0_0_0_0_1_1_2_2_2_2_3_3_3_3_21_21_3_3_3_3_3_3_3_3_18_18_18_18_18_18_18_18_18_18_18_18_18_18_18_18_18_18_1_1_18_18_18_18_1_1_18_3_18_18_3_18_18_18_18_18_18_18_18_18_18_18_18_18_18_18_5_5_5_5_5_5_5
8592,212,1332835200,1,18,1,1332841620,6420,197820,204240,6420,19_19_19_19_19_19_19_19_19_19_19_19_1_1_1
8593,196,1332835260,8,18,7,1332851400,16140,3034560,3281700,247140,7_7_7_7_7_7_7_7_7_7_7_7_7_7_7_7_7_7_7_7_1_1_1_1_7_7_1_1_7_7_1_1_7_7_7_1_1_7_7_7_7_7_7_7_7_7_1_1_7_7_7_30_30_7_1_7_7_1_7_1_1_7_7_7_1_7_7_1_1_1_7_7_30_30_1_1_10_10_10_1_1_10_10_10_10_1_1_10_10_10_10_8_8_7_10_10_7_10_10_10_10_10_7_7_7_7_7_7_8_8_10_10_7_7_1_30_1_30_8_7_8_11_11_7_10_10_8_10_7_10_8
8594,14,1332835800,2,3,2,1332843960,8160,1256400,1327560,71160,20_20_20_20_20_20_20_20_20_20_20_20_8_8_0_0_0_0_0_20_0_20_20_0_0_20_0_0_0_0_0_0_1_1_2_2_2_2_0_1_1_1_0_0_1_2
8595,63,1332837600,34,15,11,1332847200,9600,5986140,6232860,246720,16_16_16_16_16_16_16_16_16_0_0_16_16_0_16_16_0_16_16_0_0_16_16_16_0_0_16_0_0_16_0_16_0_0_0_16_1_1_1_16_16_16_0_1_1_1_16_0_0_16_16_0_16_0_16_0_0_2_2_1_1_0_0_0_0_2_2_2_2_2_2_0_1_0_1_1_0_0_0_1_1_0_0_1_1_1_0_0_0_0_0_2_2_2_2_0_0_0_0_0_0_1_1_1_1_0_0_16_0_16_16_16_16_16_0_0_1_1_2_2_1_1_16_0_2_16_2_2_2_0_1_1_1_1_1_16_16_1_1_1_3_3_18_3_18_3_3_3_3_3_18_18_18_18_3_3_3_3_18_18_18_18_18_18_18_5_5_5_18_5_18_18_18_18_18_5_5_5_18_18_18_5_6_6_5_5_5_5_3_5_18_3_3_3_18_16_18_16_5_18_18_6_3_6_18_3_18_18_5_5_18_5_5_5_5_5_5_5_5_5_18_3_5_3_18_3_3_3_3_18_18_18_18_3_5_5_18_3_18_6_3_6_3_18_3_3_18_18_5_5_3_18_3_5_34_34_3_3_18_5_18_3_2_3_2_18_5_34_18_3_5_5_3_5_3_3_5_18_3_34_3_5_18_18_18_18_18_18_18_18_18_18_18_18_18_18_18_18_18_18_34_34_5_34_5_34_5_5_6_6_5_5_6_6_5_5_5_5_5_5_5_5_5_5_5_5_5_5_5_5_34_34_34_34_34_34_5_5_34_34
8596,192,1332838140,21,4,21,1332843900,5760,4633380,4648740,15360,16_16_16_16_16_0_0_16_16_16_16_16_0_0_0_1_1_0_0_0_0_0_0_0_0_0_0_0_0_0_0_0_1_1_2_2_2_2_3_3_21
8597,219,1332840600,18,19,15,1332924300,83700,3557340,3797940,240600,26_26_26_26_26_26_26_26_26_26_8_8_38_38_17_17_17_17_17_17_17_1_17_1_1_1_17_17_1_1_17_17_1_17_1_17_1_1_3_25_3_25_18_18_18_18_18_18_18_18_18_18_15_15_15_15_15_15_3_3_18_18_18_18_18_18_18_18
8598,42,1332840840,18,19,18,1332854040,13200,706800,953340,246540,16_16_16_16_1_1_2_2_3_3_18
8599,212,1332841620,1,18,99,1332841620,0,204240,204240,0,19_19_19_19_19_19_19_19_19_19_19_19_1_1_1_1
8600,188,1332841800,5,2,5,1332843600,1800,4169760,4327560,157800,0_0_0_0_0_1_1_0_0_0_0_0_0_0_0_0_1_1_2_2_2_2_3_3_3_3_21_21_3_3_3_3_3_3_3_3_18_18_18_18_18_18_18_18_18_18_18_18_18_18_18_18_18_18_1_1_18_18_18_18_1_1_18_3_18_18_3_18_18_18_18_18_18_18_18_18_18_18_18_18_18_18_5_5_5_5_5_5_5_5
8601,188,1332843600,5,2,11,1332853200,9600,4171560,4327560,156000,0_0_0_0_0_1_1_0_0_0_0_0_0_0_0_0_1_1_2_2_2_2_3_3_3_3_21_21_3_3_3_3_3_3_3_3_18_18_18_18_18_18_18_18_18_18_18_18_18_18_18_18_18_18_1_1_18_18_18_18_1_1_18_3_18_18_3_18_18_18_18_18_18_18_18_18_18_18_18_18_18_18_5_5_5_5_5_5_5_5_5
8602,192,1332843900,21,4,21,1332843960,60,4639140,4648740,9600,16_16_16_16_16_0_0_16_16_16_16_16_0_0_0_1_1_0_0_0_0_0_0_0_0_0_0_0_0_0_0_0_1_1_2_2_2_2_3_3_21_21_21
8603,192,1332843900,21,4,21,1332843900,0,4639140,4648740,9600,16_16_16_16_16_0_0_16_16_16_16_16_0_0_0_1_1_0_0_0_0_0_0_0_0_0_0_0_0_0_0_0_1_1_2_2_2_2_3_3_21_21
8604,30,1332843960,5,18,5,1332851220,7260,563160,604800,41640,0_0_0_0_0_1_0_0_1_0_1_1_2_2_3_3_3_3_3_3_13_13_13_13_13_13_5
8605,25,1332843960,3,3,4,1332903600,59640,1866360,1951380,85020,16_16_16_8_8_16_16_8_8_16_0_0_0_0_0_0_0_0_1_1_2_2_25_25_9_9_3_3_4_4_4_4_15_15_3_3
8606,14,1332843960,2,3,0,1332906960,63000,1264560,1327560,63000,20_20_20_20_20_20_20_20_20_20_20_20_8_8_0_0_0_0_0_20_0_20_20_0_0_20_0_0_0_0_0_0_1_1_2_2_2_2_0_1_1_1_0_0_1_2_2
8607,192,1332843960,21,4,3,1332844020,60,4639200,4648740,9540,16_16_16_16_16_0_0_16_16_16_16_16_0_0_0_1_1_0_0_0_0_0_0_0_0_0_0_0_0_0_0_0_1_1_2_2_2_2_3_3_21_21_21_21
8608,192,1332844020,3,3,3,1332853500,9480,4639260,4648740,9480,16_16_16_16_16_0_0_16_16_16_16_16_0_0_0_1_1_0_0_0_0_0_0_0_0_0_0_0_0_0_0_0_1_1_2_2_2_2_3_3_21_21_21_21_3
8609,63,1332847200,11,15,11,1332852600,5400,5995740,6232860,237120,16_16_16_16_16_16_16_16_16_0_0_16_16_0_16_16_0_16_16_0_0_16_16_16_0_0_16_0_0_16_0_16_0_0_0_16_1_1_1_16_16_16_0_1_1_1_16_0_0_16_16_0_16_0_16_0_0_2_2_1_1_0_0_0_0_2_2_2_2_2_2_0_1_0_1_1_0_0_0_1_1_0_0_1_1_1_0_0_0_0_0_2_2_2_2_0_0_0_0_0_0_1_1_1_1_0_0_16_0_16_16_16_16_16_0_0_1_1_2_2_1_1_16_0_2_16_2_2_2_0_1_1_1_1_1_16_16_1_1_1_3_3_18_3_18_3_3_3_3_3_18_18_18_18_3_3_3_3_18_18_18_18_18_18_18_5_5_5_18_5_18_18_18_18_18_5_5_5_18_18_18_5_6_6_5_5_5_5_3_5_18_3_3_3_18_16_18_16_5_18_18_6_3_6_18_3_18_18_5_5_18_5_5_5_5_5_5_5_5_5_18_3_5_3_18_3_3_3_3_18_18_18_18_3_5_5_18_3_18_6_3_6_3_18_3_3_18_18_5_5_3_18_3_5_34_34_3_3_18_5_18_3_2_3_2_18_5_34_18_3_5_5_3_5_3_3_5_18_3_34_3_5_18_18_18_18_18_18_18_18_18_18_18_18_18_18_18_18_18_18_34_34_5_34_5_34_5_5_6_6_5_5_6_6_5_5_5_5_5_5_5_5_5_5_5_5_5_5_5_5_34_34_34_34_34_34_5_5_34_34_11
8610,37,1332849600,16,1,16,1332853200,3600,489600,736020,246420,16_16_16_16_16_16_16_16_16_16_16_16_16_16_16_16_16_16_16_16_16_16_16_16_16_16_16_16_16_1_1_16_16_16_16_16_16_16_16_1_1_16_16
8611,37,1332849600,16,1,16,1332849600,0,489600,736020,246420,16_16_16_16_16_16_16_16_16_16_16_16_16_16_16_16_16_16_16_16_16_16_16_16_16_16_16_16_16_1_1_16_16_16_16_16_16_16_16_1_1_16
8612,221,1332850320,1,18,1,1332859260,8940,785520,934800,149280,1_1_1
8613,30,1332851220,5,18,6,1332882000,30780,570420,604800,34380,0_0_0_0_0_1_0_0_1_0_1_1_2_2_3_3_3_3_3_3_13_13_13_13_13_13_5_5
8614,196,1332851400,7,12,10,1332853200,1800,3050700,3281700,231000,7_7_7_7_7_7_7_7_7_7_7_7_7_7_7_7_7_7_7_7_1_1_1_1_7_7_1_1_7_7_1_1_7_7_7_1_1_7_7_7_7_7_7_7_7_7_1_1_7_7_7_30_30_7_1_7_7_1_7_1_1_7_7_7_1_7_7_1_1_1_7_7_30_30_1_1_10_10_10_1_1_10_10_10_10_1_1_10_10_10_10_8_8_7_10_10_7_10_10_10_10_10_7_7_7_7_7_7_8_8_10_10_7_7_1_30_1_30_8_7_8_11_11_7_10_10_8_10_7_10_8_7
8615,63,1332852600,11,15,6,1332882000,29400,6001140,6232860,231720,16_16_16_16_16_16_16_16_16_0_0_16_16_0_16_16_0_16_16_0_0_16_16_16_0_0_16_0_0_16_0_16_0_0_0_16_1_1_1_16_16_16_0_1_1_1_16_0_0_16_16_0_16_0_16_0_0_2_2_1_1_0_0_0_0_2_2_2_2_2_2_0_1_0_1_1_0_0_0_1_1_0_0_1_1_1_0_0_0_0_0_2_2_2_2_0_0_0_0_0_0_1_1_1_1_0_0_16_0_16_16_16_16_16_0_0_1_1_2_2_1_1_16_0_2_16_2_2_2_0_1_1_1_1_1_16_16_1_1_1_3_3_18_3_18_3_3_3_3_3_18_18_18_18_3_3_3_3_18_18_18_18_18_18_18_5_5_5_18_5_18_18_18_18_18_5_5_5_18_18_18_5_6_6_5_5_5_5_3_5_18_3_3_3_18_16_18_16_5_18_18_6_3_6_18_3_18_18_5_5_18_5_5_5_5_5_5_5_5_5_18_3_5_3_18_3_3_3_3_18_18_18_18_3_5_5_18_3_18_6_3_6_3_18_3_3_18_18_5_5_3_18_3_5_34_34_3_3_18_5_18_3_2_3_2_18_5_34_18_3_5_5_3_5_3_3_5_18_3_34_3_5_18_18_18_18_18_18_18_18_18_18_18_18_18_18_18_18_18_18_34_34_5_34_5_34_5_5_6_6_5_5_6_6_5_5_5_5_5_5_5_5_5_5_5_5_5_5_5_5_34_34_34_34_34_34_5_5_34_34_11_11
8616,139,1332852960,19,1,19,1332858960,6000,112680,273900,161220,19_19_19_19_19_19_19_19_1_1_19_19
8617,37,1332853200,16,1,16,1332853620,420,493200,736020,242820,16_16_16_16_16_16_16_16_16_16_16_16_16_16_16_16_16_16_16_16_16_16_16_16_16_16_16_16_16_1_1_16_16_16_16_16_16_16_16_1_1_16_16_16
8618,220,1332853200,4,5,4,1332868320,15120,2508840,2714040,205200,0_0_0_0_1_0_1_0_0_0_0_0_1_0_0_1_0_0_0_0_0_0_0_0_0_0_0_0_0_0_0_1_1_0_1_1_1_1_0_0_1_1_2_2_2_2_2_2_2_2_27_27_27_27_27_27_27_27_27_27_27_27_27_27_27_27_3_3_3_3_3_3_3_3_3_3_3_3_3_3_4_4_4_4_1_4_4_1_4_4_4_4_4_4_4_4_4_4_4_4_4_5_5_4
8619,196,1332853200,10,13,10,1332882240,29040,3052500,3281700,229200,7_7_7_7_7_7_7_7_7_7_7_7_7_7_7_7_7_7_7_7_1_1_1_1_7_7_1_1_7_7_1_1_7_7_7_1_1_7_7_7_7_7_7_7_7_7_1_1_7_7_7_30_30_7_1_7_7_1_7_1_1_7_7_7_1_7_7_1_1_1_7_7_30_30_1_1_10_10_10_1_1_10_10_10_10_1_1_10_10_10_10_8_8_7_10_10_7_10_10_10_10_10_7_7_7_7_7_7_8_8_10_10_7_7_1_30_1_30_8_7_8_11_11_7_10_10_8_10_7_10_8_7_10
8620,188,1332853200,11,17,5,1332860460,7260,4181160,4327560,146400,0_0_0_0_0_1_1_0_0_0_0_0_0_0_0_0_1_1_2_2_2_2_3_3_3_3_21_21_3_3_3_3_3_3_3_3_18_18_18_18_18_18_18_18_18_18_18_18_18_18_18_18_18_18_1_1_18_18_18_18_1_1_18_3_18_18_3_18_18_18_18_18_18_18_18_18_18_18_18_18_18_18_5_5_5_5_5_5_5_5_5_11
8621,40,1332853440,0,1,16,1332853560,120,82260,163800,81540,0_0_0_0_0_0_0_0
8622,192,1332853500,3,3,99,1332853500,0,4648740,4648740,0,16_16_16_16_16_0_0_16_16_16_16_16_0_0_0_1_1_0_0_0_0_0_0_0_0_0_0_0_0_0_0_0_1_1_2_2_2_2_3_3_21_21_21_21_3_3
8623,160,1332853500,3,3,3,1332861540,8040,1320660,1564260,243600,16_16_16_16_0_16_0_16_1_16_1_16_16_16_16_16_16_16_1_1_2_2_3_3_3
8624,40,1332853560,16,20,16,1332860940,7380,82380,163800,81420,0_0_0_0_0_0_0_0_16
8625,37,1332853620,16,20,16,1332860880,7260,493620,736020,242400,16_16_16_16_16_16_16_16_16_16_16_16_16_16_16_16_16_16_16_16_16_16_16_16_16_16_16_16_16_1_1_16_16_16_16_16_16_16_16_1_1_16_16_16_16
8626,42,1332854040,18,19,18,1332854100,60,720000,953340,233340,16_16_16_16_1_1_2_2_3_3_18_18
8627,42,1332854100,18,19,18,1332857160,3060,720060,953340,233280,16_16_16_16_1_1_2_2_3_3_18_18_18
8628,42,1332857160,18,19,18,1332857220,60,723120,953340,230220,16_16_16_16_1_1_2_2_3_3_18_18_18_18
8629,42,1332857220,18,19,18,1332859380,2160,723180,953340,230160,16_16_16_16_1_1_2_2_3_3_18_18_18_18_18
8630,57,1332858360,26,33,26,1332878820,20460,2590620,2756640,166020,26_26_26_26_26_26_26_26_26_26_26_26_26_26_26_26_26_26_26_26_26_26_26_26_26_8_8_8_8_2_2_26_8_8_26_26_26_26_26_26_26_26_8_8_26_26_26_26_26_26_8_8_8_8_26_26_26_26_6_6_5_5_26_26_26_26_26_26_26_26_26_26
8631,139,1332858960,19,20,19,1332862200,3240,118680,273900,155220,19_19_19_19_19_19_19_19_1_1_19_19_19
8632,221,1332859260,1,18,3,1332882000,22740,794460,934800,140340,1_1_1_1
8633,42,1332859380,18,19,11,1333046160,186780,725340,953340,228000,16_16_16_16_1_1_2_2_3_3_18_18_18_18_18_18
8634,22,1332859620,17,10,17,1332873360,13740,639300,810360,171060,17_17_17_17_17_17_17_17_17_17_17_17_17_17
8635,188,1332860460,5,2,11,1332865800,5340,4188420,4327560,139140,0_0_0_0_0_1_1_0_0_0_0_0_0_0_0_0_1_1_2_2_2_2_3_3_3_3_21_21_3_3_3_3_3_3_3_3_18_18_18_18_18_18_18_18_18_18_18_18_18_18_18_18_18_18_1_1_18_18_18_18_1_1_18_3_18_18_3_18_18_18_18_18_18_18_18_18_18_18_18_18_18_18_5_5_5_5_5_5_5_5_5_11_5
8636,64,1332860460,1,9,6,1332882000,21540,6760380,6845160,84780,1_1_11_11_5_5_1_1_6_6_1_1_19_19_2_2_3_3_1_1
8637,37,1332860880,16,20,16,1332867060,6180,500880,736020,235140,16_16_16_16_16_16_16_16_16_16_16_16_16_16_16_16_16_16_16_16_16_16_16_16_16_16_16_16_16_1_1_16_16_16_16_16_16_16_16_1_1_16_16_16_16_16
8638,40,1332860940,16,20,1,1332918000,57060,89760,163800,74040,0_0_0_0_0_0_0_0_16_16
8639,160,1332861540,3,3,18,1332868920,7380,1328700,1564260,235560,16_16_16_16_0_16_0_16_1_16_1_16_16_16_16_16_16_16_1_1_2_2_3_3_3_3
8640,39,1332861660,0,20,0,1332880680,19020,0,235740,235740,0
8641,139,1332862200,19,20,19,1332868140,5940,121920,273900,151980,19_19_19_19_19_19_19_19_1_1_19_19_19_19
8642,188,1332865800,11,17,5,1332907200,41400,4193760,4327560,133800,0_0_0_0_0_1_1_0_0_0_0_0_0_0_0_0_1_1_2_2_2_2_3_3_3_3_21_21_3_3_3_3_3_3_3_3_18_18_18_18_18_18_18_18_18_18_18_18_18_18_18_18_18_18_1_1_18_18_18_18_1_1_18_3_18_18_3_18_18_18_18_18_18_18_18_18_18_18_18_18_18_18_5_5_5_5_5_5_5_5_5_11_5_11
8643,37,1332867060,16,0,16,1332880380,13320,507060,736020,228960,16_16_16_16_16_16_16_16_16_16_16_16_16_16_16_16_16_16_16_16_16_16_16_16_16_16_16_16_16_1_1_16_16_16_16_16_16_16_16_1_1_16_16_16_16_16_16
8644,139,1332868140,19,11,19,1332906120,37980,127860,273900,146040,19_19_19_19_19_19_19_19_1_1_19_19_19_19_19
8645,220,1332868320,4,22,4,1332892680,24360,2523960,2714040,190080,0_0_0_0_1_0_1_0_0_0_0_0_1_0_0_1_0_0_0_0_0_0_0_0_0_0_0_0_0_0_0_1_1_0_1_1_1_1_0_0_1_1_2_2_2_2_2_2_2_2_27_27_27_27_27_27_27_27_27_27_27_27_27_27_27_27_3_3_3_3_3_3_3_3_3_3_3_3_3_3_4_4_4_4_1_4_4_1_4_4_4_4_4_4_4_4_4_4_4_4_4_5_5_4_4
8646,160,1332868920,18,23,18,1332880860,11940,1336080,1564260,228180,16_16_16_16_0_16_0_16_1_16_1_16_16_16_16_16_16_16_1_1_2_2_3_3_3_3_18
8647,131,1332870480,34,17,34,1332880080,9600,6610380,6825900,215520,16_16_16_16_16_16_16_16_16_16_16_16_16_16_16_16_16_16_16_16_16_16_16_16_16_16_1_1_1_1_2_2_3_3_3_3_18_18_18_18_18_3_3_3_3_18_18_18_18_18_18_18_18_18_18_18_18_18_18_18_18_18_18_18_5_5_5_5_5_5_5_5_5_5_5_5_6_6_5_5_6_6_5_5_5_5_5_5_5_5_5_5_6_6_5_5_34_34_34_34_3_3_18_18_18_18_18_18_6_6_5_5_34_34_5_5_5_5_5_5_5_5_5_5_6_6_5_5_34
8648,22,1332873360,17,11,17,1332897660,24300,653040,810360,157320,17_17_17_17_17_17_17_17_17_17_17_17_17_17_17
8649,57,1332878820,26,32,26,1332906900,28080,2611080,2756640,145560,26_26_26_26_26_26_26_26_26_26_26_26_26_26_26_26_26_26_26_26_26_26_26_26_26_8_8_8_8_2_2_26_8_8_26_26_26_26_26_26_26_26_8_8_26_26_26_26_26_26_8_8_8_8_26_26_26_26_6_6_5_5_26_26_26_26_26_26_26_26_26_26_26
8650,131,1332880080,34,17,34,1332907440,27360,6619980,6825900,205920,16_16_16_16_16_16_16_16_16_16_16_16_16_16_16_16_16_16_16_16_16_16_16_16_16_16_1_1_1_1_2_2_3_3_3_3_18_18_18_18_18_3_3_3_3_18_18_18_18_18_18_18_18_18_18_18_18_18_18_18_18_18_18_18_5_5_5_5_5_5_5_5_5_5_5_5_6_6_5_5_6_6_5_5_5_5_5_5_5_5_5_5_6_6_5_5_34_34_34_34_3_3_18_18_18_18_18_18_6_6_5_5_34_34_5_5_5_5_5_5_5_5_5_5_6_6_5_5_34_34
8651,37,1332880380,16,0,16,1332880380,0,520380,736020,215640,16_16_16_16_16_16_16_16_16_16_16_16_16_16_16_16_16_16_16_16_16_16_16_16_16_16_16_16_16_1_1_16_16_16_16_16_16_16_16_1_1_16_16_16_16_16_16_16
8652,37,1332880380,16,0,16,1332886560,6180,520380,736020,215640,16_16_16_16_16_16_16_16_16_16_16_16_16_16_16_16_16_16_16_16_16_16_16_16_16_16_16_16_16_1_1_16_16_16_16_16_16_16_16_1_1_16_16_16_16_16_16_16_16
8653,39,1332880680,0,20,0,1332886620,5940,19020,235740,216720,0_0
8654,160,1332880860,18,23,18,1332880860,0,1348020,1564260,216240,16_16_16_16_0_16_0_16_1_16_1_16_16_16_16_16_16_16_1_1_2_2_3_3_3_3_18_18
8655,160,1332880860,18,23,18,1332907620,26760,1348020,1564260,216240,16_16_16_16_0_16_0_16_1_16_1_16_16_16_16_16_16_16_1_1_2_2_3_3_3_3_18_18_18
8656,35,1332882000,0,20,0,1332886500,4500,0,144180,144180,0
8657,162,1332882000,6,7,6,1332885600,3600,4793460,4836120,42660,0_0_16_16_0_0_0_0_0_0_0_0_16_0_0_16_0_0_16_16_0_0_1_1_2_2_3_3_3_4_3_4_4_4_4_4_5_5_5_5_6_6_5_5_6
8658,30,1332882000,6,7,6,1332885600,3600,601200,604800,3600,0_0_0_0_0_1_0_0_1_0_1_1_2_2_3_3_3_3_3_3_13_13_13_13_13_13_5_5_6
8659,107,1332882000,6,7,6,1332885600,3600,4955400,4991760,36360,8_8_8_8_28_28_28_28_28_28_8_8_8_8_16_16_16_16_16_1_16_16_16_1_16_16_16_16_1_16_1_16_16_16_16_16_16_16_1_16_1_16_16_16_16_16_1_1_16_16_16_1_1_16_16_16_16_16_16_16_16_16_1_1_1_1_1_1_1_1_6
8660,26,1332882000,6,7,6,1332885600,3600,2033160,2036760,3600,16_16_16_16_16_16_16_1_1_16_1_1_2_2_25_9_25_9_3_3_18_18_18_18_15_15_15_15_3_3_3_3_18_18_18_18_18_18_5_5_5_5_2_2_11_11_5_5_5_5_6
8661,63,1332882000,6,7,6,1332885600,3600,6030540,6232860,202320,16_16_16_16_16_16_16_16_16_0_0_16_16_0_16_16_0_16_16_0_0_16_16_16_0_0_16_0_0_16_0_16_0_0_0_16_1_1_1_16_16_16_0_1_1_1_16_0_0_16_16_0_16_0_16_0_0_2_2_1_1_0_0_0_0_2_2_2_2_2_2_0_1_0_1_1_0_0_0_1_1_0_0_1_1_1_0_0_0_0_0_2_2_2_2_0_0_0_0_0_0_1_1_1_1_0_0_16_0_16_16_16_16_16_0_0_1_1_2_2_1_1_16_0_2_16_2_2_2_0_1_1_1_1_1_16_16_1_1_1_3_3_18_3_18_3_3_3_3_3_18_18_18_18_3_3_3_3_18_18_18_18_18_18_18_5_5_5_18_5_18_18_18_18_18_5_5_5_18_18_18_5_6_6_5_5_5_5_3_5_18_3_3_3_18_16_18_16_5_18_18_6_3_6_18_3_18_18_5_5_18_5_5_5_5_5_5_5_5_5_18_3_5_3_18_3_3_3_3_18_18_18_18_3_5_5_18_3_18_6_3_6_3_18_3_3_18_18_5_5_3_18_3_5_34_34_3_3_18_5_18_3_2_3_2_18_5_34_18_3_5_5_3_5_3_3_5_18_3_34_3_5_18_18_18_18_18_18_18_18_18_18_18_18_18_18_18_18_18_18_34_34_5_34_5_34_5_5_6_6_5_5_6_6_5_5_5_5_5_5_5_5_5_5_5_5_5_5_5_5_34_34_34_34_34_34_5_5_34_34_11_11_6
8662,64,1332882000,6,7,6,1332885600,3600,6781920,6845160,63240,1_1_11_11_5_5_1_1_6_6_1_1_19_19_2_2_3_3_1_1_6
8663,204,1332882000,3,4,3,1332886500,4500,2348940,2567700,218760,16_16_16_16_16_16_16_16_16_16_16_16_16_16_16_16_16_16_16_16_16_16_1_1_1_1_1_16_1_2_2_16_16_16_16_16_16_16_16_16_16_1_16_1_16_16_16_16_16_16_1_1_16_16_16_16_16_16_2_16_2_16_1_1_1_1_1_2_2_2_2_1_1_1_1_1_3
8664,221,1332882000,3,4,3,1332886500,4500,817200,934800,117600,1_1_1_1_3
8665,196,1332882240,10,13,7,1332908040,25800,3081540,3281700,200160,7_7_7_7_7_7_7_7_7_7_7_7_7_7_7_7_7_7_7_7_1_1_1_1_7_7_1_1_7_7_1_1_7_7_7_1_1_7_7_7_7_7_7_7_7_7_1_1_7_7_7_30_30_7_1_7_7_1_7_1_1_7_7_7_1_7_7_1_1_1_7_7_30_30_1_1_10_10_10_1_1_10_10_10_10_1_1_10_10_10_10_8_8_7_10_10_7_10_10_10_10_10_7_7_7_7_7_7_8_8_10_10_7_7_1_30_1_30_8_7_8_11_11_7_10_10_8_10_7_10_8_7_10_10
8666,107,1332885600,6,7,5,1332907200,21600,4959000,4991760,32760,8_8_8_8_28_28_28_28_28_28_8_8_8_8_16_16_16_16_16_1_16_16_16_1_16_16_16_16_1_16_1_16_16_16_16_16_16_16_1_16_1_16_16_16_16_16_1_1_16_16_16_1_1_16_16_16_16_16_16_16_16_16_1_1_1_1_1_1_1_1_6_6
8667,30,1332885600,6,7,99,1332885600,0,604800,604800,0,0_0_0_0_0_1_0_0_1_0_1_1_2_2_3_3_3_3_3_3_13_13_13_13_13_13_5_5_6_6
8668,63,1332885600,6,7,5,1333029600,144000,6034140,6232860,198720,16_16_16_16_16_16_16_16_16_0_0_16_16_0_16_16_0_16_16_0_0_16_16_16_0_0_16_0_0_16_0_16_0_0_0_16_1_1_1_16_16_16_0_1_1_1_16_0_0_16_16_0_16_0_16_0_0_2_2_1_1_0_0_0_0_2_2_2_2_2_2_0_1_0_1_1_0_0_0_1_1_0_0_1_1_1_0_0_0_0_0_2_2_2_2_0_0_0_0_0_0_1_1_1_1_0_0_16_0_16_16_16_16_16_0_0_1_1_2_2_1_1_16_0_2_16_2_2_2_0_1_1_1_1_1_16_16_1_1_1_3_3_18_3_18_3_3_3_3_3_18_18_18_18_3_3_3_3_18_18_18_18_18_18_18_5_5_5_18_5_18_18_18_18_18_5_5_5_18_18_18_5_6_6_5_5_5_5_3_5_18_3_3_3_18_16_18_16_5_18_18_6_3_6_18_3_18_18_5_5_18_5_5_5_5_5_5_5_5_5_18_3_5_3_18_3_3_3_3_18_18_18_18_3_5_5_18_3_18_6_3_6_3_18_3_3_18_18_5_5_3_18_3_5_34_34_3_3_18_5_18_3_2_3_2_18_5_34_18_3_5_5_3_5_3_3_5_18_3_34_3_5_18_18_18_18_18_18_18_18_18_18_18_18_18_18_18_18_18_18_34_34_5_34_5_34_5_5_6_6_5_5_6_6_5_5_5_5_5_5_5_5_5_5_5_5_5_5_5_5_34_34_34_34_34_34_5_5_34_34_11_11_6_6
8669,64,1332885600,6,7,4,1332932160,46560,6785520,6845160,59640,1_1_11_11_5_5_1_1_6_6_1_1_19_19_2_2_3_3_1_1_6_6
8670,162,1332885600,6,7,34,1332918300,32700,4797060,4836120,39060,0_0_16_16_0_0_0_0_0_0_0_0_16_0_0_16_0_0_16_16_0_0_1_1_2_2_3_3_3_4_3_4_4_4_4_4_5_5_5_5_6_6_5_5_6_6
8671,26,1332885600,6,7,99,1332885600,0,2036760,2036760,0,16_16_16_16_16_16_16_1_1_16_1_1_2_2_25_9_25_9_3_3_18_18_18_18_15_15_15_15_3_3_3_3_18_18_18_18_18_18_5_5_5_5_2_2_11_11_5_5_5_5_6_6
8672,221,1332886500,3,4,3,1332914640,28140,821700,934800,113100,1_1_1_1_3_3
8673,204,1332886500,3,4,3,1332930180,43680,2353440,2567700,214260,16_16_16_16_16_16_16_16_16_16_16_16_16_16_16_16_16_16_16_16_16_16_1_1_1_1_1_16_1_2_2_16_16_16_16_16_16_16_16_16_16_1_16_1_16_16_16_16_16_16_1_1_16_16_16_16_16_16_2_16_2_16_1_1_1_1_1_2_2_2_2_1_1_1_1_1_3_3
8674,35,1332886500,0,20,0,1332954240,67740,4500,144180,139680,0_0
8675,37,1332886560,16,0,16,1332886560,0,526560,736020,209460,16_16_16_16_16_16_16_16_16_16_16_16_16_16_16_16_16_16_16_16_16_16_16_16_16_16_16_16_16_1_1_16_16_16_16_16_16_16_16_1_1_16_16_16_16_16_16_16_16_16
8676,37,1332886560,16,0,16,1332906000,19440,526560,736020,209460,16_16_16_16_16_16_16_16_16_16_16_16_16_16_16_16_16_16_16_16_16_16_16_16_16_16_16_16_16_1_1_16_16_16_16_16_16_16_16_1_1_16_16_16_16_16_16_16_16_16_16
8677,39,1332886620,0,0,0,1332897060,10440,24960,235740,210780,0_0_0
8678,220,1332892680,4,22,4,1332896040,3360,2548320,2714040,165720,0_0_0_0_1_0_1_0_0_0_0_0_1_0_0_1_0_0_0_0_0_0_0_0_0_0_0_0_0_0_0_1_1_0_1_1_1_1_0_0_1_1_2_2_2_2_2_2_2_2_27_27_27_27_27_27_27_27_27_27_27_27_27_27_27_27_3_3_3_3_3_3_3_3_3_3_3_3_3_3_4_4_4_4_1_4_4_1_4_4_4_4_4_4_4_4_4_4_4_4_4_5_5_4_4_4
8679,142,1332892800,4,22,4,1332895980,3180,7134360,7299960,165600,0_0_0_0_0_0_0_1_1_0_0_0_0_0_0_0_0_1_1_0_0_0_0_0_0_1_1_0_0_0_0_0_0_1_1_0_0_0_0_0_0_0_1_0_1_0_0_0_1_1_1_1_27_27_27_27_1_27_27_1_27_27_27_27_27_27_27_27_27_27_27_27_27_27_27_27_2_2_2_2_2_2_3_3_3_2_2_3_3_3_2_2_3_3_4_4_15_4_15_4_4_4_4_4_4_4_4_4_4_4_4_4_4_4_4_4_4_4_4_4_4_4_4_4_4_4_4_4_4_4_4_4_15_15_15_15_15_15_5_5_6_6_15_15_5_5_6_6_5_5_15_5_5_15_5_5_15_18_15_18_4
8680,142,1332895980,4,22,5,1332927540,31560,7137540,7299960,162420,0_0_0_0_0_0_0_1_1_0_0_0_0_0_0_0_0_1_1_0_0_0_0_0_0_1_1_0_0_0_0_0_0_1_1_0_0_0_0_0_0_0_1_0_1_0_0_0_1_1_1_1_27_27_27_27_1_27_27_1_27_27_27_27_27_27_27_27_27_27_27_27_27_27_27_27_2_2_2_2_2_2_3_3_3_2_2_3_3_3_2_2_3_3_4_4_15_4_15_4_4_4_4_4_4_4_4_4_4_4_4_4_4_4_4_4_4_4_4_4_4_4_4_4_4_4_4_4_4_4_4_4_15_15_15_15_15_15_5_5_6_6_15_15_5_5_6_6_5_5_15_5_5_15_5_5_15_18_15_18_4_4
8681,220,1332896040,4,22,4,1332902700,6660,2551680,2714040,162360,0_0_0_0_1_0_1_0_0_0_0_0_1_0_0_1_0_0_0_0_0_0_0_0_0_0_0_0_0_0_0_1_1_0_1_1_1_1_0_0_1_1_2_2_2_2_2_2_2_2_27_27_27_27_27_27_27_27_27_27_27_27_27_27_27_27_3_3_3_3_3_3_3_3_3_3_3_3_3_3_4_4_4_4_1_4_4_1_4_4_4_4_4_4_4_4_4_4_4_4_4_5_5_4_4_4_4
8682,39,1332897060,0,0,0,1332910200,13140,35400,235740,200340,0_0_0_0
8683,22,1332897660,17,11,17,1332908400,10740,677340,810360,133020,17_17_17_17_17_17_17_17_17_17_17_17_17_17_17_17
8684,220,1332902700,4,22,5,1332910020,7320,2558340,2714040,155700,0_0_0_0_1_0_1_0_0_0_0_0_1_0_0_1_0_0_0_0_0_0_0_0_0_0_0_0_0_0_0_1_1_0_1_1_1_1_0_0_1_1_2_2_2_2_2_2_2_2_27_27_27_27_27_27_27_27_27_27_27_27_27_27_27_27_3_3_3_3_3_3_3_3_3_3_3_3_3_3_4_4_4_4_1_4_4_1_4_4_4_4_4_4_4_4_4_4_4_4_4_5_5_4_4_4_4_4
8685,25,1332903600,4,22,4,1332906000,2400,1926000,1951380,25380,16_16_16_8_8_16_16_8_8_16_0_0_0_0_0_0_0_0_1_1_2_2_25_25_9_9_3_3_4_4_4_4_15_15_3_3_4
8686,37,1332906000,16,0,16,1332910140,4140,546000,736020,190020,16_16_16_16_16_16_16_16_16_16_16_16_16_16_16_16_16_16_16_16_16_16_16_16_16_16_16_16_16_1_1_16_16_16_16_16_16_16_16_1_1_16_16_16_16_16_16_16_16_16_16_16
8687,25,1332906000,4,22,4,1332907200,1200,1928400,1951380,22980,16_16_16_8_8_16_16_8_8_16_0_0_0_0_0_0_0_0_1_1_2_2_25_25_9_9_3_3_4_4_4_4_15_15_3_3_4_4
8688,139,1332906120,19,11,19,1332907200,1080,165840,273900,108060,19_19_19_19_19_19_19_19_1_1_19_19_19_19_19_19
8689,170,1332906780,1,9,1,1332906840,60,660660,665160,4500,19_19_19_19_19_19_1_1_51_51_1
8690,170,1332906840,1,9,1,1332909060,2220,660720,665160,4440,19_19_19_19_19_19_1_1_51_51_1_1
8691,57,1332906900,26,32,26,1332927420,20520,2639160,2756640,117480,26_26_26_26_26_26_26_26_26_26_26_26_26_26_26_26_26_26_26_26_26_26_26_26_26_8_8_8_8_2_2_26_8_8_26_26_26_26_26_26_26_26_8_8_26_26_26_26_26_26_8_8_8_8_26_26_26_26_6_6_5_5_26_26_26_26_26_26_26_26_26_26_26_26
8692,14,1332906960,0,1,99,1332906960,0,1327560,1327560,0,20_20_20_20_20_20_20_20_20_20_20_20_8_8_0_0_0_0_0_20_0_20_20_0_0_20_0_0_0_0_0_0_1_1_2_2_2_2_0_1_1_1_0_0_1_2_2_0
8693,107,1332907200,5,18,5,1332918360,11160,4980600,4991760,11160,8_8_8_8_28_28_28_28_28_28_8_8_8_8_16_16_16_16_16_1_16_16_16_1_16_16_16_16_1_16_1_16_16_16_16_16_16_16_1_16_1_16_16_16_16_16_1_1_16_16_16_1_1_16_16_16_16_16_16_16_16_16_1_1_1_1_1_1_1_1_6_6_5
8694,139,1332907200,19,21,1,1332907500,300,166920,273900,106980,19_19_19_19_19_19_19_19_1_1_19_19_19_19_19_19_19
8695,188,1332907200,5,2,5,1332913200,6000,4235160,4327560,92400,0_0_0_0_0_1_1_0_0_0_0_0_0_0_0_0_1_1_2_2_2_2_3_3_3_3_21_21_3_3_3_3_3_3_3_3_18_18_18_18_18_18_18_18_18_18_18_18_18_18_18_18_18_18_1_1_18_18_18_18_1_1_18_3_18_18_3_18_18_18_18_18_18_18_18_18_18_18_18_18_18_18_5_5_5_5_5_5_5_5_5_11_5_11_5
8696,25,1332907200,4,5,4,1332928980,21780,1929600,1951380,21780,16_16_16_8_8_16_16_8_8_16_0_0_0_0_0_0_0_0_1_1_2_2_25_25_9_9_3_3_4_4_4_4_15_15_3_3_4_4_4
8697,131,1332907440,34,15,34,1332908460,1020,6647340,6825900,178560,16_16_16_16_16_16_16_16_16_16_16_16_16_16_16_16_16_16_16_16_16_16_16_16_16_16_1_1_1_1_2_2_3_3_3_3_18_18_18_18_18_3_3_3_3_18_18_18_18_18_18_18_18_18_18_18_18_18_18_18_18_18_18_18_5_5_5_5_5_5_5_5_5_5_5_5_6_6_5_5_6_6_5_5_5_5_5_5_5_5_5_5_6_6_5_5_34_34_34_34_3_3_18_18_18_18_18_18_6_6_5_5_34_34_5_5_5_5_5_5_5_5_5_5_6_6_5_5_34_34_34
8698,139,1332907500,1,9,19,1332908820,1320,167220,273900,106680,19_19_19_19_19_19_19_19_1_1_19_19_19_19_19_19_19_1
8699,160,1332907620,18,23,18,1332907680,60,1374780,1564260,189480,16_16_16_16_0_16_0_16_1_16_1_16_16_16_16_16_16_16_1_1_2_2_3_3_3_3_18_18_18_18
8700,160,1332907680,18,5,18,1332921120,13440,1374840,1564260,189420,16_16_16_16_0_16_0_16_1_16_1_16_16_16_16_16_16_16_1_1_2_2_3_3_3_3_18_18_18_18_18
8701,196,1332908040,7,12,7,1332937920,29880,3107340,3281700,174360,7_7_7_7_7_7_7_7_7_7_7_7_7_7_7_7_7_7_7_7_1_1_1_1_7_7_1_1_7_7_1_1_7_7_7_1_1_7_7_7_7_7_7_7_7_7_1_1_7_7_7_30_30_7_1_7_7_1_7_1_1_7_7_7_1_7_7_1_1_1_7_7_30_30_1_1_10_10_10_1_1_10_10_10_10_1_1_10_10_10_10_8_8_7_10_10_7_10_10_10_10_10_7_7_7_7_7_7_8_8_10_10_7_7_1_30_1_30_8_7_8_11_11_7_10_10_8_10_7_10_8_7_10_10_7
8702,22,1332908400,17,10,17,1332945420,37020,688080,810360,122280,17_17_17_17_17_17_17_17_17_17_17_17_17_17_17_17_17
8703,131,1332908460,34,15,3,1332923280,14820,6648360,6825900,177540,16_16_16_16_16_16_16_16_16_16_16_16_16_16_16_16_16_16_16_16_16_16_16_16_16_16_1_1_1_1_2_2_3_3_3_3_18_18_18_18_18_3_3_3_3_18_18_18_18_18_18_18_18_18_18_18_18_18_18_18_18_18_18_18_5_5_5_5_5_5_5_5_5_5_5_5_6_6_5_5_6_6_5_5_5_5_5_5_5_5_5_5_6_6_5_5_34_34_34_34_3_3_18_18_18_18_18_18_6_6_5_5_34_34_5_5_5_5_5_5_5_5_5_5_6_6_5_5_34_34_34_34
8704,139,1332908820,19,21,1,1332909060,240,168540,273900,105360,19_19_19_19_19_19_19_19_1_1_19_19_19_19_19_19_19_1_19
8705,170,1332909060,1,9,1,1332911280,2220,662940,665160,2220,19_19_19_19_19_19_1_1_51_51_1_1_1
8706,139,1332909060,1,9,1,1332909660,600,168780,273900,105120,19_19_19_19_19_19_19_19_1_1_19_19_19_19_19_19_19_1_19_1
8707,139,1332909660,1,9,1,1332910080,420,169380,273900,104520,19_19_19_19_19_19_19_19_1_1_19_19_19_19_19_19_19_1_19_1_1
8708,220,1332910020,5,9,5,1332920160,10140,2565660,2714040,148380,0_0_0_0_1_0_1_0_0_0_0_0_1_0_0_1_0_0_0_0_0_0_0_0_0_0_0_0_0_0_0_1_1_0_1_1_1_1_0_0_1_1_2_2_2_2_2_2_2_2_27_27_27_27_27_27_27_27_27_27_27_27_27_27_27_27_3_3_3_3_3_3_3_3_3_3_3_3_3_3_4_4_4_4_1_4_4_1_4_4_4_4_4_4_4_4_4_4_4_4_4_5_5_4_4_4_4_4_5
8709,139,1332910080,1,9,19,1332910200,120,169800,273900,104100,19_19_19_19_19_19_19_19_1_1_19_19_19_19_19_19_19_1_19_1_1_1
8710,37,1332910140,16,1,1,1332917220,7080,550140,736020,185880,16_16_16_16_16_16_16_16_16_16_16_16_16_16_16_16_16_16_16_16_16_16_16_16_16_16_16_16_16_1_1_16_16_16_16_16_16_16_16_1_1_16_16_16_16_16_16_16_16_16_16_16_16
8711,139,1332910200,19,1,2,1332912000,1800,169920,273900,103980,19_19_19_19_19_19_19_19_1_1_19_19_19_19_19_19_19_1_19_1_1_1_19
8712,39,1332910200,0,1,0,1332940140,29940,48540,235740,187200,0_0_0_0_0
8713,170,1332911280,1,9,99,1332911280,0,665160,665160,0,19_19_19_19_19_19_1_1_51_51_1_1_1_1
8714,139,1332912000,2,3,2,1332920340,8340,171720,273900,102180,19_19_19_19_19_19_19_19_1_1_19_19_19_19_19_19_19_1_19_1_1_1_19_2
8715,188,1332913200,5,2,5,1332914400,1200,4241160,4327560,86400,0_0_0_0_0_1_1_0_0_0_0_0_0_0_0_0_1_1_2_2_2_2_3_3_3_3_21_21_3_3_3_3_3_3_3_3_18_18_18_18_18_18_18_18_18_18_18_18_18_18_18_18_18_18_1_1_18_18_18_18_1_1_18_3_18_18_3_18_18_18_18_18_18_18_18_18_18_18_18_18_18_18_5_5_5_5_5_5_5_5_5_11_5_11_5_5
8716,65,1332914400,5,18,5,1332946920,32520,7372800,7544400,171600,17_17_34_34_6_6_6_6_5_5_1_1_1_1_2_2_3_3_5_5_5_5_3_3_18_18_18_18_18_18_18_18_18_18_5
8717,188,1332914400,5,2,5,1332915600,1200,4242360,4327560,85200,0_0_0_0_0_1_1_0_0_0_0_0_0_0_0_0_1_1_2_2_2_2_3_3_3_3_21_21_3_3_3_3_3_3_3_3_18_18_18_18_18_18_18_18_18_18_18_18_18_18_18_18_18_18_1_1_18_18_18_18_1_1_18_3_18_18_3_18_18_18_18_18_18_18_18_18_18_18_18_18_18_18_5_5_5_5_5_5_5_5_5_11_5_11_5_5_5
8718,221,1332914640,3,4,2,1332916200,1560,849840,934800,84960,1_1_1_1_3_3_3
8719,133,1332915000,5,9,5,1332919500,4500,6124200,6181200,57000,17_17_17_17_17_17_17_17_17_17_17_17_17_17_17_17_17_17_17_17_17_17_17_17_17_17_17_17_17_17_1_1_17_17_17_17_1_1_1_1_17_17_17_17_17_17_17_17_17_17_17_17_17_17_17_17_17_17_17_17_17_17_19_19_17_17_2_2_3_3_3_3_3_3_5_5_6_6_17_17_17_17_3_3_1_2_2_2_1_2_3_3_2_3_3_2_5
8720,188,1332915600,5,2,5,1332915600,0,4243560,4327560,84000,0_0_0_0_0_1_1_0_0_0_0_0_0_0_0_0_1_1_2_2_2_2_3_3_3_3_21_21_3_3_3_3_3_3_3_3_18_18_18_18_18_18_18_18_18_18_18_18_18_18_18_18_18_18_1_1_18_18_18_18_1_1_18_3_18_18_3_18_18_18_18_18_18_18_18_18_18_18_18_18_18_18_5_5_5_5_5_5_5_5_5_11_5_11_5_5_5_5
8721,188,1332915600,5,2,5,1332916800,1200,4243560,4327560,84000,0_0_0_0_0_1_1_0_0_0_0_0_0_0_0_0_1_1_2_2_2_2_3_3_3_3_21_21_3_3_3_3_3_3_3_3_18_18_18_18_18_18_18_18_18_18_18_18_18_18_18_18_18_18_1_1_18_18_18_18_1_1_18_3_18_18_3_18_18_18_18_18_18_18_18_18_18_18_18_18_18_18_5_5_5_5_5_5_5_5_5_11_5_11_5_5_5_5_5
8722,221,1332916200,2,21,3,1332918780,2580,851400,934800,83400,1_1_1_1_3_3_3_2
8723,188,1332916800,5,2,5,1332916800,0,4244760,4327560,82800,0_0_0_0_0_1_1_0_0_0_0_0_0_0_0_0_1_1_2_2_2_2_3_3_3_3_21_21_3_3_3_3_3_3_3_3_18_18_18_18_18_18_18_18_18_18_18_18_18_18_18_18_18_18_1_1_18_18_18_18_1_1_18_3_18_18_3_18_18_18_18_18_18_18_18_18_18_18_18_18_18_18_5_5_5_5_5_5_5_5_5_11_5_11_5_5_5_5_5_5
8724,188,1332916800,5,2,5,1332918000,1200,4244760,4327560,82800,0_0_0_0_0_1_1_0_0_0_0_0_0_0_0_0_1_1_2_2_2_2_3_3_3_3_21_21_3_3_3_3_3_3_3_3_18_18_18_18_18_18_18_18_18_18_18_18_18_18_18_18_18_18_1_1_18_18_18_18_1_1_18_3_18_18_3_18_18_18_18_18_18_18_18_18_18_18_18_18_18_18_5_5_5_5_5_5_5_5_5_11_5_11_5_5_5_5_5_5_5
8725,37,1332917220,1,6,1,1332935280,18060,557220,736020,178800,16_16_16_16_16_16_16_16_16_16_16_16_16_16_16_16_16_16_16_16_16_16_16_16_16_16_16_16_16_1_1_16_16_16_16_16_16_16_16_1_1_16_16_16_16_16_16_16_16_16_16_16_16_1
8726,13,1332917220,1,9,1,1332917280,60,2350680,2525940,175260,19_19_19_1_1_19_19_19_19_19_19_19_19_19_19_19_1_1_1_19_1_19_19_19_19_19_19_19_19_19_19_1_19_1_19_19_19_19_19_19_1_1_1_1_19_19_19_19_1_1_1_1_1_1_19_19_1_19_1_19_19_19_19_19_2_2_9_9_2_2_1_9_1_3_1_3_9_1_1_1_19_1_1_19_19_3_19_3_3_3_9_19_9_19_3_3_1_19_1_3_3_19_19_19_19_19_19_19_3_3_2_2_3_3_1
8727,13,1332917280,1,9,4,1332929220,11940,2350740,2525940,175200,19_19_19_1_1_19_19_19_19_19_19_19_19_19_19_19_1_1_1_19_1_19_19_19_19_19_19_19_19_19_19_1_19_1_19_19_19_19_19_19_1_1_1_1_19_19_19_19_1_1_1_1_1_1_19_19_1_19_1_19_19_19_19_19_2_2_9_9_2_2_1_9_1_3_1_3_9_1_1_1_19_1_1_19_19_3_19_3_3_3_9_19_9_19_3_3_1_19_1_3_3_19_19_19_19_19_19_19_3_3_2_2_3_3_1_1
8728,188,1332918000,5,2,6,1332968400,50400,4245960,4327560,81600,0_0_0_0_0_1_1_0_0_0_0_0_0_0_0_0_1_1_2_2_2_2_3_3_3_3_21_21_3_3_3_3_3_3_3_3_18_18_18_18_18_18_18_18_18_18_18_18_18_18_18_18_18_18_1_1_18_18_18_18_1_1_18_3_18_18_3_18_18_18_18_18_18_18_18_18_18_18_18_18_18_18_5_5_5_5_5_5_5_5_5_11_5_11_5_5_5_5_5_5_5_5
8729,223,1332918000,1,18,1,1332927480,9480,0,84600,84600,1
8730,40,1332918000,1,2,1,1332919800,1800,146820,163800,16980,0_0_0_0_0_0_0_0_16_16_1
8731,162,1332918300,34,15,5,1332920160,1860,4829760,4836120,6360,0_0_16_16_0_0_0_0_0_0_0_0_16_0_0_16_0_0_16_16_0_0_1_1_2_2_3_3_3_4_3_4_4_4_4_4_5_5_5_5_6_6_5_5_6_6_34
8732,107,1332918360,5,18,99,1332918360,0,4991760,4991760,0,8_8_8_8_28_28_28_28_28_28_8_8_8_8_16_16_16_16_16_1_16_16_16_1_16_16_16_16_1_16_1_16_16_16_16_16_16_16_1_16_1_16_16_16_16_16_1_1_16_16_16_1_1_16_16_16_16_16_16_16_16_16_1_1_1_1_1_1_1_1_6_6_5_5
8733,221,1332918780,3,4,3,1332920400,1620,853980,934800,80820,1_1_1_1_3_3_3_2_3
8734,152,1332919260,5,6,5,1332927600,8340,3671820,3766500,94680,17_17_17_17_17_17_17_17_17_17_17_17_1_1_2_2_17_17_17_17_3_3_3_3_3_3_18_18_18_18_18_18_18_18_18_18_18_18_18_18_5
8735,133,1332919500,5,9,6,1332968400,48900,6128700,6181200,52500,17_17_17_17_17_17_17_17_17_17_17_17_17_17_17_17_17_17_17_17_17_17_17_17_17_17_17_17_17_17_1_1_17_17_17_17_1_1_1_1_17_17_17_17_17_17_17_17_17_17_17_17_17_17_17_17_17_17_17_17_17_17_19_19_17_17_2_2_3_3_3_3_3_3_5_5_6_6_17_17_17_17_3_3_1_2_2_2_1_2_3_3_2_3_3_2_5_5
8736,40,1332919800,1,2,1,1332919800,0,148620,163800,15180,0_0_0_0_0_0_0_0_16_16_1_1
8737,40,1332919800,1,2,1,1332921600,1800,148620,163800,15180,0_0_0_0_0_0_0_0_16_16_1_1_1
8738,220,1332920160,5,9,5,1332920220,60,2575800,2714040,138240,0_0_0_0_1_0_1_0_0_0_0_0_1_0_0_1_0_0_0_0_0_0_0_0_0_0_0_0_0_0_0_1_1_0_1_1_1_1_0_0_1_1_2_2_2_2_2_2_2_2_27_27_27_27_27_27_27_27_27_27_27_27_27_27_27_27_3_3_3_3_3_3_3_3_3_3_3_3_3_3_4_4_4_4_1_4_4_1_4_4_4_4_4_4_4_4_4_4_4_4_4_5_5_4_4_4_4_4_5_5
8739,162,1332920160,5,6,34,1332923220,3060,4831620,4836120,4500,0_0_16_16_0_0_0_0_0_0_0_0_16_0_0_16_0_0_16_16_0_0_1_1_2_2_3_3_3_4_3_4_4_4_4_4_5_5_5_5_6_6_5_5_6_6_34_5
8740,220,1332920220,5,9,5,1332924540,4320,2575860,2714040,138180,0_0_0_0_1_0_1_0_0_0_0_0_1_0_0_1_0_0_0_0_0_0_0_0_0_0_0_0_0_0_0_1_1_0_1_1_1_1_0_0_1_1_2_2_2_2_2_2_2_2_27_27_27_27_27_27_27_27_27_27_27_27_27_27_27_27_3_3_3_3_3_3_3_3_3_3_3_3_3_3_4_4_4_4_1_4_4_1_4_4_4_4_4_4_4_4_4_4_4_4_4_5_5_4_4_4_4_4_5_5_5
8741,139,1332920340,2,3,19,1332925500,5160,180060,273900,93840,19_19_19_19_19_19_19_19_1_1_19_19_19_19_19_19_19_1_19_1_1_1_19_2_2
8742,221,1332920400,3,3,2,1332925200,4800,855600,934800,79200,1_1_1_1_3_3_3_2_3_3
8743,160,1332921120,18,5,18,1332928980,7860,1388280,1564260,175980,16_16_16_16_0_16_0_16_1_16_1_16_16_16_16_16_16_16_1_1_2_2_3_3_3_3_18_18_18_18_18_18
8744,40,1332921600,1,2,1,1332921600,0,150420,163800,13380,0_0_0_0_0_0_0_0_16_16_1_1_1_1
8745,40,1332921600,1,2,1,1332924300,2700,150420,163800,13380,0_0_0_0_0_0_0_0_16_16_1_1_1_1_1
8746,162,1332923220,34,15,5,1332924660,1440,4834680,4836120,1440,0_0_16_16_0_0_0_0_0_0_0_0_16_0_0_16_0_0_16_16_0_0_1_1_2_2_3_3_3_4_3_4_4_4_4_4_5_5_5_5_6_6_5_5_6_6_34_5_34
8747,131,1332923280,3,15,3,1332932160,8880,6663180,6825900,162720,16_16_16_16_16_16_16_16_16_16_16_16_16_16_16_16_16_16_16_16_16_16_16_16_16_16_1_1_1_1_2_2_3_3_3_3_18_18_18_18_18_3_3_3_3_18_18_18_18_18_18_18_18_18_18_18_18_18_18_18_18_18_18_18_5_5_5_5_5_5_5_5_5_5_5_5_6_6_5_5_6_6_5_5_5_5_5_5_5_5_5_5_6_6_5_5_34_34_34_34_3_3_18_18_18_18_18_18_6_6_5_5_34_34_5_5_5_5_5_5_5_5_5_5_6_6_5_5_34_34_34_34_3
8748,40,1332924300,1,2,2,1332933300,9000,153120,163800,10680,0_0_0_0_0_0_0_0_16_16_1_1_1_1_1_1
8749,219,1332924300,15,2,15,1332928200,3900,3641040,3797940,156900,26_26_26_26_26_26_26_26_26_26_8_8_38_38_17_17_17_17_17_17_17_1_17_1_1_1_17_17_1_1_17_17_1_17_1_17_1_1_3_25_3_25_18_18_18_18_18_18_18_18_18_18_15_15_15_15_15_15_3_3_18_18_18_18_18_18_18_18_15
8750,220,1332924540,5,9,5,1332927480,2940,2580180,2714040,133860,0_0_0_0_1_0_1_0_0_0_0_0_1_0_0_1_0_0_0_0_0_0_0_0_0_0_0_0_0_0_0_1_1_0_1_1_1_1_0_0_1_1_2_2_2_2_2_2_2_2_27_27_27_27_27_27_27_27_27_27_27_27_27_27_27_27_3_3_3_3_3_3_3_3_3_3_3_3_3_3_4_4_4_4_1_4_4_1_4_4_4_4_4_4_4_4_4_4_4_4_4_5_5_4_4_4_4_4_5_5_5_5
8751,162,1332924660,5,6,99,1332924660,0,4836120,4836120,0,0_0_16_16_0_0_0_0_0_0_0_0_16_0_0_16_0_0_16_16_0_0_1_1_2_2_3_3_3_4_3_4_4_4_4_4_5_5_5_5_6_6_5_5_6_6_34_5_34_5
8752,221,1332925200,2,21,3,1332930120,4920,860400,934800,74400,1_1_1_1_3_3_3_2_3_3_2
8753,139,1332925500,19,1,1,1333013040,87540,185220,273900,88680,19_19_19_19_19_19_19_19_1_1_19_19_19_19_19_19_19_1_19_1_1_1_19_2_2_19
8754,57,1332927420,26,33,26,1332939180,11760,2659680,2756640,96960,26_26_26_26_26_26_26_26_26_26_26_26_26_26_26_26_26_26_26_26_26_26_26_26_26_8_8_8_8_2_2_26_8_8_26_26_26_26_26_26_26_26_8_8_26_26_26_26_26_26_8_8_8_8_26_26_26_26_6_6_5_5_26_26_26_26_26_26_26_26_26_26_26_26_26
8755,223,1332927480,1,18,2,1332936000,8520,9480,84600,75120,1_1
8756,220,1332927480,5,9,5,1332927540,60,2583120,2714040,130920,0_0_0_0_1_0_1_0_0_0_0_0_1_0_0_1_0_0_0_0_0_0_0_0_0_0_0_0_0_0_0_1_1_0_1_1_1_1_0_0_1_1_2_2_2_2_2_2_2_2_27_27_27_27_27_27_27_27_27_27_27_27_27_27_27_27_3_3_3_3_3_3_3_3_3_3_3_3_3_3_4_4_4_4_1_4_4_1_4_4_4_4_4_4_4_4_4_4_4_4_4_5_5_4_4_4_4_4_5_5_5_5_5
8757,220,1332927540,5,9,6,1333054800,127260,2583180,2714040,130860,0_0_0_0_1_0_1_0_0_0_0_0_1_0_0_1_0_0_0_0_0_0_0_0_0_0_0_0_0_0_0_1_1_0_1_1_1_1_0_0_1_1_2_2_2_2_2_2_2_2_27_27_27_27_27_27_27_27_27_27_27_27_27_27_27_27_3_3_3_3_3_3_3_3_3_3_3_3_3_3_4_4_4_4_1_4_4_1_4_4_4_4_4_4_4_4_4_4_4_4_4_5_5_4_4_4_4_4_5_5_5_5_5_5
8758,142,1332927540,5,9,15,1332927960,420,7169100,7299960,130860,0_0_0_0_0_0_0_1_1_0_0_0_0_0_0_0_0_1_1_0_0_0_0_0_0_1_1_0_0_0_0_0_0_1_1_0_0_0_0_0_0_0_1_0_1_0_0_0_1_1_1_1_27_27_27_27_1_27_27_1_27_27_27_27_27_27_27_27_27_27_27_27_27_27_27_27_2_2_2_2_2_2_3_3_3_2_2_3_3_3_2_2_3_3_4_4_15_4_15_4_4_4_4_4_4_4_4_4_4_4_4_4_4_4_4_4_4_4_4_4_4_4_4_4_4_4_4_4_4_4_4_4_15_15_15_15_15_15_5_5_6_6_15_15_5_5_6_6_5_5_15_5_5_15_5_5_15_18_15_18_4_4_5
8759,152,1332927600,5,6,6,1332968400,40800,3680160,3766500,86340,17_17_17_17_17_17_17_17_17_17_17_17_1_1_2_2_17_17_17_17_3_3_3_3_3_3_18_18_18_18_18_18_18_18_18_18_18_18_18_18_5_5
8760,142,1332927960,15,9,15,1332928020,60,7169520,7299960,130440,0_0_0_0_0_0_0_1_1_0_0_0_0_0_0_0_0_1_1_0_0_0_0_0_0_1_1_0_0_0_0_0_0_1_1_0_0_0_0_0_0_0_1_0_1_0_0_0_1_1_1_1_27_27_27_27_1_27_27_1_27_27_27_27_27_27_27_27_27_27_27_27_27_27_27_27_2_2_2_2_2_2_3_3_3_2_2_3_3_3_2_2_3_3_4_4_15_4_15_4_4_4_4_4_4_4_4_4_4_4_4_4_4_4_4_4_4_4_4_4_4_4_4_4_4_4_4_4_4_4_4_4_15_15_15_15_15_15_5_5_6_6_15_15_5_5_6_6_5_5_15_5_5_15_5_5_15_18_15_18_4_4_5_15
8761,142,1332928020,15,9,5,1332932700,4680,7169580,7299960,130380,0_0_0_0_0_0_0_1_1_0_0_0_0_0_0_0_0_1_1_0_0_0_0_0_0_1_1_0_0_0_0_0_0_1_1_0_0_0_0_0_0_0_1_0_1_0_0_0_1_1_1_1_27_27_27_27_1_27_27_1_27_27_27_27_27_27_27_27_27_27_27_27_27_27_27_27_2_2_2_2_2_2_3_3_3_2_2_3_3_3_2_2_3_3_4_4_15_4_15_4_4_4_4_4_4_4_4_4_4_4_4_4_4_4_4_4_4_4_4_4_4_4_4_4_4_4_4_4_4_4_4_4_15_15_15_15_15_15_5_5_6_6_15_15_5_5_6_6_5_5_15_5_5_15_5_5_15_18_15_18_4_4_5_15_15
8762,219,1332928200,15,2,15,1332930000,1800,3644940,3797940,153000,26_26_26_26_26_26_26_26_26_26_8_8_38_38_17_17_17_17_17_17_17_1_17_1_1_1_17_17_1_1_17_17_1_17_1_17_1_1_3_25_3_25_18_18_18_18_18_18_18_18_18_18_15_15_15_15_15_15_3_3_18_18_18_18_18_18_18_18_15_15
8763,25,1332928980,4,5,99,1332928980,0,1951380,1951380,0,16_16_16_8_8_16_16_8_8_16_0_0_0_0_0_0_0_0_1_1_2_2_25_25_9_9_3_3_4_4_4_4_15_15_3_3_4_4_4_4
8764,160,1332928980,18,5,18,1332932100,3120,1396140,1564260,168120,16_16_16_16_0_16_0_16_1_16_1_16_16_16_16_16_16_16_1_1_2_2_3_3_3_3_18_18_18_18_18_18_18
8765,13,1332929220,4,5,4,1332932100,2880,2362680,2525940,163260,19_19_19_1_1_19_19_19_19_19_19_19_19_19_19_19_1_1_1_19_1_19_19_19_19_19_19_19_19_19_19_1_19_1_19_19_19_19_19_19_1_1_1_1_19_19_19_19_1_1_1_1_1_1_19_19_1_19_1_19_19_19_19_19_2_2_9_9_2_2_1_9_1_3_1_3_9_1_1_1_19_1_1_19_19_3_19_3_3_3_9_19_9_19_3_3_1_19_1_3_3_19_19_19_19_19_19_19_3_3_2_2_3_3_1_1_4
8766,219,1332930000,15,2,15,1332946860,16860,3646740,3797940,151200,26_26_26_26_26_26_26_26_26_26_8_8_38_38_17_17_17_17_17_17_17_1_17_1_1_1_17_17_1_1_17_17_1_17_1_17_1_1_3_25_3_25_18_18_18_18_18_18_18_18_18_18_15_15_15_15_15_15_3_3_18_18_18_18_18_18_18_18_15_15_15
8767,221,1332930120,3,3,6,1332968400,38280,865320,934800,69480,1_1_1_1_3_3_3_2_3_3_2_3
8768,204,1332930180,3,3,3,1332944160,13980,2397120,2567700,170580,16_16_16_16_16_16_16_16_16_16_16_16_16_16_16_16_16_16_16_16_16_16_1_1_1_1_1_16_1_2_2_16_16_16_16_16_16_16_16_16_16_1_16_1_16_16_16_16_16_16_1_1_16_16_16_16_16_16_2_16_2_16_1_1_1_1_1_2_2_2_2_1_1_1_1_1_3_3_3
8769,13,1332932100,4,5,4,1332933180,1080,2365560,2525940,160380,19_19_19_1_1_19_19_19_19_19_19_19_19_19_19_19_1_1_1_19_1_19_19_19_19_19_19_19_19_19_19_1_19_1_19_19_19_19_19_19_1_1_1_1_19_19_19_19_1_1_1_1_1_1_19_19_1_19_1_19_19_19_19_19_2_2_9_9_2_2_1_9_1_3_1_3_9_1_1_1_19_1_1_19_19_3_19_3_3_3_9_19_9_19_3_3_1_19_1_3_3_19_19_19_19_19_19_19_3_3_2_2_3_3_1_1_4_4
8770,160,1332932100,18,5,18,1332932100,0,1399260,1564260,165000,16_16_16_16_0_16_0_16_1_16_1_16_16_16_16_16_16_16_1_1_2_2_3_3_3_3_18_18_18_18_18_18_18_18
8771,160,1332932100,18,5,18,1332945960,13860,1399260,1564260,165000,16_16_16_16_0_16_0_16_1_16_1_16_16_16_16_16_16_16_1_1_2_2_3_3_3_3_18_18_18_18_18_18_18_18_18
8772,64,1332932160,4,15,4,1332933180,1020,6832080,6845160,13080,1_1_11_11_5_5_1_1_6_6_1_1_19_19_2_2_3_3_1_1_6_6_4
8773,131,1332932160,3,15,5,1333054800,122640,6672060,6825900,153840,16_16_16_16_16_16_16_16_16_16_16_16_16_16_16_16_16_16_16_16_16_16_16_16_16_16_1_1_1_1_2_2_3_3_3_3_18_18_18_18_18_3_3_3_3_18_18_18_18_18_18_18_18_18_18_18_18_18_18_18_18_18_18_18_5_5_5_5_5_5_5_5_5_5_5_5_6_6_5_5_6_6_5_5_5_5_5_5_5_5_5_5_6_6_5_5_34_34_34_34_3_3_18_18_18_18_18_18_6_6_5_5_34_34_5_5_5_5_5_5_5_5_5_5_6_6_5_5_34_34_34_34_3_3
8774,142,1332932700,5,9,15,1332933120,420,7174260,7299960,125700,0_0_0_0_0_0_0_1_1_0_0_0_0_0_0_0_0_1_1_0_0_0_0_0_0_1_1_0_0_0_0_0_0_1_1_0_0_0_0_0_0_0_1_0_1_0_0_0_1_1_1_1_27_27_27_27_1_27_27_1_27_27_27_27_27_27_27_27_27_27_27_27_27_27_27_27_2_2_2_2_2_2_3_3_3_2_2_3_3_3_2_2_3_3_4_4_15_4_15_4_4_4_4_4_4_4_4_4_4_4_4_4_4_4_4_4_4_4_4_4_4_4_4_4_4_4_4_4_4_4_4_4_15_15_15_15_15_15_5_5_6_6_15_15_5_5_6_6_5_5_15_5_5_15_5_5_15_18_15_18_4_4_5_15_15_5
8775,142,1332933120,15,9,15,1332933180,60,7174680,7299960,125280,0_0_0_0_0_0_0_1_1_0_0_0_0_0_0_0_0_1_1_0_0_0_0_0_0_1_1_0_0_0_0_0_0_1_1_0_0_0_0_0_0_0_1_0_1_0_0_0_1_1_1_1_27_27_27_27_1_27_27_1_27_27_27_27_27_27_27_27_27_27_27_27_27_27_27_27_2_2_2_2_2_2_3_3_3_2_2_3_3_3_2_2_3_3_4_4_15_4_15_4_4_4_4_4_4_4_4_4_4_4_4_4_4_4_4_4_4_4_4_4_4_4_4_4_4_4_4_4_4_4_4_4_15_15_15_15_15_15_5_5_6_6_15_15_5_5_6_6_5_5_15_5_5_15_5_5_15_18_15_18_4_4_5_15_15_5_15
8776,64,1332933180,4,15,5,1332933540,360,6833100,6845160,12060,1_1_11_11_5_5_1_1_6_6_1_1_19_19_2_2_3_3_1_1_6_6_4_4
8777,142,1332933180,5,9,5,1332937680,4500,7174740,7299960,125220,0_0_0_0_0_0_0_1_1_0_0_0_0_0_0_0_0_1_1_0_0_0_0_0_0_1_1_0_0_0_0_0_0_1_1_0_0_0_0_0_0_0_1_0_1_0_0_0_1_1_1_1_27_27_27_27_1_27_27_1_27_27_27_27_27_27_27_27_27_27_27_27_27_27_27_27_2_2_2_2_2_2_3_3_3_2_2_3_3_3_2_2_3_3_4_4_15_4_15_4_4_4_4_4_4_4_4_4_4_4_4_4_4_4_4_4_4_4_4_4_4_4_4_4_4_4_4_4_4_4_4_4_15_15_15_15_15_15_5_5_6_6_15_15_5_5_6_6_5_5_15_5_5_15_5_5_15_18_15_18_4_4_5_15_15_5_15_15_5
8778,13,1332933180,4,15,4,1332939420,6240,2366640,2525940,159300,19_19_19_1_1_19_19_19_19_19_19_19_19_19_19_19_1_1_1_19_1_19_19_19_19_19_19_19_19_19_19_1_19_1_19_19_19_19_19_19_1_1_1_1_19_19_19_19_1_1_1_1_1_1_19_19_1_19_1_19_19_19_19_19_2_2_9_9_2_2_1_9_1_3_1_3_9_1_1_1_19_1_1_19_19_3_19_3_3_3_9_19_9_19_3_3_1_19_1_3_3_19_19_19_19_19_19_19_3_3_2_2_3_3_1_1_4_4_4
8779,142,1332933180,15,9,5,1332933180,0,7174740,7299960,125220,0_0_0_0_0_0_0_1_1_0_0_0_0_0_0_0_0_1_1_0_0_0_0_0_0_1_1_0_0_0_0_0_0_1_1_0_0_0_0_0_0_0_1_0_1_0_0_0_1_1_1_1_27_27_27_27_1_27_27_1_27_27_27_27_27_27_27_27_27_27_27_27_27_27_27_27_2_2_2_2_2_2_3_3_3_2_2_3_3_3_2_2_3_3_4_4_15_4_15_4_4_4_4_4_4_4_4_4_4_4_4_4_4_4_4_4_4_4_4_4_4_4_4_4_4_4_4_4_4_4_4_4_15_15_15_15_15_15_5_5_6_6_15_15_5_5_6_6_5_5_15_5_5_15_5_5_15_18_15_18_4_4_5_15_15_5_15_15
8780,40,1332933300,2,4,2,1332934980,1680,162120,163800,1680,0_0_0_0_0_0_0_0_16_16_1_1_1_1_1_1_2
8781,64,1332933540,5,9,5,1332945240,11700,6833460,6845160,11700,1_1_11_11_5_5_1_1_6_6_1_1_19_19_2_2_3_3_1_1_6_6_4_4_5
8782,40,1332934980,2,4,99,1332934980,0,163800,163800,0,0_0_0_0_0_0_0_0_16_16_1_1_1_1_1_1_2_2
8783,37,1332935280,1,6,16,1332940140,4860,575280,736020,160740,16_16_16_16_16_16_16_16_16_16_16_16_16_16_16_16_16_16_16_16_16_16_16_16_16_16_16_16_16_1_1_16_16_16_16_16_16_16_16_1_1_16_16_16_16_16_16_16_16_16_16_16_16_1_1
8784,223,1332936000,2,21,2,1332937800,1800,18000,84600,66600,1_1_2
8785,142,1332937680,5,9,6,1333054800,117120,7179240,7299960,120720,0_0_0_0_0_0_0_1_1_0_0_0_0_0_0_0_0_1_1_0_0_0_0_0_0_1_1_0_0_0_0_0_0_1_1_0_0_0_0_0_0_0_1_0_1_0_0_0_1_1_1_1_27_27_27_27_1_27_27_1_27_27_27_27_27_27_27_27_27_27_27_27_27_27_27_27_2_2_2_2_2_2_3_3_3_2_2_3_3_3_2_2_3_3_4_4_15_4_15_4_4_4_4_4_4_4_4_4_4_4_4_4_4_4_4_4_4_4_4_4_4_4_4_4_4_4_4_4_4_4_4_4_15_15_15_15_15_15_5_5_6_6_15_15_5_5_6_6_5_5_15_5_5_15_5_5_15_18_15_18_4_4_5_15_15_5_15_15_5_5
8786,223,1332937800,2,21,2,1332995100,57300,19800,84600,64800,1_1_2_2
8787,196,1332937920,7,12,7,1332940440,2520,3137220,3281700,144480,7_7_7_7_7_7_7_7_7_7_7_7_7_7_7_7_7_7_7_7_1_1_1_1_7_7_1_1_7_7_1_1_7_7_7_1_1_7_7_7_7_7_7_7_7_7_1_1_7_7_7_30_30_7_1_7_7_1_7_1_1_7_7_7_1_7_7_1_1_1_7_7_30_30_1_1_10_10_10_1_1_10_10_10_10_1_1_10_10_10_10_8_8_7_10_10_7_10_10_10_10_10_7_7_7_7_7_7_8_8_10_10_7_7_1_30_1_30_8_7_8_11_11_7_10_10_8_10_7_10_8_7_10_10_7_7
8788,57,1332939180,26,33,26,1332960180,21000,2671440,2756640,85200,26_26_26_26_26_26_26_26_26_26_26_26_26_26_26_26_26_26_26_26_26_26_26_26_26_8_8_8_8_2_2_26_8_8_26_26_26_26_26_26_26_26_8_8_26_26_26_26_26_26_8_8_8_8_26_26_26_26_6_6_5_5_26_26_26_26_26_26_26_26_26_26_26_26_26_26
8789,13,1332939420,4,15,4,1332939660,240,2372880,2525940,153060,19_19_19_1_1_19_19_19_19_19_19_19_19_19_19_19_1_1_1_19_1_19_19_19_19_19_19_19_19_19_19_1_19_1_19_19_19_19_19_19_1_1_1_1_19_19_19_19_1_1_1_1_1_1_19_19_1_19_1_19_19_19_19_19_2_2_9_9_2_2_1_9_1_3_1_3_9_1_1_1_19_1_1_19_19_3_19_3_3_3_9_19_9_19_3_3_1_19_1_3_3_19_19_19_19_19_19_19_3_3_2_2_3_3_1_1_4_4_4_4
8790,13,1332939660,4,17,4,1332954540,14880,2373120,2525940,152820,19_19_19_1_1_19_19_19_19_19_19_19_19_19_19_19_1_1_1_19_1_19_19_19_19_19_19_19_19_19_19_1_19_1_19_19_19_19_19_19_1_1_1_1_19_19_19_19_1_1_1_1_1_1_19_19_1_19_1_19_19_19_19_19_2_2_9_9_2_2_1_9_1_3_1_3_9_1_1_1_19_1_1_19_19_3_19_3_3_3_9_19_9_19_3_3_1_19_1_3_3_19_19_19_19_19_19_19_3_3_2_2_3_3_1_1_4_4_4_4_4
8791,39,1332940140,0,1,1,1333094100,153960,78480,235740,157260,0_0_0_0_0_0
8792,37,1332940140,16,1,16,1332940380,240,580140,736020,155880,16_16_16_16_16_16_16_16_16_16_16_16_16_16_16_16_16_16_16_16_16_16_16_16_16_16_16_16_16_1_1_16_16_16_16_16_16_16_16_1_1_16_16_16_16_16_16_16_16_16_16_16_16_1_1_16
8793,37,1332940380,16,20,16,1332967200,26820,580380,736020,155640,16_16_16_16_16_16_16_16_16_16_16_16_16_16_16_16_16_16_16_16_16_16_16_16_16_16_16_16_16_1_1_16_16_16_16_16_16_16_16_1_1_16_16_16_16_16_16_16_16_16_16_16_16_1_1_16_16
8794,196,1332940440,7,8,10,1332950160,9720,3139740,3281700,141960,7_7_7_7_7_7_7_7_7_7_7_7_7_7_7_7_7_7_7_7_1_1_1_1_7_7_1_1_7_7_1_1_7_7_7_1_1_7_7_7_7_7_7_7_7_7_1_1_7_7_7_30_30_7_1_7_7_1_7_1_1_7_7_7_1_7_7_1_1_1_7_7_30_30_1_1_10_10_10_1_1_10_10_10_10_1_1_10_10_10_10_8_8_7_10_10_7_10_10_10_10_10_7_7_7_7_7_7_8_8_10_10_7_7_1_30_1_30_8_7_8_11_11_7_10_10_8_10_7_10_8_7_10_10_7_7_7
8795,204,1332944160,3,3,18,1332965220,21060,2411100,2567700,156600,16_16_16_16_16_16_16_16_16_16_16_16_16_16_16_16_16_16_16_16_16_16_1_1_1_1_1_16_1_2_2_16_16_16_16_16_16_16_16_16_16_1_16_1_16_16_16_16_16_16_1_1_16_16_16_16_16_16_2_16_2_16_1_1_1_1_1_2_2_2_2_1_1_1_1_1_3_3_3_3
8796,64,1332945240,5,9,99,1332945240,0,6845160,6845160,0,1_1_11_11_5_5_1_1_6_6_1_1_19_19_2_2_3_3_1_1_6_6_4_4_5_5
8797,224,1332945300,5,9,5,1332946740,1440,534960,648060,113100,1_1_1_1_1_1_3_3_2_2_3_3_5
8798,22,1332945420,17,10,17,1332958440,13020,725100,810360,85260,17_17_17_17_17_17_17_17_17_17_17_17_17_17_17_17_17_17
8799,160,1332945960,18,5,18,1332955080,9120,1413120,1564260,151140,16_16_16_16_0_16_0_16_1_16_1_16_16_16_16_16_16_16_1_1_2_2_3_3_3_3_18_18_18_18_18_18_18_18_18_18
8800,224,1332946740,5,9,5,1332997200,50460,536400,648060,111660,1_1_1_1_1_1_3_3_2_2_3_3_5_5
8801,219,1332946860,15,2,6,1332968400,21540,3663600,3797940,134340,26_26_26_26_26_26_26_26_26_26_8_8_38_38_17_17_17_17_17_17_17_1_17_1_1_1_17_17_1_1_17_17_1_17_1_17_1_1_3_25_3_25_18_18_18_18_18_18_18_18_18_18_15_15_15_15_15_15_3_3_18_18_18_18_18_18_18_18_15_15_15_15
8802,65,1332946920,5,18,5,1333011600,64680,7405320,7544400,139080,17_17_34_34_6_6_6_6_5_5_1_1_1_1_2_2_3_3_5_5_5_5_3_3_18_18_18_18_18_18_18_18_18_18_5_5
8803,196,1332950160,10,13,7,1332971640,21480,3149460,3281700,132240,7_7_7_7_7_7_7_7_7_7_7_7_7_7_7_7_7_7_7_7_1_1_1_1_7_7_1_1_7_7_1_1_7_7_7_1_1_7_7_7_7_7_7_7_7_7_1_1_7_7_7_30_30_7_1_7_7_1_7_1_1_7_7_7_1_7_7_1_1_1_7_7_30_30_1_1_10_10_10_1_1_10_10_10_10_1_1_10_10_10_10_8_8_7_10_10_7_10_10_10_10_10_7_7_7_7_7_7_8_8_10_10_7_7_1_30_1_30_8_7_8_11_11_7_10_10_8_10_7_10_8_7_10_10_7_7_7_10
8804,35,1332954240,0,0,0,1332985380,31140,72240,144180,71940,0_0_0
8805,13,1332954540,4,22,4,1332954720,180,2388000,2525940,137940,19_19_19_1_1_19_19_19_19_19_19_19_19_19_19_19_1_1_1_19_1_19_19_19_19_19_19_19_19_19_19_1_19_1_19_19_19_19_19_19_1_1_1_1_19_19_19_19_1_1_1_1_1_1_19_19_1_19_1_19_19_19_19_19_2_2_9_9_2_2_1_9_1_3_1_3_9_1_1_1_19_1_1_19_19_3_19_3_3_3_9_19_9_19_3_3_1_19_1_3_3_19_19_19_19_19_19_19_3_3_2_2_3_3_1_1_4_4_4_4_4_4
8806,21,1332954600,19,11,19,1332961860,7260,328200,470460,142260,19_19_19
8807,13,1332954720,4,17,6,1332968400,13680,2388180,2525940,137760,19_19_19_1_1_19_19_19_19_19_19_19_19_19_19_19_1_1_1_19_1_19_19_19_19_19_19_19_19_19_19_1_19_1_19_19_19_19_19_19_1_1_1_1_19_19_19_19_1_1_1_1_1_1_19_19_1_19_1_19_19_19_19_19_2_2_9_9_2_2_1_9_1_3_1_3_9_1_1_1_19_1_1_19_19_3_19_3_3_3_9_19_9_19_3_3_1_19_1_3_3_19_19_19_19_19_19_19_3_3_2_2_3_3_1_1_4_4_4_4_4_4_4
8808,76,1332954720,34,17,34,1332966780,12060,7413120,7552500,139380,3_3_3_3_3_3_3_3_3_18_3_18_18_18_18_18_3_3_3_1_1_3_17_17_17_18_17_17_18_18_18_18_18_17_17_18_3_3_18_17_18_18_17_18_18_17_17_17_5_5_5_5_1_1_17_17_17_2_2_17_17_17_5_5_5_5_5_5_17_17_5_5_5_17_5_5_5_5_5_17_17_17_1_1_1_1_1_1_1_1_2_2_34_34_5_5_5_5_6_6_3_3_4_3_3_4_4_4_4_4_3_3_3_3_3_3_4_3_3_3_3_4_4_4_3_4_4_4_3_4_4_4_3_3_4_4_4_4_5_3_3_5_5_5_5_5_4_5_4_5_4_3_3_3_3_4_3_3_4_4_5_5_5_4_5_5_5_4_6_6_34_34_5_5_34_34_34_34_5_5_5_5_6_6_5_5_5_5_34_34_6_6_6_6_6_6_34
8809,160,1332955080,18,23,18,1332962580,7500,1422240,1564260,142020,16_16_16_16_0_16_0_16_1_16_1_16_16_16_16_16_16_16_1_1_2_2_3_3_3_3_18_18_18_18_18_18_18_18_18_18_18
8810,22,1332958440,17,11,17,1332992520,34080,738120,810360,72240,17_17_17_17_17_17_17_17_17_17_17_17_17_17_17_17_17_17_17
8811,57,1332960180,26,32,26,1332988440,28260,2692440,2756640,64200,26_26_26_26_26_26_26_26_26_26_26_26_26_26_26_26_26_26_26_26_26_26_26_26_26_8_8_8_8_2_2_26_8_8_26_26_26_26_26_26_26_26_8_8_26_26_26_26_26_26_8_8_8_8_26_26_26_26_6_6_5_5_26_26_26_26_26_26_26_26_26_26_26_26_26_26_26
8812,21,1332961860,19,11,19,1332961920,60,335460,470460,135000,19_19_19_19
8813,21,1332961920,19,11,19,1332973740,11820,335520,470460,134940,19_19_19_19_19
8814,160,1332962580,18,23,18,1332962640,60,1429740,1564260,134520,16_16_16_16_0_16_0_16_1_16_1_16_16_16_16_16_16_16_1_1_2_2_3_3_3_3_18_18_18_18_18_18_18_18_18_18_18_18
8815,160,1332962640,18,23,18,1332965220,2580,1429800,1564260,134460,16_16_16_16_0_16_0_16_1_16_1_16_16_16_16_16_16_16_1_1_2_2_3_3_3_3_18_18_18_18_18_18_18_18_18_18_18_18_18
8816,204,1332965220,18,23,18,1332972480,7260,2432160,2567700,135540,16_16_16_16_16_16_16_16_16_16_16_16_16_16_16_16_16_16_16_16_16_16_1_1_1_1_1_16_1_2_2_16_16_16_16_16_16_16_16_16_16_1_16_1_16_16_16_16_16_16_1_1_16_16_16_16_16_16_2_16_2_16_1_1_1_1_1_2_2_2_2_1_1_1_1_1_3_3_3_3_18
8817,160,1332965220,18,23,18,1333044540,79320,1432380,1564260,131880,16_16_16_16_0_16_0_16_1_16_1_16_16_16_16_16_16_16_1_1_2_2_3_3_3_3_18_18_18_18_18_18_18_18_18_18_18_18_18_18
8818,76,1332966780,34,17,6,1332968400,1620,7425180,7552500,127320,3_3_3_3_3_3_3_3_3_18_3_18_18_18_18_18_3_3_3_1_1_3_17_17_17_18_17_17_18_18_18_18_18_17_17_18_3_3_18_17_18_18_17_18_18_17_17_17_5_5_5_5_1_1_17_17_17_2_2_17_17_17_5_5_5_5_5_5_17_17_5_5_5_17_5_5_5_5_5_17_17_17_1_1_1_1_1_1_1_1_2_2_34_34_5_5_5_5_6_6_3_3_4_3_3_4_4_4_4_4_3_3_3_3_3_3_4_3_3_3_3_4_4_4_3_4_4_4_3_4_4_4_3_3_4_4_4_4_5_3_3_5_5_5_5_5_4_5_4_5_4_3_3_3_3_4_3_3_4_4_5_5_5_4_5_5_5_4_6_6_34_34_5_5_34_34_34_34_5_5_5_5_6_6_5_5_5_5_34_34_6_6_6_6_6_6_34_34
8819,37,1332967200,16,20,16,1332968040,840,607200,736020,128820,16_16_16_16_16_16_16_16_16_16_16_16_16_16_16_16_16_16_16_16_16_16_16_16_16_16_16_16_16_1_1_16_16_16_16_16_16_16_16_1_1_16_16_16_16_16_16_16_16_16_16_16_16_1_1_16_16_16
8820,37,1332968040,16,0,16,1332992460,24420,608040,736020,127980,16_16_16_16_16_16_16_16_16_16_16_16_16_16_16_16_16_16_16_16_16_16_16_16_16_16_16_16_16_1_1_16_16_16_16_16_16_16_16_1_1_16_16_16_16_16_16_16_16_16_16_16_16_1_1_16_16_16_16
8821,188,1332968400,6,30,6,1332972000,3600,4296360,4327560,31200,0_0_0_0_0_1_1_0_0_0_0_0_0_0_0_0_1_1_2_2_2_2_3_3_3_3_21_21_3_3_3_3_3_3_3_3_18_18_18_18_18_18_18_18_18_18_18_18_18_18_18_18_18_18_1_1_18_18_18_18_1_1_18_3_18_18_3_18_18_18_18_18_18_18_18_18_18_18_18_18_18_18_5_5_5_5_5_5_5_5_5_11_5_11_5_5_5_5_5_5_5_5_6
8822,219,1332968400,6,30,6,1332972000,3600,3685140,3797940,112800,26_26_26_26_26_26_26_26_26_26_8_8_38_38_17_17_17_17_17_17_17_1_17_1_1_1_17_17_1_1_17_17_1_17_1_17_1_1_3_25_3_25_18_18_18_18_18_18_18_18_18_18_15_15_15_15_15_15_3_3_18_18_18_18_18_18_18_18_15_15_15_15_6
8823,152,1332968400,6,7,6,1332972000,3600,3720960,3766500,45540,17_17_17_17_17_17_17_17_17_17_17_17_1_1_2_2_17_17_17_17_3_3_3_3_3_3_18_18_18_18_18_18_18_18_18_18_18_18_18_18_5_5_6
8824,133,1332968400,6,7,6,1332972000,3600,6177600,6181200,3600,17_17_17_17_17_17_17_17_17_17_17_17_17_17_17_17_17_17_17_17_17_17_17_17_17_17_17_17_17_17_1_1_17_17_17_17_1_1_1_1_17_17_17_17_17_17_17_17_17_17_17_17_17_17_17_17_17_17_17_17_17_17_19_19_17_17_2_2_3_3_3_3_3_3_5_5_6_6_17_17_17_17_3_3_1_2_2_2_1_2_3_3_2_3_3_2_5_5_6
8825,221,1332968400,6,7,6,1332972000,3600,903600,934800,31200,1_1_1_1_3_3_3_2_3_3_2_3_6_6
8826,13,1332968400,6,7,6,1332972000,3600,2401860,2525940,124080,19_19_19_1_1_19_19_19_19_19_19_19_19_19_19_19_1_1_1_19_1_19_19_19_19_19_19_19_19_19_19_1_19_1_19_19_19_19_19_19_1_1_1_1_19_19_19_19_1_1_1_1_1_1_19_19_1_19_1_19_19_19_19_19_2_2_9_9_2_2_1_9_1_3_1_3_9_1_1_1_19_1_1_19_19_3_19_3_3_3_9_19_9_19_3_3_1_19_1_3_3_19_19_19_19_19_19_19_3_3_2_2_3_3_1_1_4_4_4_4_4_4_4_6_6
8827,13,1332968400,6,7,6,1332968400,0,2401860,2525940,124080,19_19_19_1_1_19_19_19_19_19_19_19_19_19_19_19_1_1_1_19_1_19_19_19_19_19_19_19_19_19_19_1_19_1_19_19_19_19_19_19_1_1_1_1_19_19_19_19_1_1_1_1_1_1_19_19_1_19_1_19_19_19_19_19_2_2_9_9_2_2_1_9_1_3_1_3_9_1_1_1_19_1_1_19_19_3_19_3_3_3_9_19_9_19_3_3_1_19_1_3_3_19_19_19_19_19_19_19_3_3_2_2_3_3_1_1_4_4_4_4_4_4_4_6
8828,221,1332968400,6,30,6,1332968400,0,903600,934800,31200,1_1_1_1_3_3_3_2_3_3_2_3_6
8829,76,1332968400,6,30,6,1332972000,3600,7426800,7552500,125700,3_3_3_3_3_3_3_3_3_18_3_18_18_18_18_18_3_3_3_1_1_3_17_17_17_18_17_17_18_18_18_18_18_17_17_18_3_3_18_17_18_18_17_18_18_17_17_17_5_5_5_5_1_1_17_17_17_2_2_17_17_17_5_5_5_5_5_5_17_17_5_5_5_17_5_5_5_5_5_17_17_17_1_1_1_1_1_1_1_1_2_2_34_34_5_5_5_5_6_6_3_3_4_3_3_4_4_4_4_4_3_3_3_3_3_3_4_3_3_3_3_4_4_4_3_4_4_4_3_4_4_4_3_3_4_4_4_4_5_3_3_5_5_5_5_5_4_5_4_5_4_3_3_3_3_4_3_3_4_4_5_5_5_4_5_5_5_4_6_6_34_34_5_5_34_34_34_34_5_5_5_5_6_6_5_5_5_5_34_34_6_6_6_6_6_6_34_34_6
8830,15,1332968400,6,7,6,1332972000,3600,1788420,1822860,34440,7_7_7_7_7_7_1_7_1_7_7_7_7_7_7_7_7_7_7_7_7_7_7_7_1_1_1_1_2_2_3_3_17_17_17_17_17_17_17_17_17_17_17_5_5_5_5_17_17_6_6_6_6_17_1_1_2_2_17_17_17_17_21_21_21_3_21_3_5_5_6
8831,206,1332968400,3,4,3,1332972900,4500,1910340,2086740,176400,16_16_16_16_1_1_2_2_3
8832,186,1332968400,2,4,2,1332972900,4500,3582780,3636240,53460,7_7_7_7_7_7_7_7_7_1_7_1_7_7_7_1_7_7_1_7_7_7_7_7_7_1_7_1_1_1_38_38_1_1_24_24_24_24_24_8_24_24_8_24_24_24_24_24_8_8_2
8833,196,1332971640,7,8,10,1332976980,5340,3170940,3281700,110760,7_7_7_7_7_7_7_7_7_7_7_7_7_7_7_7_7_7_7_7_1_1_1_1_7_7_1_1_7_7_1_1_7_7_7_1_1_7_7_7_7_7_7_7_7_7_1_1_7_7_7_30_30_7_1_7_7_1_7_1_1_7_7_7_1_7_7_1_1_1_7_7_30_30_1_1_10_10_10_1_1_10_10_10_10_1_1_10_10_10_10_8_8_7_10_10_7_10_10_10_10_10_7_7_7_7_7_7_8_8_10_10_7_7_1_30_1_30_8_7_8_11_11_7_10_10_8_10_7_10_8_7_10_10_7_7_7_10_7
8834,15,1332972000,6,7,5,1333000800,28800,1792020,1822860,30840,7_7_7_7_7_7_1_7_1_7_7_7_7_7_7_7_7_7_7_7_7_7_7_7_1_1_1_1_2_2_3_3_17_17_17_17_17_17_17_17_17_17_17_5_5_5_5_17_17_6_6_6_6_17_1_1_2_2_17_17_17_17_21_21_21_3_21_3_5_5_6_6
8835,219,1332972000,6,30,5,1333000800,28800,3688740,3797940,109200,26_26_26_26_26_26_26_26_26_26_8_8_38_38_17_17_17_17_17_17_17_1_17_1_1_1_17_17_1_1_17_17_1_17_1_17_1_1_3_25_3_25_18_18_18_18_18_18_18_18_18_18_15_15_15_15_15_15_3_3_18_18_18_18_18_18_18_18_15_15_15_15_6_6
8836,133,1332972000,6,7,99,1332972000,0,6181200,6181200,0,17_17_17_17_17_17_17_17_17_17_17_17_17_17_17_17_17_17_17_17_17_17_17_17_17_17_17_17_17_17_1_1_17_17_17_17_1_1_1_1_17_17_17_17_17_17_17_17_17_17_17_17_17_17_17_17_17_17_17_17_17_17_19_19_17_17_2_2_3_3_3_3_3_3_5_5_6_6_17_17_17_17_3_3_1_2_2_2_1_2_3_3_2_3_3_2_5_5_6_6
8837,13,1332972000,6,7,6,1332972000,0,2405460,2525940,120480,19_19_19_1_1_19_19_19_19_19_19_19_19_19_19_19_1_1_1_19_1_19_19_19_19_19_19_19_19_19_19_1_19_1_19_19_19_19_19_19_1_1_1_1_19_19_19_19_1_1_1_1_1_1_19_19_1_19_1_19_19_19_19_19_2_2_9_9_2_2_1_9_1_3_1_3_9_1_1_1_19_1_1_19_19_3_19_3_3_3_9_19_9_19_3_3_1_19_1_3_3_19_19_19_19_19_19_19_3_3_2_2_3_3_1_1_4_4_4_4_4_4_4_6_6_6
8838,13,1332972000,6,7,4,1332987960,15960,2405460,2525940,120480,19_19_19_1_1_19_19_19_19_19_19_19_19_19_19_19_1_1_1_19_1_19_19_19_19_19_19_19_19_19_19_1_19_1_19_19_19_19_19_19_1_1_1_1_19_19_19_19_1_1_1_1_1_1_19_19_1_19_1_19_19_19_19_19_2_2_9_9_2_2_1_9_1_3_1_3_9_1_1_1_19_1_1_19_19_3_19_3_3_3_9_19_9_19_3_3_1_19_1_3_3_19_19_19_19_19_19_19_3_3_2_2_3_3_1_1_4_4_4_4_4_4_4_6_6_6_6
8839,221,1332972000,6,30,6,1332972000,0,907200,934800,27600,1_1_1_1_3_3_3_2_3_3_2_3_6_6_6
8840,221,1332972000,6,7,5,1332993600,21600,907200,934800,27600,1_1_1_1_3_3_3_2_3_3_2_3_6_6_6_6
8841,188,1332972000,6,30,5,1332993600,21600,4299960,4327560,27600,0_0_0_0_0_1_1_0_0_0_0_0_0_0_0_0_1_1_2_2_2_2_3_3_3_3_21_21_3_3_3_3_3_3_3_3_18_18_18_18_18_18_18_18_18_18_18_18_18_18_18_18_18_18_1_1_18_18_18_18_1_1_18_3_18_18_3_18_18_18_18_18_18_18_18_18_18_18_18_18_18_18_5_5_5_5_5_5_5_5_5_11_5_11_5_5_5_5_5_5_5_5_6_6
8842,76,1332972000,6,30,5,1332995640,23640,7430400,7552500,122100,3_3_3_3_3_3_3_3_3_18_3_18_18_18_18_18_3_3_3_1_1_3_17_17_17_18_17_17_18_18_18_18_18_17_17_18_3_3_18_17_18_18_17_18_18_17_17_17_5_5_5_5_1_1_17_17_17_2_2_17_17_17_5_5_5_5_5_5_17_17_5_5_5_17_5_5_5_5_5_17_17_17_1_1_1_1_1_1_1_1_2_2_34_34_5_5_5_5_6_6_3_3_4_3_3_4_4_4_4_4_3_3_3_3_3_3_4_3_3_3_3_4_4_4_3_4_4_4_3_4_4_4_3_3_4_4_4_4_5_3_3_5_5_5_5_5_4_5_4_5_4_3_3_3_3_4_3_3_4_4_5_5_5_4_5_5_5_4_6_6_34_34_5_5_34_34_34_34_5_5_5_5_6_6_5_5_5_5_34_34_6_6_6_6_6_6_34_34_6_6
8843,152,1332972000,6,7,5,1333009440,37440,3724560,3766500,41940,17_17_17_17_17_17_17_17_17_17_17_17_1_1_2_2_17_17_17_17_3_3_3_3_3_3_18_18_18_18_18_18_18_18_18_18_18_18_18_18_5_5_6_6
8844,204,1332972480,18,23,18,1332972540,60,2439420,2567700,128280,16_16_16_16_16_16_16_16_16_16_16_16_16_16_16_16_16_16_16_16_16_16_1_1_1_1_1_16_1_2_2_16_16_16_16_16_16_16_16_16_16_1_16_1_16_16_16_16_16_16_1_1_16_16_16_16_16_16_2_16_2_16_1_1_1_1_1_2_2_2_2_1_1_1_1_1_3_3_3_3_18_18
8845,204,1332972540,18,23,18,1332993000,20460,2439480,2567700,128220,16_16_16_16_16_16_16_16_16_16_16_16_16_16_16_16_16_16_16_16_16_16_1_1_1_1_1_16_1_2_2_16_16_16_16_16_16_16_16_16_16_1_16_1_16_16_16_16_16_16_1_1_16_16_16_16_16_16_2_16_2_16_1_1_1_1_1_2_2_2_2_1_1_1_1_1_3_3_3_3_18_18_18
8846,186,1332972900,2,4,2,1333018200,45300,3587280,3636240,48960,7_7_7_7_7_7_7_7_7_1_7_1_7_7_7_1_7_7_1_7_7_7_7_7_7_1_7_1_1_1_38_38_1_1_24_24_24_24_24_8_24_24_8_24_24_24_24_24_8_8_2_2
8847,206,1332972900,3,4,3,1333020720,47820,1914840,2086740,171900,16_16_16_16_1_1_2_2_3_3
8848,21,1332973740,19,11,1,1333091880,118140,347340,470460,123120,19_19_19_19_19_19
8849,29,1332973800,19,11,19,1332992520,18720,0,57540,57540,19
8850,196,1332976980,10,13,10,1332993600,16620,3176280,3281700,105420,7_7_7_7_7_7_7_7_7_7_7_7_7_7_7_7_7_7_7_7_1_1_1_1_7_7_1_1_7_7_1_1_7_7_7_1_1_7_7_7_7_7_7_7_7_7_1_1_7_7_7_30_30_7_1_7_7_1_7_1_1_7_7_7_1_7_7_1_1_1_7_7_30_30_1_1_10_10_10_1_1_10_10_10_10_1_1_10_10_10_10_8_8_7_10_10_7_10_10_10_10_10_7_7_7_7_7_7_8_8_10_10_7_7_1_30_1_30_8_7_8_11_11_7_10_10_8_10_7_10_8_7_10_10_7_7_7_10_7_10
8851,35,1332985380,0,0,0,1332985440,60,103380,144180,40800,0_0_0_0
8852,35,1332985440,0,0,0,1332992400,6960,103440,144180,40740,0_0_0_0_0
8853,13,1332987960,4,22,4,1332988200,240,2421420,2525940,104520,19_19_19_1_1_19_19_19_19_19_19_19_19_19_19_19_1_1_1_19_1_19_19_19_19_19_19_19_19_19_19_1_19_1_19_19_19_19_19_19_1_1_1_1_19_19_19_19_1_1_1_1_1_1_19_19_1_19_1_19_19_19_19_19_2_2_9_9_2_2_1_9_1_3_1_3_9_1_1_1_19_1_1_19_19_3_19_3_3_3_9_19_9_19_3_3_1_19_1_3_3_19_19_19_19_19_19_19_3_3_2_2_3_3_1_1_4_4_4_4_4_4_4_6_6_6_6_4
8854,13,1332988200,4,5,4,1332993000,4800,2421660,2525940,104280,19_19_19_1_1_19_19_19_19_19_19_19_19_19_19_19_1_1_1_19_1_19_19_19_19_19_19_19_19_19_19_1_19_1_19_19_19_19_19_19_1_1_1_1_19_19_19_19_1_1_1_1_1_1_19_19_1_19_1_19_19_19_19_19_2_2_9_9_2_2_1_9_1_3_1_3_9_1_1_1_19_1_1_19_19_3_19_3_3_3_9_19_9_19_3_3_1_19_1_3_3_19_19_19_19_19_19_19_3_3_2_2_3_3_1_1_4_4_4_4_4_4_4_6_6_6_6_4_4
8855,57,1332988440,26,32,26,1332994260,5820,2720700,2756640,35940,26_26_26_26_26_26_26_26_26_26_26_26_26_26_26_26_26_26_26_26_26_26_26_26_26_8_8_8_8_2_2_26_8_8_26_26_26_26_26_26_26_26_8_8_26_26_26_26_26_26_8_8_8_8_26_26_26_26_6_6_5_5_26_26_26_26_26_26_26_26_26_26_26_26_26_26_26_26
8856,35,1332992400,0,0,0,1332992700,300,110400,144180,33780,0_0_0_0_0_0
8857,37,1332992460,16,0,16,1332992700,240,632460,736020,103560,16_16_16_16_16_16_16_16_16_16_16_16_16_16_16_16_16_16_16_16_16_16_16_16_16_16_16_16_16_1_1_16_16_16_16_16_16_16_16_1_1_16_16_16_16_16_16_16_16_16_16_16_16_1_1_16_16_16_16_16
8858,22,1332992520,17,11,17,1332994680,2160,772200,810360,38160,17_17_17_17_17_17_17_17_17_17_17_17_17_17_17_17_17_17_17_17
8859,29,1332992520,19,11,19,1332995160,2640,18720,57540,38820,19_19
8860,35,1332992700,0,1,0,1333026180,33480,110700,144180,33480,0_0_0_0_0_0_0
8861,37,1332992700,16,1,1,1333011840,19140,632700,736020,103320,16_16_16_16_16_16_16_16_16_16_16_16_16_16_16_16_16_16_16_16_16_16_16_16_16_16_16_16_16_1_1_16_16_16_16_16_16_16_16_1_1_16_16_16_16_16_16_16_16_16_16_16_16_1_1_16_16_16_16_16_16
8862,204,1332993000,18,23,18,1332993720,720,2459940,2567700,107760,16_16_16_16_16_16_16_16_16_16_16_16_16_16_16_16_16_16_16_16_16_16_1_1_1_1_1_16_1_2_2_16_16_16_16_16_16_16_16_16_16_1_16_1_16_16_16_16_16_16_1_1_16_16_16_16_16_16_2_16_2_16_1_1_1_1_1_2_2_2_2_1_1_1_1_1_3_3_3_3_18_18_18_18
8863,13,1332993000,4,5,4,1332993540,540,2426460,2525940,99480,19_19_19_1_1_19_19_19_19_19_19_19_19_19_19_19_1_1_1_19_1_19_19_19_19_19_19_19_19_19_19_1_19_1_19_19_19_19_19_19_1_1_1_1_19_19_19_19_1_1_1_1_1_1_19_19_1_19_1_19_19_19_19_19_2_2_9_9_2_2_1_9_1_3_1_3_9_1_1_1_19_1_1_19_19_3_19_3_3_3_9_19_9_19_3_3_1_19_1_3_3_19_19_19_19_19_19_19_3_3_2_2_3_3_1_1_4_4_4_4_4_4_4_6_6_6_6_4_4_4
8864,13,1332993540,4,15,9,1332998340,4800,2427000,2525940,98940,19_19_19_1_1_19_19_19_19_19_19_19_19_19_19_19_1_1_1_19_1_19_19_19_19_19_19_19_19_19_19_1_19_1_19_19_19_19_19_19_1_1_1_1_19_19_19_19_1_1_1_1_1_1_19_19_1_19_1_19_19_19_19_19_2_2_9_9_2_2_1_9_1_3_1_3_9_1_1_1_19_1_1_19_19_3_19_3_3_3_9_19_9_19_3_3_1_19_1_3_3_19_19_19_19_19_19_19_3_3_2_2_3_3_1_1_4_4_4_4_4_4_4_6_6_6_6_4_4_4_4
8865,221,1332993600,5,18,5,1332999600,6000,928800,934800,6000,1_1_1_1_3_3_3_2_3_3_2_3_6_6_6_6_5
8866,196,1332993600,10,16,7,1332994560,960,3192900,3281700,88800,7_7_7_7_7_7_7_7_7_7_7_7_7_7_7_7_7_7_7_7_1_1_1_1_7_7_1_1_7_7_1_1_7_7_7_1_1_7_7_7_7_7_7_7_7_7_1_1_7_7_7_30_30_7_1_7_7_1_7_1_1_7_7_7_1_7_7_1_1_1_7_7_30_30_1_1_10_10_10_1_1_10_10_10_10_1_1_10_10_10_10_8_8_7_10_10_7_10_10_10_10_10_7_7_7_7_7_7_8_8_10_10_7_7_1_30_1_30_8_7_8_11_11_7_10_10_8_10_7_10_8_7_10_10_7_7_7_10_7_10_10
8867,188,1332993600,5,2,5,1332999600,6000,4321560,4327560,6000,0_0_0_0_0_1_1_0_0_0_0_0_0_0_0_0_1_1_2_2_2_2_3_3_3_3_21_21_3_3_3_3_3_3_3_3_18_18_18_18_18_18_18_18_18_18_18_18_18_18_18_18_18_18_1_1_18_18_18_18_1_1_18_3_18_18_3_18_18_18_18_18_18_18_18_18_18_18_18_18_18_18_5_5_5_5_5_5_5_5_5_11_5_11_5_5_5_5_5_5_5_5_6_6_5
8868,204,1332993720,18,5,18,1333006620,12900,2460660,2567700,107040,16_16_16_16_16_16_16_16_16_16_16_16_16_16_16_16_16_16_16_16_16_16_1_1_1_1_1_16_1_2_2_16_16_16_16_16_16_16_16_16_16_1_16_1_16_16_16_16_16_16_1_1_16_16_16_16_16_16_2_16_2_16_1_1_1_1_1_2_2_2_2_1_1_1_1_1_3_3_3_3_18_18_18_18_18
8869,57,1332994260,26,33,26,1333024380,30120,2726520,2756640,30120,26_26_26_26_26_26_26_26_26_26_26_26_26_26_26_26_26_26_26_26_26_26_26_26_26_8_8_8_8_2_2_26_8_8_26_26_26_26_26_26_26_26_8_8_26_26_26_26_26_26_8_8_8_8_26_26_26_26_6_6_5_5_26_26_26_26_26_26_26_26_26_26_26_26_26_26_26_26_26
8870,196,1332994560,7,12,7,1332998460,3900,3193860,3281700,87840,7_7_7_7_7_7_7_7_7_7_7_7_7_7_7_7_7_7_7_7_1_1_1_1_7_7_1_1_7_7_1_1_7_7_7_1_1_7_7_7_7_7_7_7_7_7_1_1_7_7_7_30_30_7_1_7_7_1_7_1_1_7_7_7_1_7_7_1_1_1_7_7_30_30_1_1_10_10_10_1_1_10_10_10_10_1_1_10_10_10_10_8_8_7_10_10_7_10_10_10_10_10_7_7_7_7_7_7_8_8_10_10_7_7_1_30_1_30_8_7_8_11_11_7_10_10_8_10_7_10_8_7_10_10_7_7_7_10_7_10_10_7
8871,22,1332994680,17,10,17,1333030680,36000,774360,810360,36000,17_17_17_17_17_17_17_17_17_17_17_17_17_17_17_17_17_17_17_17_17
8872,223,1332995100,2,4,2,1332998400,3300,77100,84600,7500,1_1_2_2_2
8873,29,1332995160,19,1,19,1333016520,21360,21360,57540,36180,19_19_19
8874,76,1332995640,5,6,5,1333006440,10800,7454040,7552500,98460,3_3_3_3_3_3_3_3_3_18_3_18_18_18_18_18_3_3_3_1_1_3_17_17_17_18_17_17_18_18_18_18_18_17_17_18_3_3_18_17_18_18_17_18_18_17_17_17_5_5_5_5_1_1_17_17_17_2_2_17_17_17_5_5_5_5_5_5_17_17_5_5_5_17_5_5_5_5_5_17_17_17_1_1_1_1_1_1_1_1_2_2_34_34_5_5_5_5_6_6_3_3_4_3_3_4_4_4_4_4_3_3_3_3_3_3_4_3_3_3_3_4_4_4_3_4_4_4_3_4_4_4_3_3_4_4_4_4_5_3_3_5_5_5_5_5_4_5_4_5_4_3_3_3_3_4_3_3_4_4_5_5_5_4_5_5_5_4_6_6_34_34_5_5_34_34_34_34_5_5_5_5_6_6_5_5_5_5_34_34_6_6_6_6_6_6_34_34_6_6_5
8875,224,1332997200,5,9,5,1333011240,14040,586860,648060,61200,1_1_1_1_1_1_3_3_2_2_3_3_5_5_5
8876,13,1332998340,9,3,9,1332998400,60,2431800,2525940,94140,19_19_19_1_1_19_19_19_19_19_19_19_19_19_19_19_1_1_1_19_1_19_19_19_19_19_19_19_19_19_19_1_19_1_19_19_19_19_19_19_1_1_1_1_19_19_19_19_1_1_1_1_1_1_19_19_1_19_1_19_19_19_19_19_2_2_9_9_2_2_1_9_1_3_1_3_9_1_1_1_19_1_1_19_19_3_19_3_3_3_9_19_9_19_3_3_1_19_1_3_3_19_19_19_19_19_19_19_3_3_2_2_3_3_1_1_4_4_4_4_4_4_4_6_6_6_6_4_4_4_4_9
8877,13,1332998400,9,3,3,1332998460,60,2431860,2525940,94080,19_19_19_1_1_19_19_19_19_19_19_19_19_19_19_19_1_1_1_19_1_19_19_19_19_19_19_19_19_19_19_1_19_1_19_19_19_19_19_19_1_1_1_1_19_19_19_19_1_1_1_1_1_1_19_19_1_19_1_19_19_19_19_19_2_2_9_9_2_2_1_9_1_3_1_3_9_1_1_1_19_1_1_19_19_3_19_3_3_3_9_19_9_19_3_3_1_19_1_3_3_19_19_19_19_19_19_19_3_3_2_2_3_3_1_1_4_4_4_4_4_4_4_6_6_6_6_4_4_4_4_9_9
8878,223,1332998400,2,4,2,1333000800,2400,80400,84600,4200,1_1_2_2_2_2
8879,13,1332998460,3,3,5,1333002000,3540,2431920,2525940,94020,19_19_19_1_1_19_19_19_19_19_19_19_19_19_19_19_1_1_1_19_1_19_19_19_19_19_19_19_19_19_19_1_19_1_19_19_19_19_19_19_1_1_1_1_19_19_19_19_1_1_1_1_1_1_19_19_1_19_1_19_19_19_19_19_2_2_9_9_2_2_1_9_1_3_1_3_9_1_1_1_19_1_1_19_19_3_19_3_3_3_9_19_9_19_3_3_1_19_1_3_3_19_19_19_19_19_19_19_3_3_2_2_3_3_1_1_4_4_4_4_4_4_4_6_6_6_6_4_4_4_4_9_9_3
8880,196,1332998460,7,12,8,1333016700,18240,3197760,3281700,83940,7_7_7_7_7_7_7_7_7_7_7_7_7_7_7_7_7_7_7_7_1_1_1_1_7_7_1_1_7_7_1_1_7_7_7_1_1_7_7_7_7_7_7_7_7_7_1_1_7_7_7_30_30_7_1_7_7_1_7_1_1_7_7_7_1_7_7_1_1_1_7_7_30_30_1_1_10_10_10_1_1_10_10_10_10_1_1_10_10_10_10_8_8_7_10_10_7_10_10_10_10_10_7_7_7_7_7_7_8_8_10_10_7_7_1_30_1_30_8_7_8_11_11_7_10_10_8_10_7_10_8_7_10_10_7_7_7_10_7_10_10_7_7
8881,58,1332998760,2,3,2,1333002000,3240,899040,992100,93060,19_19_19_1_19_19_1_19_19_19_19_19_19_19_19_19_1_1_1_1_2
8882,188,1332999600,5,2,99,1332999600,0,4327560,4327560,0,0_0_0_0_0_1_1_0_0_0_0_0_0_0_0_0_1_1_2_2_2_2_3_3_3_3_21_21_3_3_3_3_3_3_3_3_18_18_18_18_18_18_18_18_18_18_18_18_18_18_18_18_18_18_1_1_18_18_18_18_1_1_18_3_18_18_3_18_18_18_18_18_18_18_18_18_18_18_18_18_18_18_5_5_5_5_5_5_5_5_5_11_5_11_5_5_5_5_5_5_5_5_6_6_5_5
8883,221,1332999600,5,18,99,1332999600,0,934800,934800,0,1_1_1_1_3_3_3_2_3_3_2_3_6_6_6_6_5_5
8884,15,1333000800,5,18,5,1333002840,2040,1820820,1822860,2040,7_7_7_7_7_7_1_7_1_7_7_7_7_7_7_7_7_7_7_7_7_7_7_7_1_1_1_1_2_2_3_3_17_17_17_17_17_17_17_17_17_17_17_5_5_5_5_17_17_6_6_6_6_17_1_1_2_2_17_17_17_17_21_21_21_3_21_3_5_5_6_6_5
8885,219,1333000800,5,2,5,1333014600,13800,3717540,3797940,80400,26_26_26_26_26_26_26_26_26_26_8_8_38_38_17_17_17_17_17_17_17_1_17_1_1_1_17_17_1_1_17_17_1_17_1_17_1_1_3_25_3_25_18_18_18_18_18_18_18_18_18_18_15_15_15_15_15_15_3_3_18_18_18_18_18_18_18_18_15_15_15_15_6_6_5
8886,223,1333000800,2,21,2,1333002600,1800,82800,84600,1800,1_1_2_2_2_2_2
8887,58,1333002000,2,3,3,1333002000,0,902280,992100,89820,19_19_19_1_19_19_1_19_19_19_19_19_19_19_19_19_1_1_1_1_2_2
8888,13,1333002000,5,9,3,1333002960,960,2435460,2525940,90480,19_19_19_1_1_19_19_19_19_19_19_19_19_19_19_19_1_1_1_19_1_19_19_19_19_19_19_19_19_19_19_1_19_1_19_19_19_19_19_19_1_1_1_1_19_19_19_19_1_1_1_1_1_1_19_19_1_19_1_19_19_19_19_19_2_2_9_9_2_2_1_9_1_3_1_3_9_1_1_1_19_1_1_19_19_3_19_3_3_3_9_19_9_19_3_3_1_19_1_3_3_19_19_19_19_19_19_19_3_3_2_2_3_3_1_1_4_4_4_4_4_4_4_6_6_6_6_4_4_4_4_9_9_3_5
8889,58,1333002000,3,3,3,1333004400,2400,902280,992100,89820,19_19_19_1_19_19_1_19_19_19_19_19_19_19_19_19_1_1_1_1_2_2_3
8890,223,1333002600,2,21,99,1333002600,0,84600,84600,0,1_1_2_2_2_2_2_2
8891,15,1333002840,5,18,99,1333002840,0,1822860,1822860,0,7_7_7_7_7_7_1_7_1_7_7_7_7_7_7_7_7_7_7_7_7_7_7_7_1_1_1_1_2_2_3_3_17_17_17_17_17_17_17_17_17_17_17_5_5_5_5_17_17_6_6_6_6_17_1_1_2_2_17_17_17_17_21_21_21_3_21_3_5_5_6_6_5_5
8892,13,1333002960,3,3,4,1333004280,1320,2436420,2525940,89520,19_19_19_1_1_19_19_19_19_19_19_19_19_19_19_19_1_1_1_19_1_19_19_19_19_19_19_19_19_19_19_1_19_1_19_19_19_19_19_19_1_1_1_1_19_19_19_19_1_1_1_1_1_1_19_19_1_19_1_19_19_19_19_19_2_2_9_9_2_2_1_9_1_3_1_3_9_1_1_1_19_1_1_19_19_3_19_3_3_3_9_19_9_19_3_3_1_19_1_3_3_19_19_19_19_19_19_19_3_3_2_2_3_3_1_1_4_4_4_4_4_4_4_6_6_6_6_4_4_4_4_9_9_3_5_3
8893,13,1333004280,4,15,5,1333006140,1860,2437740,2525940,88200,19_19_19_1_1_19_19_19_19_19_19_19_19_19_19_19_1_1_1_19_1_19_19_19_19_19_19_19_19_19_19_1_19_1_19_19_19_19_19_19_1_1_1_1_19_19_19_19_1_1_1_1_1_1_19_19_1_19_1_19_19_19_19_19_2_2_9_9_2_2_1_9_1_3_1_3_9_1_1_1_19_1_1_19_19_3_19_3_3_3_9_19_9_19_3_3_1_19_1_3_3_19_19_19_19_19_19_19_3_3_2_2_3_3_1_1_4_4_4_4_4_4_4_6_6_6_6_4_4_4_4_9_9_3_5_3_4
8894,58,1333004400,3,15,3,1333007280,2880,904680,992100,87420,19_19_19_1_19_19_1_19_19_19_19_19_19_19_19_19_1_1_1_1_2_2_3_3
8895,13,1333006140,5,9,4,1333006740,600,2439600,2525940,86340,19_19_19_1_1_19_19_19_19_19_19_19_19_19_19_19_1_1_1_19_1_19_19_19_19_19_19_19_19_19_19_1_19_1_19_19_19_19_19_19_1_1_1_1_19_19_19_19_1_1_1_1_1_1_19_19_1_19_1_19_19_19_19_19_2_2_9_9_2_2_1_9_1_3_1_3_9_1_1_1_19_1_1_19_19_3_19_3_3_3_9_19_9_19_3_3_1_19_1_3_3_19_19_19_19_19_19_19_3_3_2_2_3_3_1_1_4_4_4_4_4_4_4_6_6_6_6_4_4_4_4_9_9_3_5_3_4_5
8896,76,1333006440,5,6,5,1333013040,6600,7464840,7552500,87660,3_3_3_3_3_3_3_3_3_18_3_18_18_18_18_18_3_3_3_1_1_3_17_17_17_18_17_17_18_18_18_18_18_17_17_18_3_3_18_17_18_18_17_18_18_17_17_17_5_5_5_5_1_1_17_17_17_2_2_17_17_17_5_5_5_5_5_5_17_17_5_5_5_17_5_5_5_5_5_17_17_17_1_1_1_1_1_1_1_1_2_2_34_34_5_5_5_5_6_6_3_3_4_3_3_4_4_4_4_4_3_3_3_3_3_3_4_3_3_3_3_4_4_4_3_4_4_4_3_4_4_4_3_3_4_4_4_4_5_3_3_5_5_5_5_5_4_5_4_5_4_3_3_3_3_4_3_3_4_4_5_5_5_4_5_5_5_4_6_6_34_34_5_5_34_34_34_34_5_5_5_5_6_6_5_5_5_5_34_34_6_6_6_6_6_6_34_34_6_6_5_5
8897,204,1333006620,18,5,3,1333021140,14520,2473560,2567700,94140,16_16_16_16_16_16_16_16_16_16_16_16_16_16_16_16_16_16_16_16_16_16_1_1_1_1_1_16_1_2_2_16_16_16_16_16_16_16_16_16_16_1_16_1_16_16_16_16_16_16_1_1_16_16_16_16_16_16_2_16_2_16_1_1_1_1_1_2_2_2_2_1_1_1_1_1_3_3_3_3_18_18_18_18_18_18
8898,13,1333006740,4,5,4,1333024980,18240,2440200,2525940,85740,19_19_19_1_1_19_19_19_19_19_19_19_19_19_19_19_1_1_1_19_1_19_19_19_19_19_19_19_19_19_19_1_19_1_19_19_19_19_19_19_1_1_1_1_19_19_19_19_1_1_1_1_1_1_19_19_1_19_1_19_19_19_19_19_2_2_9_9_2_2_1_9_1_3_1_3_9_1_1_1_19_1_1_19_19_3_19_3_3_3_9_19_9_19_3_3_1_19_1_3_3_19_19_19_19_19_19_19_3_3_2_2_3_3_1_1_4_4_4_4_4_4_4_6_6_6_6_4_4_4_4_9_9_3_5_3_4_5_4
8899,58,1333007280,3,3,3,1333007340,60,907560,992100,84540,19_19_19_1_19_19_1_19_19_19_19_19_19_19_19_19_1_1_1_1_2_2_3_3_3
8900,58,1333007340,3,3,3,1333007880,540,907620,992100,84480,19_19_19_1_19_19_1_19_19_19_19_19_19_19_19_19_1_1_1_1_2_2_3_3_3_3
8901,58,1333007880,3,15,13,1333007880,0,908160,992100,83940,19_19_19_1_19_19_1_19_19_19_19_19_19_19_19_19_1_1_1_1_2_2_3_3_3_3_3
8902,58,1333007880,13,15,13,1333007940,60,908160,992100,83940,19_19_19_1_19_19_1_19_19_19_19_19_19_19_19_19_1_1_1_1_2_2_3_3_3_3_3_13
8903,190,1333007880,7,12,7,1333026120,18240,615480,705600,90120,7_7_1_1_7
8904,58,1333007940,13,15,13,1333012380,4440,908220,992100,83880,19_19_19_1_19_19_1_19_19_19_19_19_19_19_19_19_1_1_1_1_2_2_3_3_3_3_3_13_13
8905,152,1333009440,5,6,5,1333013940,4500,3762000,3766500,4500,17_17_17_17_17_17_17_17_17_17_17_17_1_1_2_2_17_17_17_17_3_3_3_3_3_3_18_18_18_18_18_18_18_18_18_18_18_18_18_18_5_5_6_6_5
8906,224,1333011240,5,9,6,1333054800,43560,600900,648060,47160,1_1_1_1_1_1_3_3_2_2_3_3_5_5_5_5
8907,65,1333011600,5,18,5,1333025400,13800,7470000,7544400,74400,17_17_34_34_6_6_6_6_5_5_1_1_1_1_2_2_3_3_5_5_5_5_3_3_18_18_18_18_18_18_18_18_18_18_5_5_5
8908,37,1333011840,1,6,1,1333022700,10860,651840,736020,84180,16_16_16_16_16_16_16_16_16_16_16_16_16_16_16_16_16_16_16_16_16_16_16_16_16_16_16_16_16_1_1_16_16_16_16_16_16_16_16_1_1_16_16_16_16_16_16_16_16_16_16_16_16_1_1_16_16_16_16_16_16_1
8909,58,1333012380,13,15,3,1333014660,2280,912660,992100,79440,19_19_19_1_19_19_1_19_19_19_19_19_19_19_19_19_1_1_1_1_2_2_3_3_3_3_3_13_13_13
8910,76,1333013040,5,6,5,1333017540,4500,7471440,7552500,81060,3_3_3_3_3_3_3_3_3_18_3_18_18_18_18_18_3_3_3_1_1_3_17_17_17_18_17_17_18_18_18_18_18_17_17_18_3_3_18_17_18_18_17_18_18_17_17_17_5_5_5_5_1_1_17_17_17_2_2_17_17_17_5_5_5_5_5_5_17_17_5_5_5_17_5_5_5_5_5_17_17_17_1_1_1_1_1_1_1_1_2_2_34_34_5_5_5_5_6_6_3_3_4_3_3_4_4_4_4_4_3_3_3_3_3_3_4_3_3_3_3_4_4_4_3_4_4_4_3_4_4_4_3_3_4_4_4_4_5_3_3_5_5_5_5_5_4_5_4_5_4_3_3_3_3_4_3_3_4_4_5_5_5_4_5_5_5_4_6_6_34_34_5_5_34_34_34_34_5_5_5_5_6_6_5_5_5_5_34_34_6_6_6_6_6_6_34_34_6_6_5_5_5
8911,139,1333013040,1,9,1,1333014180,1140,272760,273900,1140,19_19_19_19_19_19_19_19_1_1_19_19_19_19_19_19_19_1_19_1_1_1_19_2_2_19_1
8912,152,1333013940,5,6,99,1333013940,0,3766500,3766500,0,17_17_17_17_17_17_17_17_17_17_17_17_1_1_2_2_17_17_17_17_3_3_3_3_3_3_18_18_18_18_18_18_18_18_18_18_18_18_18_18_5_5_6_6_5_5
8913,139,1333014180,1,9,99,1333014180,0,273900,273900,0,19_19_19_19_19_19_19_19_1_1_19_19_19_19_19_19_19_1_19_1_1_1_19_2_2_19_1_1
8914,219,1333014600,5,2,2,1333014660,60,3731340,3797940,66600,26_26_26_26_26_26_26_26_26_26_8_8_38_38_17_17_17_17_17_17_17_1_17_1_1_1_17_17_1_1_17_17_1_17_1_17_1_1_3_25_3_25_18_18_18_18_18_18_18_18_18_18_15_15_15_15_15_15_3_3_18_18_18_18_18_18_18_18_15_15_15_15_6_6_5_5
8915,58,1333014660,3,3,13,1333020900,6240,914940,992100,77160,19_19_19_1_19_19_1_19_19_19_19_19_19_19_19_19_1_1_1_1_2_2_3_3_3_3_3_13_13_13_3
8916,219,1333014660,2,3,5,1333016400,1740,3731400,3797940,66540,26_26_26_26_26_26_26_26_26_26_8_8_38_38_17_17_17_17_17_17_17_1_17_1_1_1_17_17_1_1_17_17_1_17_1_17_1_1_3_25_3_25_18_18_18_18_18_18_18_18_18_18_15_15_15_15_15_15_3_3_18_18_18_18_18_18_18_18_15_15_15_15_6_6_5_5_2
8917,219,1333016400,5,2,2,1333020600,4200,3733140,3797940,64800,26_26_26_26_26_26_26_26_26_26_8_8_38_38_17_17_17_17_17_17_17_1_17_1_1_1_17_17_1_1_17_17_1_17_1_17_1_1_3_25_3_25_18_18_18_18_18_18_18_18_18_18_15_15_15_15_15_15_3_3_18_18_18_18_18_18_18_18_15_15_15_15_6_6_5_5_2_5
8918,29,1333016520,19,1,1,1333016700,180,42720,57540,14820,19_19_19_19
8919,196,1333016700,8,18,10,1333022400,5700,3216000,3281700,65700,7_7_7_7_7_7_7_7_7_7_7_7_7_7_7_7_7_7_7_7_1_1_1_1_7_7_1_1_7_7_1_1_7_7_7_1_1_7_7_7_7_7_7_7_7_7_1_1_7_7_7_30_30_7_1_7_7_1_7_1_1_7_7_7_1_7_7_1_1_1_7_7_30_30_1_1_10_10_10_1_1_10_10_10_10_1_1_10_10_10_10_8_8_7_10_10_7_10_10_10_10_10_7_7_7_7_7_7_8_8_10_10_7_7_1_30_1_30_8_7_8_11_11_7_10_10_8_10_7_10_8_7_10_10_7_7_7_10_7_10_10_7_7_8
8920,29,1333016700,1,9,19,1333024980,8280,42900,57540,14640,19_19_19_19_1
8921,76,1333017540,5,6,6,1333054800,37260,7475940,7552500,76560,3_3_3_3_3_3_3_3_3_18_3_18_18_18_18_18_3_3_3_1_1_3_17_17_17_18_17_17_18_18_18_18_18_17_17_18_3_3_18_17_18_18_17_18_18_17_17_17_5_5_5_5_1_1_17_17_17_2_2_17_17_17_5_5_5_5_5_5_17_17_5_5_5_17_5_5_5_5_5_17_17_17_1_1_1_1_1_1_1_1_2_2_34_34_5_5_5_5_6_6_3_3_4_3_3_4_4_4_4_4_3_3_3_3_3_3_4_3_3_3_3_4_4_4_3_4_4_4_3_4_4_4_3_3_4_4_4_4_5_3_3_5_5_5_5_5_4_5_4_5_4_3_3_3_3_4_3_3_4_4_5_5_5_4_5_5_5_4_6_6_34_34_5_5_34_34_34_34_5_5_5_5_6_6_5_5_5_5_34_34_6_6_6_6_6_6_34_34_6_6_5_5_5_5
8922,186,1333018200,2,3,2,1333021860,3660,3632580,3636240,3660,7_7_7_7_7_7_7_7_7_1_7_1_7_7_7_1_7_7_1_7_7_7_7_7_7_1_7_1_1_1_38_38_1_1_24_24_24_24_24_8_24_24_8_24_24_24_24_24_8_8_2_2_2
8923,219,1333020600,2,3,5,1333025820,5220,3737340,3797940,60600,26_26_26_26_26_26_26_26_26_26_8_8_38_38_17_17_17_17_17_17_17_1_17_1_1_1_17_17_1_1_17_17_1_17_1_17_1_1_3_25_3_25_18_18_18_18_18_18_18_18_18_18_15_15_15_15_15_15_3_3_18_18_18_18_18_18_18_18_15_15_15_15_6_6_5_5_2_5_2
8924,206,1333020720,3,3,3,1333021860,1140,1962660,2086740,124080,16_16_16_16_1_1_2_2_3_3_3
8925,58,1333020900,13,15,13,1333020960,60,921180,992100,70920,19_19_19_1_19_19_1_19_19_19_19_19_19_19_19_19_1_1_1_1_2_2_3_3_3_3_3_13_13_13_3_13
8926,58,1333020960,13,15,13,1333025160,4200,921240,992100,70860,19_19_19_1_19_19_1_19_19_19_19_19_19_19_19_19_1_1_1_1_2_2_3_3_3_3_3_13_13_13_3_13_13
8927,204,1333021140,3,3,1,1333022820,1680,2488080,2567700,79620,16_16_16_16_16_16_16_16_16_16_16_16_16_16_16_16_16_16_16_16_16_16_1_1_1_1_1_16_1_2_2_16_16_16_16_16_16_16_16_16_16_1_16_1_16_16_16_16_16_16_1_1_16_16_16_16_16_16_2_16_2_16_1_1_1_1_1_2_2_2_2_1_1_1_1_1_3_3_3_3_18_18_18_18_18_18_3
8928,186,1333021860,2,3,99,1333021860,0,3636240,3636240,0,7_7_7_7_7_7_7_7_7_1_7_1_7_7_7_1_7_7_1_7_7_7_7_7_7_1_7_1_1_1_38_38_1_1_24_24_24_24_24_8_24_24_8_24_24_24_24_24_8_8_2_2_2_2
8929,206,1333021860,3,3,4,1333038360,16500,1963800,2086740,122940,16_16_16_16_1_1_2_2_3_3_3_3
8930,196,1333022400,10,16,8,1333024320,1920,3221700,3281700,60000,7_7_7_7_7_7_7_7_7_7_7_7_7_7_7_7_7_7_7_7_1_1_1_1_7_7_1_1_7_7_1_1_7_7_7_1_1_7_7_7_7_7_7_7_7_7_1_1_7_7_7_30_30_7_1_7_7_1_7_1_1_7_7_7_1_7_7_1_1_1_7_7_30_30_1_1_10_10_10_1_1_10_10_10_10_1_1_10_10_10_10_8_8_7_10_10_7_10_10_10_10_10_7_7_7_7_7_7_8_8_10_10_7_7_1_30_1_30_8_7_8_11_11_7_10_10_8_10_7_10_8_7_10_10_7_7_7_10_7_10_10_7_7_8_10
8931,37,1333022700,1,6,16,1333026240,3540,662700,736020,73320,16_16_16_16_16_16_16_16_16_16_16_16_16_16_16_16_16_16_16_16_16_16_16_16_16_16_16_16_16_1_1_16_16_16_16_16_16_16_16_1_1_16_16_16_16_16_16_16_16_16_16_16_16_1_1_16_16_16_16_16_16_1_1
8932,204,1333022820,1,48,1,1333023060,240,2489760,2567700,77940,16_16_16_16_16_16_16_16_16_16_16_16_16_16_16_16_16_16_16_16_16_16_1_1_1_1_1_16_1_2_2_16_16_16_16_16_16_16_16_16_16_1_16_1_16_16_16_16_16_16_1_1_16_16_16_16_16_16_2_16_2_16_1_1_1_1_1_2_2_2_2_1_1_1_1_1_3_3_3_3_18_18_18_18_18_18_3_1
8933,204,1333023060,1,48,3,1333030920,7860,2490000,2567700,77700,16_16_16_16_16_16_16_16_16_16_16_16_16_16_16_16_16_16_16_16_16_16_1_1_1_1_1_16_1_2_2_16_16_16_16_16_16_16_16_16_16_1_16_1_16_16_16_16_16_16_1_1_16_16_16_16_16_16_2_16_2_16_1_1_1_1_1_2_2_2_2_1_1_1_1_1_3_3_3_3_18_18_18_18_18_18_3_1_1
8934,196,1333024320,8,18,10,1333027800,3480,3223620,3281700,58080,7_7_7_7_7_7_7_7_7_7_7_7_7_7_7_7_7_7_7_7_1_1_1_1_7_7_1_1_7_7_1_1_7_7_7_1_1_7_7_7_7_7_7_7_7_7_1_1_7_7_7_30_30_7_1_7_7_1_7_1_1_7_7_7_1_7_7_1_1_1_7_7_30_30_1_1_10_10_10_1_1_10_10_10_10_1_1_10_10_10_10_8_8_7_10_10_7_10_10_10_10_10_7_7_7_7_7_7_8_8_10_10_7_7_1_30_1_30_8_7_8_11_11_7_10_10_8_10_7_10_8_7_10_10_7_7_7_10_7_10_10_7_7_8_10_8
8935,57,1333024380,26,33,99,1333024380,0,2756640,2756640,0,26_26_26_26_26_26_26_26_26_26_26_26_26_26_26_26_26_26_26_26_26_26_26_26_26_8_8_8_8_2_2_26_8_8_26_26_26_26_26_26_26_26_8_8_26_26_26_26_26_26_8_8_8_8_26_26_26_26_6_6_5_5_26_26_26_26_26_26_26_26_26_26_26_26_26_26_26_26_26_26
8936,29,1333024980,19,1,19,1333025880,900,51180,57540,6360,19_19_19_19_1_19
8937,13,1333024980,4,5,4,1333025940,960,2458440,2525940,67500,19_19_19_1_1_19_19_19_19_19_19_19_19_19_19_19_1_1_1_19_1_19_19_19_19_19_19_19_19_19_19_1_19_1_19_19_19_19_19_19_1_1_1_1_19_19_19_19_1_1_1_1_1_1_19_19_1_19_1_19_19_19_19_19_2_2_9_9_2_2_1_9_1_3_1_3_9_1_1_1_19_1_1_19_19_3_19_3_3_3_9_19_9_19_3_3_1_19_1_3_3_19_19_19_19_19_19_19_3_3_2_2_3_3_1_1_4_4_4_4_4_4_4_6_6_6_6_4_4_4_4_9_9_3_5_3_4_5_4_4
8938,58,1333025160,13,15,3,1333032780,7620,925440,992100,66660,19_19_19_1_19_19_1_19_19_19_19_19_19_19_19_19_1_1_1_1_2_2_3_3_3_3_3_13_13_13_3_13_13_13
8939,65,1333025400,5,18,6,1333054800,29400,7483800,7544400,60600,17_17_34_34_6_6_6_6_5_5_1_1_1_1_2_2_3_3_5_5_5_5_3_3_18_18_18_18_18_18_18_18_18_18_5_5_5_5
8940,219,1333025820,5,2,5,1333029600,3780,3742560,3797940,55380,26_26_26_26_26_26_26_26_26_26_8_8_38_38_17_17_17_17_17_17_17_1_17_1_1_1_17_17_1_1_17_17_1_17_1_17_1_1_3_25_3_25_18_18_18_18_18_18_18_18_18_18_15_15_15_15_15_15_3_3_18_18_18_18_18_18_18_18_15_15_15_15_6_6_5_5_2_5_2_5_5
8941,219,1333025820,5,2,5,1333025820,0,3742560,3797940,55380,26_26_26_26_26_26_26_26_26_26_8_8_38_38_17_17_17_17_17_17_17_1_17_1_1_1_17_17_1_1_17_17_1_17_1_17_1_1_3_25_3_25_18_18_18_18_18_18_18_18_18_18_15_15_15_15_15_15_3_3_18_18_18_18_18_18_18_18_15_15_15_15_6_6_5_5_2_5_2_5
8942,29,1333025880,19,1,1,1333026180,300,52080,57540,5460,19_19_19_19_1_19_19
8943,13,1333025940,4,17,4,1333032780,6840,2459400,2525940,66540,19_19_19_1_1_19_19_19_19_19_19_19_19_19_19_19_1_1_1_19_1_19_19_19_19_19_19_19_19_19_19_1_19_1_19_19_19_19_19_19_1_1_1_1_19_19_19_19_1_1_1_1_1_1_19_19_1_19_1_19_19_19_19_19_2_2_9_9_2_2_1_9_1_3_1_3_9_1_1_1_19_1_1_19_19_3_19_3_3_3_9_19_9_19_3_3_1_19_1_3_3_19_19_19_19_19_19_19_3_3_2_2_3_3_1_1_4_4_4_4_4_4_4_6_6_6_6_4_4_4_4_9_9_3_5_3_4_5_4_4_4
8944,190,1333026120,7,12,7,1333028580,2460,633720,705600,71880,7_7_1_1_7_7
8945,29,1333026180,1,9,19,1333028700,2520,52380,57540,5160,19_19_19_19_1_19_19_1
8946,35,1333026180,0,1,99,1333026180,0,144180,144180,0,0_0_0_0_0_0_0_0
8947,37,1333026240,16,1,16,1333028820,2580,666240,736020,69780,16_16_16_16_16_16_16_16_16_16_16_16_16_16_16_16_16_16_16_16_16_16_16_16_16_16_16_16_16_1_1_16_16_16_16_16_16_16_16_1_1_16_16_16_16_16_16_16_16_16_16_16_16_1_1_16_16_16_16_16_16_1_1_16
8948,196,1333027800,10,13,10,1333057620,29820,3227100,3281700,54600,7_7_7_7_7_7_7_7_7_7_7_7_7_7_7_7_7_7_7_7_1_1_1_1_7_7_1_1_7_7_1_1_7_7_7_1_1_7_7_7_7_7_7_7_7_7_1_1_7_7_7_30_30_7_1_7_7_1_7_1_1_7_7_7_1_7_7_1_1_1_7_7_30_30_1_1_10_10_10_1_1_10_10_10_10_1_1_10_10_10_10_8_8_7_10_10_7_10_10_10_10_10_7_7_7_7_7_7_8_8_10_10_7_7_1_30_1_30_8_7_8_11_11_7_10_10_8_10_7_10_8_7_10_10_7_7_7_10_7_10_10_7_7_8_10_8_10
8949,190,1333028580,7,8,7,1333053660,25080,636180,705600,69420,7_7_1_1_7_7_7
8950,29,1333028700,19,20,19,1333031340,2640,54900,57540,2640,19_19_19_19_1_19_19_1_19
8951,37,1333028820,16,20,16,1333052880,24060,668820,736020,67200,16_16_16_16_16_16_16_16_16_16_16_16_16_16_16_16_16_16_16_16_16_16_16_16_16_16_16_16_16_1_1_16_16_16_16_16_16_16_16_1_1_16_16_16_16_16_16_16_16_16_16_16_16_1_1_16_16_16_16_16_16_1_1_16_16
8952,219,1333029600,5,2,6,1333054800,25200,3746340,3797940,51600,26_26_26_26_26_26_26_26_26_26_8_8_38_38_17_17_17_17_17_17_17_1_17_1_1_1_17_17_1_1_17_17_1_17_1_17_1_1_3_25_3_25_18_18_18_18_18_18_18_18_18_18_15_15_15_15_15_15_3_3_18_18_18_18_18_18_18_18_15_15_15_15_6_6_5_5_2_5_2_5_5_5
8953,63,1333029600,5,2,5,1333033500,3900,6178140,6232860,54720,16_16_16_16_16_16_16_16_16_0_0_16_16_0_16_16_0_16_16_0_0_16_16_16_0_0_16_0_0_16_0_16_0_0_0_16_1_1_1_16_16_16_0_1_1_1_16_0_0_16_16_0_16_0_16_0_0_2_2_1_1_0_0_0_0_2_2_2_2_2_2_0_1_0_1_1_0_0_0_1_1_0_0_1_1_1_0_0_0_0_0_2_2_2_2_0_0_0_0_0_0_1_1_1_1_0_0_16_0_16_16_16_16_16_0_0_1_1_2_2_1_1_16_0_2_16_2_2_2_0_1_1_1_1_1_16_16_1_1_1_3_3_18_3_18_3_3_3_3_3_18_18_18_18_3_3_3_3_18_18_18_18_18_18_18_5_5_5_18_5_18_18_18_18_18_5_5_5_18_18_18_5_6_6_5_5_5_5_3_5_18_3_3_3_18_16_18_16_5_18_18_6_3_6_18_3_18_18_5_5_18_5_5_5_5_5_5_5_5_5_18_3_5_3_18_3_3_3_3_18_18_18_18_3_5_5_18_3_18_6_3_6_3_18_3_3_18_18_5_5_3_18_3_5_34_34_3_3_18_5_18_3_2_3_2_18_5_34_18_3_5_5_3_5_3_3_5_18_3_34_3_5_18_18_18_18_18_18_18_18_18_18_18_18_18_18_18_18_18_18_34_34_5_34_5_34_5_5_6_6_5_5_6_6_5_5_5_5_5_5_5_5_5_5_5_5_5_5_5_5_34_34_34_34_34_34_5_5_34_34_11_11_6_6_5
8954,22,1333030680,17,10,99,1333030680,0,810360,810360,0,17_17_17_17_17_17_17_17_17_17_17_17_17_17_17_17_17_17_17_17_17_17
8955,204,1333030920,3,3,1,1333037640,6720,2497860,2567700,69840,16_16_16_16_16_16_16_16_16_16_16_16_16_16_16_16_16_16_16_16_16_16_1_1_1_1_1_16_1_2_2_16_16_16_16_16_16_16_16_16_16_1_16_1_16_16_16_16_16_16_1_1_16_16_16_16_16_16_2_16_2_16_1_1_1_1_1_2_2_2_2_1_1_1_1_1_3_3_3_3_18_18_18_18_18_18_3_1_1_3
8956,29,1333031340,19,20,99,1333031340,0,57540,57540,0,19_19_19_19_1_19_19_1_19_19
8957,36,1333032540,0,0,0,1333039740,7200,0,129360,129360,0
8958,13,1333032780,4,17,6,1333054800,22020,2466240,2525940,59700,19_19_19_1_1_19_19_19_19_19_19_19_19_19_19_19_1_1_1_19_1_19_19_19_19_19_19_19_19_19_19_1_19_1_19_19_19_19_19_19_1_1_1_1_19_19_19_19_1_1_1_1_1_1_19_19_1_19_1_19_19_19_19_19_2_2_9_9_2_2_1_9_1_3_1_3_9_1_1_1_19_1_1_19_19_3_19_3_3_3_9_19_9_19_3_3_1_19_1_3_3_19_19_19_19_19_19_19_3_3_2_2_3_3_1_1_4_4_4_4_4_4_4_6_6_6_6_4_4_4_4_9_9_3_5_3_4_5_4_4_4_4
8959,58,1333032780,3,17,3,1333046160,13380,933060,992100,59040,19_19_19_1_19_19_1_19_19_19_19_19_19_19_19_19_1_1_1_1_2_2_3_3_3_3_3_13_13_13_3_13_13_13_3
8960,63,1333033500,5,2,6,1333054800,21300,6182040,6232860,50820,16_16_16_16_16_16_16_16_16_0_0_16_16_0_16_16_0_16_16_0_0_16_16_16_0_0_16_0_0_16_0_16_0_0_0_16_1_1_1_16_16_16_0_1_1_1_16_0_0_16_16_0_16_0_16_0_0_2_2_1_1_0_0_0_0_2_2_2_2_2_2_0_1_0_1_1_0_0_0_1_1_0_0_1_1_1_0_0_0_0_0_2_2_2_2_0_0_0_0_0_0_1_1_1_1_0_0_16_0_16_16_16_16_16_0_0_1_1_2_2_1_1_16_0_2_16_2_2_2_0_1_1_1_1_1_16_16_1_1_1_3_3_18_3_18_3_3_3_3_3_18_18_18_18_3_3_3_3_18_18_18_18_18_18_18_5_5_5_18_5_18_18_18_18_18_5_5_5_18_18_18_5_6_6_5_5_5_5_3_5_18_3_3_3_18_16_18_16_5_18_18_6_3_6_18_3_18_18_5_5_18_5_5_5_5_5_5_5_5_5_18_3_5_3_18_3_3_3_3_18_18_18_18_3_5_5_18_3_18_6_3_6_3_18_3_3_18_18_5_5_3_18_3_5_34_34_3_3_18_5_18_3_2_3_2_18_5_34_18_3_5_5_3_5_3_3_5_18_3_34_3_5_18_18_18_18_18_18_18_18_18_18_18_18_18_18_18_18_18_18_34_34_5_34_5_34_5_5_6_6_5_5_6_6_5_5_5_5_5_5_5_5_5_5_5_5_5_5_5_5_34_34_34_34_34_34_5_5_34_34_11_11_6_6_5_5
8961,204,1333037640,1,22,1,1333070880,33240,2504580,2567700,63120,16_16_16_16_16_16_16_16_16_16_16_16_16_16_16_16_16_16_16_16_16_16_1_1_1_1_1_16_1_2_2_16_16_16_16_16_16_16_16_16_16_1_16_1_16_16_16_16_16_16_1_1_16_16_16_16_16_16_2_16_2_16_1_1_1_1_1_2_2_2_2_1_1_1_1_1_3_3_3_3_18_18_18_18_18_18_3_1_1_3_1
8962,38,1333037700,19,11,19,1333053240,15540,0,43560,43560,19
8963,206,1333038360,4,23,4,1333044540,6180,1980300,2086740,106440,16_16_16_16_1_1_2_2_3_3_3_3_4
8964,36,1333039740,0,0,0,1333039800,60,7200,129360,122160,0_0
8965,36,1333039800,0,0,0,1333054800,15000,7260,129360,122100,0_0_0
8966,206,1333044540,4,23,4,1333056420,11880,1986480,2086740,100260,16_16_16_16_1_1_2_2_3_3_3_3_4_4
8967,160,1333044540,18,23,11,1333048800,4260,1511700,1564260,52560,16_16_16_16_0_16_0_16_1_16_1_16_16_16_16_16_16_16_1_1_2_2_3_3_3_3_18_18_18_18_18_18_18_18_18_18_18_18_18_18_18
8968,58,1333046160,3,17,6,1333054800,8640,946440,992100,45660,19_19_19_1_19_19_1_19_19_19_19_19_19_19_19_19_1_1_1_1_2_2_3_3_3_3_3_13_13_13_3_13_13_13_3_3
8969,42,1333046160,11,17,11,1333048740,2580,912120,953340,41220,16_16_16_16_1_1_2_2_3_3_18_18_18_18_18_18_11
8970,42,1333048740,11,17,18,1333054440,5700,914700,953340,38640,16_16_16_16_1_1_2_2_3_3_18_18_18_18_18_18_11_11
8971,160,1333048800,11,17,11,1333053900,5100,1515960,1564260,48300,16_16_16_16_0_16_0_16_1_16_1_16_16_16_16_16_16_16_1_1_2_2_3_3_3_3_18_18_18_18_18_18_18_18_18_18_18_18_18_18_18_11
8972,37,1333052880,16,20,16,1333054860,1980,692880,736020,43140,16_16_16_16_16_16_16_16_16_16_16_16_16_16_16_16_16_16_16_16_16_16_16_16_16_16_16_16_16_1_1_16_16_16_16_16_16_16_16_1_1_16_16_16_16_16_16_16_16_16_16_16_16_1_1_16_16_16_16_16_16_1_1_16_16_16
8973,38,1333053240,19,11,19,1333053240,0,15540,43560,28020,19_19
8974,38,1333053240,19,11,19,1333076100,22860,15540,43560,28020,19_19_19
8975,190,1333053660,7,8,7,1333054500,840,661260,705600,44340,7_7_1_1_7_7_7_7
8976,160,1333053900,11,17,18,1333054440,540,1521060,1564260,43200,16_16_16_16_0_16_0_16_1_16_1_16_16_16_16_16_16_16_1_1_2_2_3_3_3_3_18_18_18_18_18_18_18_18_18_18_18_18_18_18_18_11_11
8977,160,1333054440,18,23,11,1333080000,25560,1521600,1564260,42660,16_16_16_16_0_16_0_16_1_16_1_16_16_16_16_16_16_16_1_1_2_2_3_3_3_3_18_18_18_18_18_18_18_18_18_18_18_18_18_18_18_11_11_18
8978,42,1333054440,18,23,6,1333054800,360,920400,953340,32940,16_16_16_16_1_1_2_2_3_3_18_18_18_18_18_18_11_11_18
8979,190,1333054500,7,11,7,1333076040,21540,662100,705600,43500,7_7_1_1_7_7_7_7_7
8980,141,1333054800,1,2,1,1333059300,4500,7401600,7406100,4500,1_1_16_16_16_16_16_1_16_16_1_1_1_16_16_16_16_16_16_16_16_16_16_16_16_16_16_16_1_1_1_1_1_1_1_1_1_1_1_1_16_2_2_16_3_3_3_3_3_3_18_18_18_18_18_3_18_3_3_3_5_5_5_5_5_5_3_3_4_4_4_4_4_3_1_3_1_4_18_3_3_18_18_1_1_18_18_5_5_18_5_5_5_5_6_6_5_5_6_6_6_6_5_5_5_5_5_5_5_5_6_6_5_5_5_5_5_5_5_5_5_5_5_5_34_34_34_34_5_5_5_5_34_34_6_6_5_5_6_6_1
8981,220,1333054800,6,24,6,1333058400,3600,2710440,2714040,3600,0_0_0_0_1_0_1_0_0_0_0_0_1_0_0_1_0_0_0_0_0_0_0_0_0_0_0_0_0_0_0_1_1_0_1_1_1_1_0_0_1_1_2_2_2_2_2_2_2_2_27_27_27_27_27_27_27_27_27_27_27_27_27_27_27_27_3_3_3_3_3_3_3_3_3_3_3_3_3_3_4_4_4_4_1_4_4_1_4_4_4_4_4_4_4_4_4_4_4_4_4_5_5_4_4_4_4_4_5_5_5_5_5_5_6
8982,142,1333054800,6,30,6,1333058400,3600,7296360,7299960,3600,0_0_0_0_0_0_0_1_1_0_0_0_0_0_0_0_0_1_1_0_0_0_0_0_0_1_1_0_0_0_0_0_0_1_1_0_0_0_0_0_0_0_1_0_1_0_0_0_1_1_1_1_27_27_27_27_1_27_27_1_27_27_27_27_27_27_27_27_27_27_27_27_27_27_27_27_2_2_2_2_2_2_3_3_3_2_2_3_3_3_2_2_3_3_4_4_15_4_15_4_4_4_4_4_4_4_4_4_4_4_4_4_4_4_4_4_4_4_4_4_4_4_4_4_4_4_4_4_4_4_4_4_15_15_15_15_15_15_5_5_6_6_15_15_5_5_6_6_5_5_15_5_5_15_5_5_15_18_15_18_4_4_5_15_15_5_15_15_5_5_6
8983,60,1333054800,3,2,3,1333059300,4500,7396800,7401300,4500,3_3_18_18_18_18_18_18_5_5_5_5_5_5_5_5_34_34_6_6_5_5_3
8984,42,1333054800,6,7,18,1333056360,1560,920760,953340,32580,16_16_16_16_1_1_2_2_3_3_18_18_18_18_18_18_11_11_18_6
8985,224,1333054800,6,7,6,1333058400,3600,644460,648060,3600,1_1_1_1_1_1_3_3_2_2_3_3_5_5_5_5_6
8986,65,1333054800,6,24,6,1333058400,3600,7513200,7544400,31200,17_17_34_34_6_6_6_6_5_5_1_1_1_1_2_2_3_3_5_5_5_5_3_3_18_18_18_18_18_18_18_18_18_18_5_5_5_5_6
8987,36,1333054800,0,0,0,1333075500,20700,22260,129360,107100,0_0_0_0
8988,13,1333054800,6,24,6,1333058400,3600,2488260,2525940,37680,19_19_19_1_1_19_19_19_19_19_19_19_19_19_19_19_1_1_1_19_1_19_19_19_19_19_19_19_19_19_19_1_19_1_19_19_19_19_19_19_1_1_1_1_19_19_19_19_1_1_1_1_1_1_19_19_1_19_1_19_19_19_19_19_2_2_9_9_2_2_1_9_1_3_1_3_9_1_1_1_19_1_1_19_19_3_19_3_3_3_9_19_9_19_3_3_1_19_1_3_3_19_19_19_19_19_19_19_3_3_2_2_3_3_1_1_4_4_4_4_4_4_4_6_6_6_6_4_4_4_4_9_9_3_5_3_4_5_4_4_4_4_6
8989,219,1333054800,6,24,6,1333058400,3600,3771540,3797940,26400,26_26_26_26_26_26_26_26_26_26_8_8_38_38_17_17_17_17_17_17_17_1_17_1_1_1_17_17_1_1_17_17_1_17_1_17_1_1_3_25_3_25_18_18_18_18_18_18_18_18_18_18_15_15_15_15_15_15_3_3_18_18_18_18_18_18_18_18_15_15_15_15_6_6_5_5_2_5_2_5_5_5_6
8990,63,1333054800,6,24,6,1333058400,3600,6203340,6232860,29520,16_16_16_16_16_16_16_16_16_0_0_16_16_0_16_16_0_16_16_0_0_16_16_16_0_0_16_0_0_16_0_16_0_0_0_16_1_1_1_16_16_16_0_1_1_1_16_0_0_16_16_0_16_0_16_0_0_2_2_1_1_0_0_0_0_2_2_2_2_2_2_0_1_0_1_1_0_0_0_1_1_0_0_1_1_1_0_0_0_0_0_2_2_2_2_0_0_0_0_0_0_1_1_1_1_0_0_16_0_16_16_16_16_16_0_0_1_1_2_2_1_1_16_0_2_16_2_2_2_0_1_1_1_1_1_16_16_1_1_1_3_3_18_3_18_3_3_3_3_3_18_18_18_18_3_3_3_3_18_18_18_18_18_18_18_5_5_5_18_5_18_18_18_18_18_5_5_5_18_18_18_5_6_6_5_5_5_5_3_5_18_3_3_3_18_16_18_16_5_18_18_6_3_6_18_3_18_18_5_5_18_5_5_5_5_5_5_5_5_5_18_3_5_3_18_3_3_3_3_18_18_18_18_3_5_5_18_3_18_6_3_6_3_18_3_3_18_18_5_5_3_18_3_5_34_34_3_3_18_5_18_3_2_3_2_18_5_34_18_3_5_5_3_5_3_3_5_18_3_34_3_5_18_18_18_18_18_18_18_18_18_18_18_18_18_18_18_18_18_18_34_34_5_34_5_34_5_5_6_6_5_5_6_6_5_5_5_5_5_5_5_5_5_5_5_5_5_5_5_5_34_34_34_34_34_34_5_5_34_34_11_11_6_6_5_5_6
8991,131,1333054800,5,25,6,1333054800,0,6794700,6825900,31200,16_16_16_16_16_16_16_16_16_16_16_16_16_16_16_16_16_16_16_16_16_16_16_16_16_16_1_1_1_1_2_2_3_3_3_3_18_18_18_18_18_3_3_3_3_18_18_18_18_18_18_18_18_18_18_18_18_18_18_18_18_18_18_18_5_5_5_5_5_5_5_5_5_5_5_5_6_6_5_5_6_6_5_5_5_5_5_5_5_5_5_5_6_6_5_5_34_34_34_34_3_3_18_18_18_18_18_18_6_6_5_5_34_34_5_5_5_5_5_5_5_5_5_5_6_6_5_5_34_34_34_34_3_3_5
8992,131,1333054800,6,7,6,1333058400,3600,6794700,6825900,31200,16_16_16_16_16_16_16_16_16_16_16_16_16_16_16_16_16_16_16_16_16_16_16_16_16_16_1_1_1_1_2_2_3_3_3_3_18_18_18_18_18_3_3_3_3_18_18_18_18_18_18_18_18_18_18_18_18_18_18_18_18_18_18_18_5_5_5_5_5_5_5_5_5_5_5_5_6_6_5_5_6_6_5_5_5_5_5_5_5_5_5_5_6_6_5_5_34_34_34_34_3_3_18_18_18_18_18_18_6_6_5_5_34_34_5_5_5_5_5_5_5_5_5_5_6_6_5_5_34_34_34_34_3_3_5_6
8993,76,1333054800,6,24,6,1333058400,3600,7513200,7552500,39300,3_3_3_3_3_3_3_3_3_18_3_18_18_18_18_18_3_3_3_1_1_3_17_17_17_18_17_17_18_18_18_18_18_17_17_18_3_3_18_17_18_18_17_18_18_17_17_17_5_5_5_5_1_1_17_17_17_2_2_17_17_17_5_5_5_5_5_5_17_17_5_5_5_17_5_5_5_5_5_17_17_17_1_1_1_1_1_1_1_1_2_2_34_34_5_5_5_5_6_6_3_3_4_3_3_4_4_4_4_4_3_3_3_3_3_3_4_3_3_3_3_4_4_4_3_4_4_4_3_4_4_4_3_3_4_4_4_4_5_3_3_5_5_5_5_5_4_5_4_5_4_3_3_3_3_4_3_3_4_4_5_5_5_4_5_5_5_4_6_6_34_34_5_5_34_34_34_34_5_5_5_5_6_6_5_5_5_5_34_34_6_6_6_6_6_6_34_34_6_6_5_5_5_5_6
8994,58,1333054800,6,24,6,1333058400,3600,955080,992100,37020,19_19_19_1_19_19_1_19_19_19_19_19_19_19_19_19_1_1_1_1_2_2_3_3_3_3_3_13_13_13_3_13_13_13_3_3_6
8995,45,1333054800,6,24,6,1333058400,3600,0,35820,35820,6
8996,98,1333054800,2,3,2,1333059300,4500,7315380,7319880,4500,34_34_2_2_35_35_34_34_2_2_3_3_3_3_3_3_18_18_3_3_3_18_3_3_3_18_18_18_18_3_3_18_18_18_18_18_18_18_18_3_3_18_39_3_3_39_3_3_3_3_4_4_5_5_5_5_5_5_4_4_4_5_3_5_5_3_5_4_4_4_5_5_5_5_6_6_6_6_5_5_5_5_5_5_5_5_5_5_5_5_6_6_5_5_34_34_6_6_5_5_5_5_5_5_5_5_5_5_5_5_2_2_5_18_5_18_18_18_6_6_5_5_5_5_5_5_6_6_34_34_34_34_35_35_6_6_5_5_5_5_34_34_6_6_5_5_34_34_2
8997,37,1333054860,16,0,16,1333075500,20640,694860,736020,41160,16_16_16_16_16_16_16_16_16_16_16_16_16_16_16_16_16_16_16_16_16_16_16_16_16_16_16_16_16_1_1_16_16_16_16_16_16_16_16_1_1_16_16_16_16_16_16_16_16_16_16_16_16_1_1_16_16_16_16_16_16_1_1_16_16_16_16
8998,42,1333056360,18,23,6,1333058400,2040,922320,953340,31020,16_16_16_16_1_1_2_2_3_3_18_18_18_18_18_18_11_11_18_6_18
8999,206,1333056420,4,23,4,1333058400,1980,1998360,2086740,88380,16_16_16_16_1_1_2_2_3_3_3_3_4_4_4
9000,196,1333057620,10,13,8,1333076400,18780,3256920,3281700,24780,7_7_7_7_7_7_7_7_7_7_7_7_7_7_7_7_7_7_7_7_1_1_1_1_7_7_1_1_7_7_1_1_7_7_7_1_1_7_7_7_7_7_7_7_7_7_1_1_7_7_7_30_30_7_1_7_7_1_7_1_1_7_7_7_1_7_7_1_1_1_7_7_30_30_1_1_10_10_10_1_1_10_10_10_10_1_1_10_10_10_10_8_8_7_10_10_7_10_10_10_10_10_7_7_7_7_7_7_8_8_10_10_7_7_1_30_1_30_8_7_8_11_11_7_10_10_8_10_7_10_8_7_10_10_7_7_7_10_7_10_10_7_7_8_10_8_10_10
9001,42,1333058400,6,7,5,1333080720,22320,924360,953340,28980,16_16_16_16_1_1_2_2_3_3_18_18_18_18_18_18_11_11_18_6_18_6
9002,220,1333058400,6,24,99,1333058400,0,2714040,2714040,0,0_0_0_0_1_0_1_0_0_0_0_0_1_0_0_1_0_0_0_0_0_0_0_0_0_0_0_0_0_0_0_1_1_0_1_1_1_1_0_0_1_1_2_2_2_2_2_2_2_2_27_27_27_27_27_27_27_27_27_27_27_27_27_27_27_27_3_3_3_3_3_3_3_3_3_3_3_3_3_3_4_4_4_4_1_4_4_1_4_4_4_4_4_4_4_4_4_4_4_4_4_5_5_4_4_4_4_4_5_5_5_5_5_5_6_6
9003,58,1333058400,6,24,5,1333086000,27600,958680,992100,33420,19_19_19_1_19_19_1_19_19_19_19_19_19_19_19_19_1_1_1_1_2_2_3_3_3_3_3_13_13_13_3_13_13_13_3_3_6_6
9004,65,1333058400,6,24,5,1333083600,25200,7516800,7544400,27600,17_17_34_34_6_6_6_6_5_5_1_1_1_1_2_2_3_3_5_5_5_5_3_3_18_18_18_18_18_18_18_18_18_18_5_5_5_5_6_6
9005,142,1333058400,6,30,99,1333058400,0,7299960,7299960,0,0_0_0_0_0_0_0_1_1_0_0_0_0_0_0_0_0_1_1_0_0_0_0_0_0_1_1_0_0_0_0_0_0_1_1_0_0_0_0_0_0_0_1_0_1_0_0_0_1_1_1_1_27_27_27_27_1_27_27_1_27_27_27_27_27_27_27_27_27_27_27_27_27_27_27_27_2_2_2_2_2_2_3_3_3_2_2_3_3_3_2_2_3_3_4_4_15_4_15_4_4_4_4_4_4_4_4_4_4_4_4_4_4_4_4_4_4_4_4_4_4_4_4_4_4_4_4_4_4_4_4_4_15_15_15_15_15_15_5_5_6_6_15_15_5_5_6_6_5_5_15_5_5_15_5_5_15_18_15_18_4_4_5_15_15_5_15_15_5_5_6_6
9006,206,1333058400,4,5,4,1333067700,9300,2000340,2086740,86400,16_16_16_16_1_1_2_2_3_3_3_3_4_4_4_4
9007,76,1333058400,6,24,5,1333086000,27600,7516800,7552500,35700,3_3_3_3_3_3_3_3_3_18_3_18_18_18_18_18_3_3_3_1_1_3_17_17_17_18_17_17_18_18_18_18_18_17_17_18_3_3_18_17_18_18_17_18_18_17_17_17_5_5_5_5_1_1_17_17_17_2_2_17_17_17_5_5_5_5_5_5_17_17_5_5_5_17_5_5_5_5_5_17_17_17_1_1_1_1_1_1_1_1_2_2_34_34_5_5_5_5_6_6_3_3_4_3_3_4_4_4_4_4_3_3_3_3_3_3_4_3_3_3_3_4_4_4_3_4_4_4_3_4_4_4_3_3_4_4_4_4_5_3_3_5_5_5_5_5_4_5_4_5_4_3_3_3_3_4_3_3_4_4_5_5_5_4_5_5_5_4_6_6_34_34_5_5_34_34_34_34_5_5_5_5_6_6_5_5_5_5_34_34_6_6_6_6_6_6_34_34_6_6_5_5_5_5_6_6
9008,45,1333058400,6,24,5,1333086960,28560,3600,35820,32220,6_6
9009,63,1333058400,6,24,5,1333083600,25200,6206940,6232860,25920,16_16_16_16_16_16_16_16_16_0_0_16_16_0_16_16_0_16_16_0_0_16_16_16_0_0_16_0_0_16_0_16_0_0_0_16_1_1_1_16_16_16_0_1_1_1_16_0_0_16_16_0_16_0_16_0_0_2_2_1_1_0_0_0_0_2_2_2_2_2_2_0_1_0_1_1_0_0_0_1_1_0_0_1_1_1_0_0_0_0_0_2_2_2_2_0_0_0_0_0_0_1_1_1_1_0_0_16_0_16_16_16_16_16_0_0_1_1_2_2_1_1_16_0_2_16_2_2_2_0_1_1_1_1_1_16_16_1_1_1_3_3_18_3_18_3_3_3_3_3_18_18_18_18_3_3_3_3_18_18_18_18_18_18_18_5_5_5_18_5_18_18_18_18_18_5_5_5_18_18_18_5_6_6_5_5_5_5_3_5_18_3_3_3_18_16_18_16_5_18_18_6_3_6_18_3_18_18_5_5_18_5_5_5_5_5_5_5_5_5_18_3_5_3_18_3_3_3_3_18_18_18_18_3_5_5_18_3_18_6_3_6_3_18_3_3_18_18_5_5_3_18_3_5_34_34_3_3_18_5_18_3_2_3_2_18_5_34_18_3_5_5_3_5_3_3_5_18_3_34_3_5_18_18_18_18_18_18_18_18_18_18_18_18_18_18_18_18_18_18_34_34_5_34_5_34_5_5_6_6_5_5_6_6_5_5_5_5_5_5_5_5_5_5_5_5_5_5_5_5_34_34_34_34_34_34_5_5_34_34_11_11_6_6_5_5_6_6
9010,13,1333058400,6,24,5,1333081260,22860,2491860,2525940,34080,19_19_19_1_1_19_19_19_19_19_19_19_19_19_19_19_1_1_1_19_1_19_19_19_19_19_19_19_19_19_19_1_19_1_19_19_19_19_19_19_1_1_1_1_19_19_19_19_1_1_1_1_1_1_19_19_1_19_1_19_19_19_19_19_2_2_9_9_2_2_1_9_1_3_1_3_9_1_1_1_19_1_1_19_19_3_19_3_3_3_9_19_9_19_3_3_1_19_1_3_3_19_19_19_19_19_19_19_3_3_2_2_3_3_1_1_4_4_4_4_4_4_4_6_6_6_6_4_4_4_4_9_9_3_5_3_4_5_4_4_4_4_6_6
9011,224,1333058400,6,7,99,1333058400,0,648060,648060,0,1_1_1_1_1_1_3_3_2_2_3_3_5_5_5_5_6_6
9012,219,1333058400,6,24,5,1333080000,21600,3775140,3797940,22800,26_26_26_26_26_26_26_26_26_26_8_8_38_38_17_17_17_17_17_17_17_1_17_1_1_1_17_17_1_1_17_17_1_17_1_17_1_1_3_25_3_25_18_18_18_18_18_18_18_18_18_18_15_15_15_15_15_15_3_3_18_18_18_18_18_18_18_18_15_15_15_15_6_6_5_5_2_5_2_5_5_5_6_6
9013,131,1333058400,6,7,5,1333059300,900,6798300,6825900,27600,16_16_16_16_16_16_16_16_16_16_16_16_16_16_16_16_16_16_16_16_16_16_16_16_16_16_1_1_1_1_2_2_3_3_3_3_18_18_18_18_18_3_3_3_3_18_18_18_18_18_18_18_18_18_18_18_18_18_18_18_18_18_18_18_5_5_5_5_5_5_5_5_5_5_5_5_6_6_5_5_6_6_5_5_5_5_5_5_5_5_5_5_6_6_5_5_34_34_34_34_3_3_18_18_18_18_18_18_6_6_5_5_34_34_5_5_5_5_5_5_5_5_5_5_6_6_5_5_34_34_34_34_3_3_5_6_6
9014,98,1333059300,2,3,99,1333059300,0,7319880,7319880,0,34_34_2_2_35_35_34_34_2_2_3_3_3_3_3_3_18_18_3_3_3_18_3_3_3_18_18_18_18_3_3_18_18_18_18_18_18_18_18_3_3_18_39_3_3_39_3_3_3_3_4_4_5_5_5_5_5_5_4_4_4_5_3_5_5_3_5_4_4_4_5_5_5_5_6_6_6_6_5_5_5_5_5_5_5_5_5_5_5_5_6_6_5_5_34_34_6_6_5_5_5_5_5_5_5_5_5_5_5_5_2_2_5_18_5_18_18_18_6_6_5_5_5_5_5_5_6_6_34_34_34_34_35_35_6_6_5_5_5_5_34_34_6_6_5_5_34_34_2_2
9015,60,1333059300,3,2,99,1333059300,0,7401300,7401300,0,3_3_18_18_18_18_18_18_5_5_5_5_5_5_5_5_34_34_6_6_5_5_3_3
9016,131,1333059300,5,25,5,1333081200,21900,6799200,6825900,26700,16_16_16_16_16_16_16_16_16_16_16_16_16_16_16_16_16_16_16_16_16_16_16_16_16_16_1_1_1_1_2_2_3_3_3_3_18_18_18_18_18_3_3_3_3_18_18_18_18_18_18_18_18_18_18_18_18_18_18_18_18_18_18_18_5_5_5_5_5_5_5_5_5_5_5_5_6_6_5_5_6_6_5_5_5_5_5_5_5_5_5_5_6_6_5_5_34_34_34_34_3_3_18_18_18_18_18_18_6_6_5_5_34_34_5_5_5_5_5_5_5_5_5_5_6_6_5_5_34_34_34_34_3_3_5_6_6_5
9017,141,1333059300,1,2,99,1333059300,0,7406100,7406100,0,1_1_16_16_16_16_16_1_16_16_1_1_1_16_16_16_16_16_16_16_16_16_16_16_16_16_16_16_1_1_1_1_1_1_1_1_1_1_1_1_16_2_2_16_3_3_3_3_3_3_18_18_18_18_18_3_18_3_3_3_5_5_5_5_5_5_3_3_4_4_4_4_4_3_1_3_1_4_18_3_3_18_18_1_1_18_18_5_5_18_5_5_5_5_6_6_5_5_6_6_6_6_5_5_5_5_5_5_5_5_6_6_5_5_5_5_5_5_5_5_5_5_5_5_34_34_34_34_5_5_5_5_34_34_6_6_5_5_6_6_1_1
9018,206,1333067700,4,23,4,1333075860,8160,2009640,2086740,77100,16_16_16_16_1_1_2_2_3_3_3_3_4_4_4_4_4
9019,204,1333070880,1,22,18,1333076580,5700,2537820,2567700,29880,16_16_16_16_16_16_16_16_16_16_16_16_16_16_16_16_16_16_16_16_16_16_1_1_1_1_1_16_1_2_2_16_16_16_16_16_16_16_16_16_16_1_16_1_16_16_16_16_16_16_1_1_16_16_16_16_16_16_2_16_2_16_1_1_1_1_1_2_2_2_2_1_1_1_1_1_3_3_3_3_18_18_18_18_18_18_3_1_1_3_1_1
9020,37,1333075500,16,0,16,1333075500,0,715500,736020,20520,16_16_16_16_16_16_16_16_16_16_16_16_16_16_16_16_16_16_16_16_16_16_16_16_16_16_16_16_16_1_1_16_16_16_16_16_16_16_16_1_1_16_16_16_16_16_16_16_16_16_16_16_16_1_1_16_16_16_16_16_16_1_1_16_16_16_16_16
9021,37,1333075500,16,1,1,1333077060,1560,715500,736020,20520,16_16_16_16_16_16_16_16_16_16_16_16_16_16_16_16_16_16_16_16_16_16_16_16_16_16_16_16_16_1_1_16_16_16_16_16_16_16_16_1_1_16_16_16_16_16_16_16_16_16_16_16_16_1_1_16_16_16_16_16_16_1_1_16_16_16_16_16_16
9022,36,1333075500,0,1,0,1333095900,20400,42960,129360,86400,0_0_0_0_0
9023,206,1333075860,4,19,4,1333078200,2340,2017800,2086740,68940,16_16_16_16_1_1_2_2_3_3_3_3_4_4_4_4_4_4
9024,190,1333076040,7,11,7,1333087200,11160,683640,705600,21960,7_7_1_1_7_7_7_7_7_7
9025,38,1333076100,19,11,1,1333078560,2460,38400,43560,5160,19_19_19_19
9026,196,1333076400,8,18,8,1333082400,6000,3275700,3281700,6000,7_7_7_7_7_7_7_7_7_7_7_7_7_7_7_7_7_7_7_7_1_1_1_1_7_7_1_1_7_7_1_1_7_7_7_1_1_7_7_7_7_7_7_7_7_7_1_1_7_7_7_30_30_7_1_7_7_1_7_1_1_7_7_7_1_7_7_1_1_1_7_7_30_30_1_1_10_10_10_1_1_10_10_10_10_1_1_10_10_10_10_8_8_7_10_10_7_10_10_10_10_10_7_7_7_7_7_7_8_8_10_10_7_7_1_30_1_30_8_7_8_11_11_7_10_10_8_10_7_10_8_7_10_10_7_7_7_10_7_10_10_7_7_8_10_8_10_10_8
9027,204,1333076580,18,19,18,1333095720,19140,2543520,2567700,24180,16_16_16_16_16_16_16_16_16_16_16_16_16_16_16_16_16_16_16_16_16_16_1_1_1_1_1_16_1_2_2_16_16_16_16_16_16_16_16_16_16_1_16_1_16_16_16_16_16_16_1_1_16_16_16_16_16_16_2_16_2_16_1_1_1_1_1_2_2_2_2_1_1_1_1_1_3_3_3_3_18_18_18_18_18_18_3_1_1_3_1_1_18
9028,37,1333077060,1,6,1,1333080660,3600,717060,736020,18960,16_16_16_16_16_16_16_16_16_16_16_16_16_16_16_16_16_16_16_16_16_16_16_16_16_16_16_16_16_1_1_16_16_16_16_16_16_16_16_1_1_16_16_16_16_16_16_16_16_16_16_16_16_1_1_16_16_16_16_16_16_1_1_16_16_16_16_16_16_1
9029,175,1333077420,10,16,10,1333095240,17820,0,19560,19560,10
9030,206,1333078200,4,5,4,1333095780,17580,2020140,2086740,66600,16_16_16_16_1_1_2_2_3_3_3_3_4_4_4_4_4_4_4
9031,9,1333078560,17,10,17,1333097220,18660,0,18660,18660,17
9032,38,1333078560,1,9,1,1333081260,2700,40860,43560,2700,19_19_19_19_1
9033,160,1333080000,11,15,11,1333097100,17100,1547160,1564260,17100,16_16_16_16_0_16_0_16_1_16_1_16_16_16_16_16_16_16_1_1_2_2_3_3_3_3_18_18_18_18_18_18_18_18_18_18_18_18_18_18_18_11_11_18_11
9034,219,1333080000,5,2,5,1333081200,1200,3796740,3797940,1200,26_26_26_26_26_26_26_26_26_26_8_8_38_38_17_17_17_17_17_17_17_1_17_1_1_1_17_17_1_1_17_17_1_17_1_17_1_1_3_25_3_25_18_18_18_18_18_18_18_18_18_18_15_15_15_15_15_15_3_3_18_18_18_18_18_18_18_18_15_15_15_15_6_6_5_5_2_5_2_5_5_5_6_6_5
9035,37,1333080660,1,6,16,1333096020,15360,720660,736020,15360,16_16_16_16_16_16_16_16_16_16_16_16_16_16_16_16_16_16_16_16_16_16_16_16_16_16_16_16_16_1_1_16_16_16_16_16_16_16_16_1_1_16_16_16_16_16_16_16_16_16_16_16_16_1_1_16_16_16_16_16_16_1_1_16_16_16_16_16_16_1_1
9036,42,1333080720,5,6,5,1333087380,6660,946680,953340,6660,16_16_16_16_1_1_2_2_3_3_18_18_18_18_18_18_11_11_18_6_18_6_5
9037,219,1333081200,5,2,99,1333081200,0,3797940,3797940,0,26_26_26_26_26_26_26_26_26_26_8_8_38_38_17_17_17_17_17_17_17_1_17_1_1_1_17_17_1_1_17_17_1_17_1_17_1_1_3_25_3_25_18_18_18_18_18_18_18_18_18_18_15_15_15_15_15_15_3_3_18_18_18_18_18_18_18_18_15_15_15_15_6_6_5_5_2_5_2_5_5_5_6_6_5_5
9038,131,1333081200,5,2,5,1333082400,1200,6821100,6825900,4800,16_16_16_16_16_16_16_16_16_16_16_16_16_16_16_16_16_16_16_16_16_16_16_16_16_16_1_1_1_1_2_2_3_3_3_3_18_18_18_18_18_3_3_3_3_18_18_18_18_18_18_18_18_18_18_18_18_18_18_18_18_18_18_18_5_5_5_5_5_5_5_5_5_5_5_5_6_6_5_5_6_6_5_5_5_5_5_5_5_5_5_5_6_6_5_5_34_34_34_34_3_3_18_18_18_18_18_18_6_6_5_5_34_34_5_5_5_5_5_5_5_5_5_5_6_6_5_5_34_34_34_34_3_3_5_6_6_5_5
9039,38,1333081260,1,9,99,1333081260,0,43560,43560,0,19_19_19_19_1_1
9040,13,1333081260,5,9,5,1333092480,11220,2514720,2525940,11220,19_19_19_1_1_19_19_19_19_19_19_19_19_19_19_19_1_1_1_19_1_19_19_19_19_19_19_19_19_19_19_1_19_1_19_19_19_19_19_19_1_1_1_1_19_19_19_19_1_1_1_1_1_1_19_19_1_19_1_19_19_19_19_19_2_2_9_9_2_2_1_9_1_3_1_3_9_1_1_1_19_1_1_19_19_3_19_3_3_3_9_19_9_19_3_3_1_19_1_3_3_19_19_19_19_19_19_19_3_3_2_2_3_3_1_1_4_4_4_4_4_4_4_6_6_6_6_4_4_4_4_9_9_3_5_3_4_5_4_4_4_4_6_6_5
9041,131,1333082400,5,2,5,1333084320,1920,6822300,6825900,3600,16_16_16_16_16_16_16_16_16_16_16_16_16_16_16_16_16_16_16_16_16_16_16_16_16_16_1_1_1_1_2_2_3_3_3_3_18_18_18_18_18_3_3_3_3_18_18_18_18_18_18_18_18_18_18_18_18_18_18_18_18_18_18_18_5_5_5_5_5_5_5_5_5_5_5_5_6_6_5_5_6_6_5_5_5_5_5_5_5_5_5_5_6_6_5_5_34_34_34_34_3_3_18_18_18_18_18_18_6_6_5_5_34_34_5_5_5_5_5_5_5_5_5_5_6_6_5_5_34_34_34_34_3_3_5_6_6_5_5_5
9042,196,1333082400,8,18,99,1333082400,0,3281700,3281700,0,7_7_7_7_7_7_7_7_7_7_7_7_7_7_7_7_7_7_7_7_1_1_1_1_7_7_1_1_7_7_1_1_7_7_7_1_1_7_7_7_7_7_7_7_7_7_1_1_7_7_7_30_30_7_1_7_7_1_7_1_1_7_7_7_1_7_7_1_1_1_7_7_30_30_1_1_10_10_10_1_1_10_10_10_10_1_1_10_10_10_10_8_8_7_10_10_7_10_10_10_10_10_7_7_7_7_7_7_8_8_10_10_7_7_1_30_1_30_8_7_8_11_11_7_10_10_8_10_7_10_8_7_10_10_7_7_7_10_7_10_10_7_7_8_10_8_10_10_8_8
9043,65,1333083600,5,18,5,1333086000,2400,7542000,7544400,2400,17_17_34_34_6_6_6_6_5_5_1_1_1_1_2_2_3_3_5_5_5_5_3_3_18_18_18_18_18_18_18_18_18_18_5_5_5_5_6_6_5
9044,63,1333083600,5,2,5,1333084320,720,6232140,6232860,720,16_16_16_16_16_16_16_16_16_0_0_16_16_0_16_16_0_16_16_0_0_16_16_16_0_0_16_0_0_16_0_16_0_0_0_16_1_1_1_16_16_16_0_1_1_1_16_0_0_16_16_0_16_0_16_0_0_2_2_1_1_0_0_0_0_2_2_2_2_2_2_0_1_0_1_1_0_0_0_1_1_0_0_1_1_1_0_0_0_0_0_2_2_2_2_0_0_0_0_0_0_1_1_1_1_0_0_16_0_16_16_16_16_16_0_0_1_1_2_2_1_1_16_0_2_16_2_2_2_0_1_1_1_1_1_16_16_1_1_1_3_3_18_3_18_3_3_3_3_3_18_18_18_18_3_3_3_3_18_18_18_18_18_18_18_5_5_5_18_5_18_18_18_18_18_5_5_5_18_18_18_5_6_6_5_5_5_5_3_5_18_3_3_3_18_16_18_16_5_18_18_6_3_6_18_3_18_18_5_5_18_5_5_5_5_5_5_5_5_5_18_3_5_3_18_3_3_3_3_18_18_18_18_3_5_5_18_3_18_6_3_6_3_18_3_3_18_18_5_5_3_18_3_5_34_34_3_3_18_5_18_3_2_3_2_18_5_34_18_3_5_5_3_5_3_3_5_18_3_34_3_5_18_18_18_18_18_18_18_18_18_18_18_18_18_18_18_18_18_18_34_34_5_34_5_34_5_5_6_6_5_5_6_6_5_5_5_5_5_5_5_5_5_5_5_5_5_5_5_5_34_34_34_34_34_34_5_5_34_34_11_11_6_6_5_5_6_6_5
9045,63,1333084320,5,2,99,1333084320,0,6232860,6232860,0,16_16_16_16_16_16_16_16_16_0_0_16_16_0_16_16_0_16_16_0_0_16_16_16_0_0_16_0_0_16_0_16_0_0_0_16_1_1_1_16_16_16_0_1_1_1_16_0_0_16_16_0_16_0_16_0_0_2_2_1_1_0_0_0_0_2_2_2_2_2_2_0_1_0_1_1_0_0_0_1_1_0_0_1_1_1_0_0_0_0_0_2_2_2_2_0_0_0_0_0_0_1_1_1_1_0_0_16_0_16_16_16_16_16_0_0_1_1_2_2_1_1_16_0_2_16_2_2_2_0_1_1_1_1_1_16_16_1_1_1_3_3_18_3_18_3_3_3_3_3_18_18_18_18_3_3_3_3_18_18_18_18_18_18_18_5_5_5_18_5_18_18_18_18_18_5_5_5_18_18_18_5_6_6_5_5_5_5_3_5_18_3_3_3_18_16_18_16_5_18_18_6_3_6_18_3_18_18_5_5_18_5_5_5_5_5_5_5_5_5_18_3_5_3_18_3_3_3_3_18_18_18_18_3_5_5_18_3_18_6_3_6_3_18_3_3_18_18_5_5_3_18_3_5_34_34_3_3_18_5_18_3_2_3_2_18_5_34_18_3_5_5_3_5_3_3_5_18_3_34_3_5_18_18_18_18_18_18_18_18_18_18_18_18_18_18_18_18_18_18_34_34_5_34_5_34_5_5_6_6_5_5_6_6_5_5_5_5_5_5_5_5_5_5_5_5_5_5_5_5_34_34_34_34_34_34_5_5_34_34_11_11_6_6_5_5_6_6_5_5
9046,131,1333084320,5,2,5,1333086000,1680,6824220,6825900,1680,16_16_16_16_16_16_16_16_16_16_16_16_16_16_16_16_16_16_16_16_16_16_16_16_16_16_1_1_1_1_2_2_3_3_3_3_18_18_18_18_18_3_3_3_3_18_18_18_18_18_18_18_18_18_18_18_18_18_18_18_18_18_18_18_5_5_5_5_5_5_5_5_5_5_5_5_6_6_5_5_6_6_5_5_5_5_5_5_5_5_5_5_6_6_5_5_34_34_34_34_3_3_18_18_18_18_18_18_6_6_5_5_34_34_5_5_5_5_5_5_5_5_5_5_6_6_5_5_34_34_34_34_3_3_5_6_6_5_5_5_5
9047,65,1333086000,5,18,99,1333086000,0,7544400,7544400,0,17_17_34_34_6_6_6_6_5_5_1_1_1_1_2_2_3_3_5_5_5_5_3_3_18_18_18_18_18_18_18_18_18_18_5_5_5_5_6_6_5_5
9048,76,1333086000,5,2,5,1333090380,4380,7544400,7552500,8100,3_3_3_3_3_3_3_3_3_18_3_18_18_18_18_18_3_3_3_1_1_3_17_17_17_18_17_17_18_18_18_18_18_17_17_18_3_3_18_17_18_18_17_18_18_17_17_17_5_5_5_5_1_1_17_17_17_2_2_17_17_17_5_5_5_5_5_5_17_17_5_5_5_17_5_5_5_5_5_17_17_17_1_1_1_1_1_1_1_1_2_2_34_34_5_5_5_5_6_6_3_3_4_3_3_4_4_4_4_4_3_3_3_3_3_3_4_3_3_3_3_4_4_4_3_4_4_4_3_4_4_4_3_3_4_4_4_4_5_3_3_5_5_5_5_5_4_5_4_5_4_3_3_3_3_4_3_3_4_4_5_5_5_4_5_5_5_4_6_6_34_34_5_5_34_34_34_34_5_5_5_5_6_6_5_5_5_5_34_34_6_6_6_6_6_6_34_34_6_6_5_5_5_5_6_6_5
9049,131,1333086000,5,2,99,1333086000,0,6825900,6825900,0,16_16_16_16_16_16_16_16_16_16_16_16_16_16_16_16_16_16_16_16_16_16_16_16_16_16_1_1_1_1_2_2_3_3_3_3_18_18_18_18_18_3_3_3_3_18_18_18_18_18_18_18_18_18_18_18_18_18_18_18_18_18_18_18_5_5_5_5_5_5_5_5_5_5_5_5_6_6_5_5_6_6_5_5_5_5_5_5_5_5_5_5_6_6_5_5_34_34_34_34_3_3_18_18_18_18_18_18_6_6_5_5_34_34_5_5_5_5_5_5_5_5_5_5_6_6_5_5_34_34_34_34_3_3_5_6_6_5_5_5_5_5
9050,58,1333086000,5,18,5,1333091820,5820,986280,992100,5820,19_19_19_1_19_19_1_19_19_19_19_19_19_19_19_19_1_1_1_1_2_2_3_3_3_3_3_13_13_13_3_13_13_13_3_3_6_6_5
9051,45,1333086960,5,6,5,1333090620,3660,32160,35820,3660,6_6_5
9052,190,1333087200,7,25,7,1333098000,10800,694800,705600,10800,7_7_1_1_7_7_7_7_7_7_7
9053,42,1333087380,5,6,99,1333087380,0,953340,953340,0,16_16_16_16_1_1_2_2_3_3_18_18_18_18_18_18_11_11_18_6_18_6_5_5
9054,76,1333090380,5,2,5,1333090380,0,7548780,7552500,3720,3_3_3_3_3_3_3_3_3_18_3_18_18_18_18_18_3_3_3_1_1_3_17_17_17_18_17_17_18_18_18_18_18_17_17_18_3_3_18_17_18_18_17_18_18_17_17_17_5_5_5_5_1_1_17_17_17_2_2_17_17_17_5_5_5_5_5_5_17_17_5_5_5_17_5_5_5_5_5_17_17_17_1_1_1_1_1_1_1_1_2_2_34_34_5_5_5_5_6_6_3_3_4_3_3_4_4_4_4_4_3_3_3_3_3_3_4_3_3_3_3_4_4_4_3_4_4_4_3_4_4_4_3_3_4_4_4_4_5_3_3_5_5_5_5_5_4_5_4_5_4_3_3_3_3_4_3_3_4_4_5_5_5_4_5_5_5_4_6_6_34_34_5_5_34_34_34_34_5_5_5_5_6_6_5_5_5_5_34_34_6_6_6_6_6_6_34_34_6_6_5_5_5_5_6_6_5_5
9055,76,1333090380,5,2,5,1333091700,1320,7548780,7552500,3720,3_3_3_3_3_3_3_3_3_18_3_18_18_18_18_18_3_3_3_1_1_3_17_17_17_18_17_17_18_18_18_18_18_17_17_18_3_3_18_17_18_18_17_18_18_17_17_17_5_5_5_5_1_1_17_17_17_2_2_17_17_17_5_5_5_5_5_5_17_17_5_5_5_17_5_5_5_5_5_17_17_17_1_1_1_1_1_1_1_1_2_2_34_34_5_5_5_5_6_6_3_3_4_3_3_4_4_4_4_4_3_3_3_3_3_3_4_3_3_3_3_4_4_4_3_4_4_4_3_4_4_4_3_3_4_4_4_4_5_3_3_5_5_5_5_5_4_5_4_5_4_3_3_3_3_4_3_3_4_4_5_5_5_4_5_5_5_4_6_6_34_34_5_5_34_34_34_34_5_5_5_5_6_6_5_5_5_5_34_34_6_6_6_6_6_6_34_34_6_6_5_5_5_5_6_6_5_5_5
9056,45,1333090620,5,6,99,1333090620,0,35820,35820,0,6_6_5_5
9057,76,1333091700,5,2,5,1333091700,0,7550100,7552500,2400,3_3_3_3_3_3_3_3_3_18_3_18_18_18_18_18_3_3_3_1_1_3_17_17_17_18_17_17_18_18_18_18_18_17_17_18_3_3_18_17_18_18_17_18_18_17_17_17_5_5_5_5_1_1_17_17_17_2_2_17_17_17_5_5_5_5_5_5_17_17_5_5_5_17_5_5_5_5_5_17_17_17_1_1_1_1_1_1_1_1_2_2_34_34_5_5_5_5_6_6_3_3_4_3_3_4_4_4_4_4_3_3_3_3_3_3_4_3_3_3_3_4_4_4_3_4_4_4_3_4_4_4_3_3_4_4_4_4_5_3_3_5_5_5_5_5_4_5_4_5_4_3_3_3_3_4_3_3_4_4_5_5_5_4_5_5_5_4_6_6_34_34_5_5_34_34_34_34_5_5_5_5_6_6_5_5_5_5_34_34_6_6_6_6_6_6_34_34_6_6_5_5_5_5_6_6_5_5_5_5
9058,76,1333091700,5,2,5,1333092300,600,7550100,7552500,2400,3_3_3_3_3_3_3_3_3_18_3_18_18_18_18_18_3_3_3_1_1_3_17_17_17_18_17_17_18_18_18_18_18_17_17_18_3_3_18_17_18_18_17_18_18_17_17_17_5_5_5_5_1_1_17_17_17_2_2_17_17_17_5_5_5_5_5_5_17_17_5_5_5_17_5_5_5_5_5_17_17_17_1_1_1_1_1_1_1_1_2_2_34_34_5_5_5_5_6_6_3_3_4_3_3_4_4_4_4_4_3_3_3_3_3_3_4_3_3_3_3_4_4_4_3_4_4_4_3_4_4_4_3_3_4_4_4_4_5_3_3_5_5_5_5_5_4_5_4_5_4_3_3_3_3_4_3_3_4_4_5_5_5_4_5_5_5_4_6_6_34_34_5_5_34_34_34_34_5_5_5_5_6_6_5_5_5_5_34_34_6_6_6_6_6_6_34_34_6_6_5_5_5_5_6_6_5_5_5_5_5
9059,58,1333091820,5,18,99,1333091820,0,992100,992100,0,19_19_19_1_19_19_1_19_19_19_19_19_19_19_19_19_1_1_1_1_2_2_3_3_3_3_3_13_13_13_3_13_13_13_3_3_6_6_5_5
9060,21,1333091880,1,18,1,1333096860,4980,465480,470460,4980,19_19_19_19_19_19_1
9061,76,1333092300,5,2,5,1333092900,600,7550700,7552500,1800,3_3_3_3_3_3_3_3_3_18_3_18_18_18_18_18_3_3_3_1_1_3_17_17_17_18_17_17_18_18_18_18_18_17_17_18_3_3_18_17_18_18_17_18_18_17_17_17_5_5_5_5_1_1_17_17_17_2_2_17_17_17_5_5_5_5_5_5_17_17_5_5_5_17_5_5_5_5_5_17_17_17_1_1_1_1_1_1_1_1_2_2_34_34_5_5_5_5_6_6_3_3_4_3_3_4_4_4_4_4_3_3_3_3_3_3_4_3_3_3_3_4_4_4_3_4_4_4_3_4_4_4_3_3_4_4_4_4_5_3_3_5_5_5_5_5_4_5_4_5_4_3_3_3_3_4_3_3_4_4_5_5_5_4_5_5_5_4_6_6_34_34_5_5_34_34_34_34_5_5_5_5_6_6_5_5_5_5_34_34_6_6_6_6_6_6_34_34_6_6_5_5_5_5_6_6_5_5_5_5_5_5_5
9062,76,1333092300,5,2,5,1333092300,0,7550700,7552500,1800,3_3_3_3_3_3_3_3_3_18_3_18_18_18_18_18_3_3_3_1_1_3_17_17_17_18_17_17_18_18_18_18_18_17_17_18_3_3_18_17_18_18_17_18_18_17_17_17_5_5_5_5_1_1_17_17_17_2_2_17_17_17_5_5_5_5_5_5_17_17_5_5_5_17_5_5_5_5_5_17_17_17_1_1_1_1_1_1_1_1_2_2_34_34_5_5_5_5_6_6_3_3_4_3_3_4_4_4_4_4_3_3_3_3_3_3_4_3_3_3_3_4_4_4_3_4_4_4_3_4_4_4_3_3_4_4_4_4_5_3_3_5_5_5_5_5_4_5_4_5_4_3_3_3_3_4_3_3_4_4_5_5_5_4_5_5_5_4_6_6_34_34_5_5_34_34_34_34_5_5_5_5_6_6_5_5_5_5_34_34_6_6_6_6_6_6_34_34_6_6_5_5_5_5_6_6_5_5_5_5_5_5
9063,13,1333092480,5,9,99,1333092480,0,2525940,2525940,0,19_19_19_1_1_19_19_19_19_19_19_19_19_19_19_19_1_1_1_19_1_19_19_19_19_19_19_19_19_19_19_1_19_1_19_19_19_19_19_19_1_1_1_1_19_19_19_19_1_1_1_1_1_1_19_19_1_19_1_19_19_19_19_19_2_2_9_9_2_2_1_9_1_3_1_3_9_1_1_1_19_1_1_19_19_3_19_3_3_3_9_19_9_19_3_3_1_19_1_3_3_19_19_19_19_19_19_19_3_3_2_2_3_3_1_1_4_4_4_4_4_4_4_6_6_6_6_4_4_4_4_9_9_3_5_3_4_5_4_4_4_4_6_6_5_5
9064,76,1333092900,5,2,5,1333092900,0,7551300,7552500,1200,3_3_3_3_3_3_3_3_3_18_3_18_18_18_18_18_3_3_3_1_1_3_17_17_17_18_17_17_18_18_18_18_18_17_17_18_3_3_18_17_18_18_17_18_18_17_17_17_5_5_5_5_1_1_17_17_17_2_2_17_17_17_5_5_5_5_5_5_17_17_5_5_5_17_5_5_5_5_5_17_17_17_1_1_1_1_1_1_1_1_2_2_34_34_5_5_5_5_6_6_3_3_4_3_3_4_4_4_4_4_3_3_3_3_3_3_4_3_3_3_3_4_4_4_3_4_4_4_3_4_4_4_3_3_4_4_4_4_5_3_3_5_5_5_5_5_4_5_4_5_4_3_3_3_3_4_3_3_4_4_5_5_5_4_5_5_5_4_6_6_34_34_5_5_34_34_34_34_5_5_5_5_6_6_5_5_5_5_34_34_6_6_6_6_6_6_34_34_6_6_5_5_5_5_6_6_5_5_5_5_5_5_5_5
9065,76,1333092900,5,2,5,1333094100,1200,7551300,7552500,1200,3_3_3_3_3_3_3_3_3_18_3_18_18_18_18_18_3_3_3_1_1_3_17_17_17_18_17_17_18_18_18_18_18_17_17_18_3_3_18_17_18_18_17_18_18_17_17_17_5_5_5_5_1_1_17_17_17_2_2_17_17_17_5_5_5_5_5_5_17_17_5_5_5_17_5_5_5_5_5_17_17_17_1_1_1_1_1_1_1_1_2_2_34_34_5_5_5_5_6_6_3_3_4_3_3_4_4_4_4_4_3_3_3_3_3_3_4_3_3_3_3_4_4_4_3_4_4_4_3_4_4_4_3_3_4_4_4_4_5_3_3_5_5_5_5_5_4_5_4_5_4_3_3_3_3_4_3_3_4_4_5_5_5_4_5_5_5_4_6_6_34_34_5_5_34_34_34_34_5_5_5_5_6_6_5_5_5_5_34_34_6_6_6_6_6_6_34_34_6_6_5_5_5_5_6_6_5_5_5_5_5_5_5_5_5
9066,39,1333094100,1,2,1,1333097400,3300,232440,235740,3300,0_0_0_0_0_0_1
9067,76,1333094100,5,2,99,1333094100,0,7552500,7552500,0,3_3_3_3_3_3_3_3_3_18_3_18_18_18_18_18_3_3_3_1_1_3_17_17_17_18_17_17_18_18_18_18_18_17_17_18_3_3_18_17_18_18_17_18_18_17_17_17_5_5_5_5_1_1_17_17_17_2_2_17_17_17_5_5_5_5_5_5_17_17_5_5_5_17_5_5_5_5_5_17_17_17_1_1_1_1_1_1_1_1_2_2_34_34_5_5_5_5_6_6_3_3_4_3_3_4_4_4_4_4_3_3_3_3_3_3_4_3_3_3_3_4_4_4_3_4_4_4_3_4_4_4_3_3_4_4_4_4_5_3_3_5_5_5_5_5_4_5_4_5_4_3_3_3_3_4_3_3_4_4_5_5_5_4_5_5_5_4_6_6_34_34_5_5_34_34_34_34_5_5_5_5_6_6_5_5_5_5_34_34_6_6_6_6_6_6_34_34_6_6_5_5_5_5_6_6_5_5_5_5_5_5_5_5_5_5
9068,175,1333095240,10,16,10,1333096980,1740,17820,19560,1740,10_10_10
9069,175,1333095240,10,16,10,1333095240,0,17820,19560,1740,10_10
9070,204,1333095720,18,19,3,1333096260,540,2562660,2567700,5040,16_16_16_16_16_16_16_16_16_16_16_16_16_16_16_16_16_16_16_16_16_16_1_1_1_1_1_16_1_2_2_16_16_16_16_16_16_16_16_16_16_1_16_1_16_16_16_16_16_16_1_1_16_16_16_16_16_16_2_16_2_16_1_1_1_1_1_2_2_2_2_1_1_1_1_1_3_3_3_3_18_18_18_18_18_18_3_1_1_3_1_1_18_18
9071,206,1333095780,4,19,4,1333134000,38220,2037720,2086740,49020,16_16_16_16_1_1_2_2_3_3_3_3_4_4_4_4_4_4_4_4
9072,36,1333095900,0,1,0,1333140180,44280,63360,129360,66000,0_0_0_0_0_0
9073,37,1333096020,16,1,99,1333096020,0,736020,736020,0,16_16_16_16_16_16_16_16_16_16_16_16_16_16_16_16_16_16_16_16_16_16_16_16_16_16_16_16_16_1_1_16_16_16_16_16_16_16_16_1_1_16_16_16_16_16_16_16_16_16_16_16_16_1_1_16_16_16_16_16_16_1_1_16_16_16_16_16_16_1_1_16
9074,204,1333096260,3,3,3,1333100760,4500,2563200,2567700,4500,16_16_16_16_16_16_16_16_16_16_16_16_16_16_16_16_16_16_16_16_16_16_1_1_1_1_1_16_1_2_2_16_16_16_16_16_16_16_16_16_16_1_16_1_16_16_16_16_16_16_1_1_16_16_16_16_16_16_2_16_2_16_1_1_1_1_1_2_2_2_2_1_1_1_1_1_3_3_3_3_18_18_18_18_18_18_3_1_1_3_1_1_18_18_3
9075,21,1333096860,1,18,99,1333096860,0,470460,470460,0,19_19_19_19_19_19_1_1
9076,175,1333096980,10,16,99,1333096980,0,19560,19560,0,10_10_10_10
9077,160,1333097100,11,15,99,1333097100,0,1564260,1564260,0,16_16_16_16_0_16_0_16_1_16_1_16_16_16_16_16_16_16_1_1_2_2_3_3_3_3_18_18_18_18_18_18_18_18_18_18_18_18_18_18_18_11_11_18_11_11
9078,9,1333097220,17,10,99,1333097220,0,18660,18660,0,17_17
9079,39,1333097400,1,2,99,1333097400,0,235740,235740,0,0_0_0_0_0_0_1_1
9080,190,1333098000,7,25,99,1333098000,0,705600,705600,0,7_7_1_1_7_7_7_7_7_7_7_7
9081,204,1333100760,3,3,99,1333100760,0,2567700,2567700,0,16_16_16_16_16_16_16_16_16_16_16_16_16_16_16_16_16_16_16_16_16_16_1_1_1_1_1_16_1_2_2_16_16_16_16_16_16_16_16_16_16_1_16_1_16_16_16_16_16_16_1_1_16_16_16_16_16_16_2_16_2_16_1_1_1_1_1_2_2_2_2_1_1_1_1_1_3_3_3_3_18_18_18_18_18_18_3_1_1_3_1_1_18_18_3_3
9082,206,1333134000,4,5,4,1333144800,10800,2075940,2086740,10800,16_16_16_16_1_1_2_2_3_3_3_3_4_4_4_4_4_4_4_4_4
9083,36,1333140180,0,0,0,1333161900,21720,107640,129360,21720,0_0_0_0_0_0_0
9084,206,1333144800,4,5,99,1333144800,0,2086740,2086740,0,16_16_16_16_1_1_2_2_3_3_3_3_4_4_4_4_4_4_4_4_4_4
9085,36,1333161900,0,0,99,1333161900,0,129360,129360,0,0_0_0_0_0_0_0_0
