,id,elapsed_time,total_time,remaining_time,XG_2000,RF_50,LM_pred,Lasso
5523,76,4772400,7552500,2780100,2785475.5,2779905.6,2470826.97076,2766906.8363
113,76,56100,7552500,7496400,7500346.5,5894372.4,5678371.06122,4189109.08627
5932,204,0,2567700,2567700,1347053.875,1451515.2,2190984.73621,1465914.98806
5616,220,20400,2714040,2693640,1855584.375,1744082.4,1588129.4696,2014014.68715
4190,203,1248900,1897500,648600,646588.5625,643498.8,0.0,581513.735018
3116,141,2744100,7406100,4662000,4690200.5,4652163.6,4562888.02979,4824724.74053
7743,98,6421080,7319880,898800,903842.0,923931.6,1137708.77679,1217895.26333
8393,196,2907780,3281700,373920,380952.375,374041.2,400993.2724,596674.993065
5314,156,2635680,2639280,3600,3155.84667969,11275.2,686106.194092,-206481.756137
6486,63,4244220,6232860,1988640,2084794.375,2036925.6,219171791.613,2299138.07632
2305,98,1845180,7319880,5474700,5526258.5,5434057.2,7073640.94147,5322435.01272
5305,214,24420,341760,317340,224409.3125,413796.0,81513.0880127,278226.29985
1924,83,1263420,1818000,554580,560357.125,784404.0,390071.523254,671953.539258
7052,151,3467400,3643800,176400,172386.296875,201862.8,271147.545227,-73126.1737215
4759,131,3459900,6825900,3366000,3347880.5,3364328.4,3624435.47284,3277633.29207
4432,63,2540880,6232860,3691980,3654102.0,3696292.8,0.0,3804823.57254
6798,75,5332500,6135000,802500,804273.25,814578.0,479632.960022,896081.679762
7568,75,5916660,6135000,218340,509843.25,761479.2,376054.62738,-94511.1364778
5104,103,4112820,4719960,607140,611486.875,617425.2,6718268446.24,779849.989379
8017,22,112980,810360,697380,673656.1875,529096.8,0.0,867.33435026
1184,129,1184400,1188000,3600,0.0,738069.6,0.0,-1309153.40178
2752,156,619440,2639280,2019840,1960137.125,2002527.6,1996410.94128,1514420.34974
5425,63,3401940,6232860,2830920,2816475.75,2827119.6,3616028.6568,2939648.66752
5917,220,180060,2714040,2533980,2309512.0,2262228.0,1854966.37256,2562838.9271
4167,163,117840,548880,431040,1078014.25,747074.4,0.0,332420.415202
115,146,70560,6670800,6600240,6554480.5,6336732.0,5387938.68274,4638556.21952
8899,58,907560,992100,84540,83816.4765625,85449.6,98414.9945068,-266077.705408
1291,66,1261200,4817700,3556500,3555764.25,3660246.0,3116969.93378,3435851.91929
7500,13,1308240,2525940,1217700,1079704.875,1210970.4,338437.07312,788310.313031
7932,220,1936440,2714040,777600,770258.375,776222.4,857252.530884,794609.898061
3093,130,1540380,3083940,1543560,1554621.5,1536349.2,1088144.13153,1908335.25425
7625,63,5218140,6232860,1014720,1076826.625,989508.0,0.0,916030.640077
1564,110,1391040,5579400,4188360,4179242.5,4190973.6,3830677.84967,3705594.95532
1295,66,1269600,4817700,3548100,3553247.75,3655881.6,3265613.98676,3432254.67375
3817,182,242580,915060,672480,656554.6875,843854.4,0.0,-185292.492334
4014,203,1147080,1897500,750420,742408.125,742614.0,0.0,809812.776942
660,84,464940,3714840,3249900,3186312.0,3030194.4,4289633.36554,3381238.90173
6473,218,1974480,1974480,0,7498.94628906,85323.6,0.0,-240400.433552
2979,67,2667840,3120480,452640,594306.9375,452506.8,885407.557434,881106.3069
4356,107,1441800,4991760,3549960,3561999.25,3552132.0,3401248.94891,3449750.65301
4442,156,1998000,2639280,641280,644108.125,638332.8,1053231.7652,736973.85342
3743,73,847500,1303500,456000,499961.0625,707866.8,562261.075684,1022294.08378
20,67,300,3120480,3120180,3221509.5,2975694.0,0.0,2386880.65868
4474,135,3333660,5649480,2315820,2406819.25,2268874.8,2380779.48108,2263477.12367
8269,196,2768520,3281700,513180,502783.0625,518146.8,0.0,471435.088904
4539,151,1342740,3643800,2301060,2403222.75,2298529.2,2640729.77222,2717811.55932
1050,118,329820,459900,130080,477225.90625,791954.4,472211.181152,408985.573081
6299,146,5444400,6670800,1226400,1374871.25,1249135.2,0.0,1485618.76547
869,110,727680,5579400,4851720,4739588.0,4552510.8,3466537.26019,3036190.20776
2959,114,99480,1201080,1101600,853162.75,1069630.8,1999979.9566,1522729.04712
3069,72,2061960,2385960,324000,946207.0625,462580.8,1593686.22198,1126479.21908
4107,0,1330860,1560960,230100,311043.96875,243190.8,1304470.77802,1076954.83771
7931,15,1100820,1822860,722040,713815.4375,732715.2,383955.534851,723930.115189
1201,77,73320,3257040,3183720,3121024.0,3195441.6,1290575.65881,1983845.0894
313,91,14460,1030200,1015740,1172153.25,1228723.2,2776924.13708,3020054.03673
7885,42,113880,953340,839460,675166.3125,524226.0,1836576.02826,1270141.64171
4297,213,284520,3206820,2922300,2951387.75,2919201.6,3619049.94348,3719960.68005
3788,130,2147460,3083940,936480,906668.625,916435.2,18600744924.6,1094767.00262
1250,140,1051320,1300140,248820,240604.4375,247075.2,448710.21167,855805.048436
8477,139,24600,273900,249300,159472.875,249744.0,497682.765015,385657.467233
2193,101,272460,655020,382560,417661.625,538590.0,537719.887268,165153.942315
8450,224,335580,648060,312480,290040.84375,267134.4,0.0,-218182.525579
7001,204,1026180,2567700,1541520,1539131.875,1543593.6,1481496.58746,1550021.97584
5771,134,3652980,3656580,3600,273219.9375,470667.6,149002.461853,-228542.119838
1651,97,292800,294600,1800,516502.28125,1300563.6,2383159.0509,2498096.62216
8458,37,393000,736020,343020,346802.125,335773.2,894739.959534,779449.18231
4877,130,3055140,3083940,28800,13241.4667969,39412.8,0.0,-98097.9349032
5090,19,16740,608940,592200,711380.4375,985076.4,518031.836487,274965.046674
8426,65,7193040,7544400,351360,338583.90625,345211.2,172694.465698,184954.547593
2509,153,34080,1618560,1584480,1916718.125,1951242.0,863994.455811,1659034.37307
3077,142,2489160,7299960,4810800,4854390.5,4806840.0,4631418.01245,4990373.66036
7585,131,5790300,6825900,1035600,1071079.5,1023397.2,1260876.73291,1081420.59827
2324,63,737280,6232860,5495580,5497234.0,5492547.6,0.0,5376354.39789
3066,141,2591760,7406100,4814340,4834664.0,4821364.8,5176381.11005,5071284.61852
696,84,511380,3714840,3203460,3276687.5,3121873.2,3166865.44177,3582800.27459
6852,187,1814940,2496960,682020,627375.625,616180.8,606338.458557,41638.438798
4234,213,247140,3206820,2959680,2913685.5,2940571.2,3633580.99445,3640775.69407
9021,37,715500,736020,20520,59733.234375,74271.6,0.0,366827.027311
3636,71,2502720,3996240,1493520,1546277.875,1496460.0,1991268.7876,1464750.59906
5848,123,3544020,3545820,1800,90533.0234375,458247.6,0.0,297201.654039
6882,5,465900,748200,282300,315834.25,271633.2,279930.837952,453770.459269
8667,30,604800,604800,0,0.0,9692.4,0.0,-336027.202978
8875,224,586860,648060,61200,0.0,51978.0,0.0,-5980.94132957
8355,14,1099320,1327560,228240,440198.90625,210828.0,0.0,175766.030299
2105,77,827040,3257040,2430000,2396013.5,2381854.8,2822346.94763,2590907.87047
922,131,35340,6825900,6790560,6650967.5,6671010.0,5063068.3797,4264688.82248
3264,107,582180,4991760,4409580,4386305.5,4352374.8,4501664.95923,4237932.48285
8554,196,3020100,3281700,261600,262357.84375,259182.0,0.0,116916.806225
3921,60,3429600,7401300,3971700,2763657.0,3405658.8,4361748.60266,4009214.60629
8391,37,348120,736020,387900,396543.0625,373968.0,2333457.8092,2928934.50239
588,106,506220,1023180,516960,510001.625,522666.0,3313452518.47,465663.160931
213,146,156420,6670800,6514380,6522085.0,6520906.8,5778487.8277,5242848.90808
1998,63,527820,6232860,5705040,5782614.0,5708343.6,5874801.71289,5857300.91115
5808,4,118140,1326000,1207860,1239438.375,1169062.8,763514.75238,659012.953715
2189,166,24600,1666080,1641480,1439359.0,1607836.8,1500179.89398,1115352.55036
5075,62,3592860,3674460,81600,121808.3125,255217.2,0.0,699593.120181
3232,192,287700,4648740,4361040,4439643.5,4360272.0,4565598.36139,3953158.16098
5735,4,84720,1326000,1241280,1445294.375,1271665.2,266135.892395,386378.641478
3703,203,807900,1897500,1089600,1098021.375,1092525.6,19296725501.4,1320816.68347
5459,24,17940,1547520,1529580,1419223.75,1357086.0,2677318.34338,2170862.91813
2956,135,2083860,5649480,3565620,3112414.5,3069819.6,4504180.48462,3567105.54813
8491,65,7226040,7544400,318360,213073.3125,279456.0,408522.187988,216100.051078
6277,63,4104360,6232860,2128500,2143150.75,2130250.8,224903364.846,2184802.91544
6104,155,2226300,3225180,998880,983870.875,987109.2,296521.347046,645450.461706
5899,196,721320,3281700,2560380,2532900.0,2555947.2,5932316495.57,2260403.23051
5939,220,194100,2714040,2519940,2406697.75,2242392.0,2354713.59857,1783274.24475
2839,203,90780,1897500,1806720,1907100.75,1553968.8,1168415.91479,1439077.47973
2517,142,2094360,7299960,5205600,5193175.5,5125334.4,0.0,4906041.67701
2485,143,366300,1898460,1532160,1494897.0,1503529.2,1289096.5423,1098784.04171
5574,10,40800,979740,938940,1521637.375,1224152.4,1227445.61169,1390461.99891
6596,131,4905060,6825900,1920840,1918745.875,1941338.4,0.0,2102798.28845
2455,101,599220,655020,55800,307763.9375,210831.6,0.0,-527081.383658
6955,204,1002960,2567700,1564740,1562553.0,1578277.2,1231602.05493,1564522.74911
8578,64,6729900,6845160,115260,160785.390625,144202.8,638834.580383,57377.9386217
6346,63,4157520,6232860,2075340,2083799.875,2071144.8,64097929.9284,2225798.98086
891,144,174840,1807260,1632420,1617054.125,1601116.8,1668872.17847,1781228.6495
8892,13,2436420,2525940,89520,66553.578125,99788.4,30438356424.6,130460.942089
3772,147,1479360,1479360,0,46708.28125,94176.0,395848.361084,145880.549486
7968,2,2555580,2555640,60,135979.59375,156807.6,24126.6790161,-157583.046442
2166,112,908100,1303440,395340,394518.9375,549997.2,643182.392517,484477.438182
3706,203,808200,1897500,1089300,1090835.125,1090694.4,18648700821.3,1320688.21042
3254,130,1782480,3083940,1301460,1331071.25,1293018.0,939774.136597,1258288.56789
8377,14,1115040,1327560,212520,253813.859375,224926.8,0.0,358992.174111
3775,188,192360,4327560,4135200,4012613.0,3723130.8,3105177.70923,2587455.78078
2131,77,859440,3257040,2397600,2362415.25,2412364.8,2112717.38849,2392343.77527
6094,63,3954060,6232860,2278800,2265981.5,2333575.2,2365731.14191,2596596.46135
4731,187,62040,2496960,2434920,2081629.0,1896858.0,725140.260559,903103.595211
3707,182,26700,915060,888360,968092.75,1074380.4,141924.782288,448237.662841
8940,219,3742560,3797940,55380,60014.9375,59362.8,340883.057922,298145.183637
4119,218,109020,1974480,1865460,1611937.5,1342267.2,1521671.61786,1000173.1686
8853,13,2421420,2525940,104520,113647.757812,148934.4,0.0,35841.6072364
5809,4,118200,1326000,1207800,1308608.0,1163320.8,790487.166809,663177.953775
5388,214,234840,341760,106920,87760.53125,177967.2,715162.875,395711.66131
5986,204,44700,2567700,2523000,2285140.25,2378542.8,3093490.12567,2630062.24449
7415,8,0,615060,615060,614985.875,634282.8,383066.228943,575237.576185
942,83,258120,1818000,1559880,1742983.875,1505937.6,2538763.10803,2311482.10503
1374,103,1002120,4719960,3717840,3717801.25,3743241.6,3412289.11792,3578006.66895
1238,131,450480,6825900,6375420,6371374.0,6371140.8,5411302.38208,4984315.16692
7031,157,1684200,1993260,309060,289983.09375,302102.4,0.0,149863.774414
7855,13,1671840,2525940,854100,823274.5625,854928.0,274711.620667,733952.434664
4212,119,2310780,2742780,432000,464224.0625,355822.8,354158.124695,666645.083993
6998,222,268800,1113000,844200,763999.8125,652423.2,0.0,-448115.117
281,51,222000,280800,58800,24893.5019531,349171.2,0.0,-345152.323453
3357,130,1855380,3083940,1228560,1226865.25,1228957.2,1330733.3172,1243647.50296
295,65,214200,7544400,7330200,6319242.5,6785653.2,8120596.94556,7188588.92641
3283,148,1653900,1938900,285000,302899.09375,295453.2,524497.429199,457539.457268
1102,61,1152480,6225300,5072820,5695426.5,5174870.4,4695208.94989,5201105.29389
1192,87,1090800,1090800,0,0.0,110132.4,0.0,-600134.357915
1008,66,926460,4817700,3891240,3900307.0,3644898.0,3925511.06866,3921959.55952
2866,158,277800,2044680,1766880,1783743.0,1770788.4,1023793.35248,1963115.75089
2751,130,1294200,3083940,1789740,1756828.75,1775296.8,790675.598572,1597354.81505
3941,155,519000,3225180,2706180,2584538.0,2132427.6,2010344.10748,1980060.29782
2188,12,850020,850020,0,11092.21875,6837.6,194328.874023,428732.425595
7606,188,3386820,4327560,940740,989641.375,960895.2,389513.741577,863842.650352
1139,104,266460,935100,668640,2129815.25,1567642.8,6659466.96436,4782160.99545
1524,132,157380,1658640,1501260,1590452.5,1337032.8,2398216.36902,2333560.21852
8776,64,6833100,6845160,12060,39867.9648438,28347.6,134693.187073,-189654.392179
550,120,572400,576000,3600,0.0,186879.6,2610128.72827,1968099.52598
5748,213,1405140,3206820,1801680,1793936.125,1818588.0,0.0,1690722.45304
829,83,177300,1818000,1640700,1640981.375,1683892.8,2351489.51306,2491640.67667
3919,166,1614600,1666080,51480,34989.9140625,215461.2,1330079.32489,372658.17401
5371,214,204420,341760,137340,177925.375,167132.4,16554794660.7,1618261.0094
2483,70,1690920,3064200,1373280,1416059.375,1738735.2,1107610.34546,1086970.56146
5169,98,4208580,7319880,3111300,3209770.5,2984108.4,3302341.08582,2950948.47922
4940,2,68340,2555640,2487300,2412584.0,2182550.4,1497904.82733,1417879.5427
4945,103,4020060,4719960,699900,640750.375,638755.2,555116.39917,851993.227703
6233,220,581580,2714040,2132460,2293348.75,1917924.0,0.0,2012837.7924
2472,143,360120,1898460,1538340,1497608.875,1385262.0,1020106.87115,699843.143273
8043,211,34560,87180,52620,0.0,218538.0,590788.583496,421236.039487
5162,217,108180,557700,449520,488676.0625,673159.2,1735705.97516,1237144.08678
5189,20,3600,39660,36060,38026.2578125,197438.4,905823.053345,1115437.15516
3979,114,1062600,1201080,138480,149753.953125,159346.8,667044.740417,354549.968659
6820,5,431580,748200,316620,329127.65625,325462.8,0.0,-327188.610178
5736,4,84720,1326000,1241280,1472059.375,1270285.2,837666.035339,642466.454491
6770,13,722280,2525940,1803660,1802180.375,1776625.2,1881298.88812,1784922.03775
6564,61,5686200,6225300,539100,619348.8125,745039.2,0.0,813707.930564
6943,31,686520,1374660,688140,689475.3125,693272.4,888889.958374,741358.764496
4847,2,20880,2555640,2534760,1938808.125,1733496.0,1462887.83429,700652.689732
5839,213,1459260,3206820,1747560,1751488.125,1802581.2,2093954.52399,1789870.7006
4207,135,3182400,5649480,2467080,2460702.0,2465830.8,2192841.2359,2339480.00358
6704,204,698760,2567700,1868940,1862736.25,1863769.2,2163588.4054,1944754.41565
790,75,95280,6135000,6039720,6056393.0,5883105.6,4870868.17957,4290069.01836
1212,77,83580,3257040,3173460,2293485.5,3220512.0,2137832.5047,1666415.11457
6693,204,689100,2567700,1878600,1873570.125,1877221.2,1945213.03571,2025827.31654
6516,110,5567400,5579400,12000,16744.9257812,553698.0,0.0,235412.481777
1976,133,557340,6181200,5623860,5621202.0,5505199.2,5894879.48688,5280484.21464
8739,162,4831620,4836120,4500,20112.1445312,107853.6,476625.127014,-316254.896796
5826,220,147660,2714040,2566380,2605230.75,2412858.0,3169504.25568,2979626.41651
2375,156,252600,2639280,2386680,2652105.75,2565597.6,3182132.81927,3283241.67906
5378,71,3945600,3996240,50640,91107.234375,119781.6,2652289941.71,452511.580772
3813,119,2052480,2742780,690300,683142.1875,647512.8,1413030.71979,1349116.08826
8916,219,3731400,3797940,66540,43888.75,69858.0,91255.7024536,178828.345604
6533,32,102240,1205580,1103340,1066309.25,911196.0,878423.720276,919204.239271
5663,193,74340,187200,112860,1007837.8125,860084.4,0.0,-78054.7854073
1470,138,1379340,1785600,406260,379142.59375,491037.6,616162.172119,591132.886121
368,124,257400,754200,496800,478553.40625,362401.2,2676015410.23,166423.460302
6238,63,4076400,6232860,2156460,2216726.5,2156449.2,2894405359.39,2309602.09491
4612,142,3876600,7299960,3423360,3381517.75,3407812.8,2826121.19568,3415514.84058
3685,203,794160,1897500,1103340,1175600.25,1103413.2,1577751.84155,1324401.22684
6926,167,38100,534900,496800,694212.0,533546.4,0.0,903418.483578
8908,37,651840,736020,84180,46972.0625,76321.2,0.0,327454.265895
1357,138,1309620,1785600,475980,475185.96875,459652.8,914997.061584,760779.453645
8146,13,1843020,2525940,682920,682072.6875,681544.8,167298.998901,780694.721931
8936,29,51180,57540,6360,0.0,153514.8,0.0,18184.5219114
7222,205,116100,460800,344700,444979.84375,445154.4,0.0,348269.629161
146,76,86400,7552500,7466100,7453603.5,7468671.6,8053928.19983,7472194.41926
8499,159,2421180,2480580,59400,31991.4179688,67164.0,0.0,-1155456.31769
486,141,372000,7406100,7034100,7020411.5,7033860.0,6668074.56183,6267339.40629
5959,56,4492800,6361440,1868640,1872796.0,1754666.4,2619288.11963,2164229.49059
1190,127,599940,599940,0,1587.53894043,25526.4,0.0,-182958.395246
1041,88,422340,555360,133020,84740.359375,333523.2,845566.898682,1620646.12831
3165,98,2701380,7319880,4618500,4621566.0,4621375.2,4982703.31622,4774730.3459
198,138,180000,1785600,1605600,1531489.875,1650807.6,2825548.95013,2714177.87818
1218,122,347820,861720,513900,739626.9375,702387.6,325940.307495,740997.815813
1881,98,1555740,7319880,5764140,5788195.0,5681487.6,5976093.12628,5915456.92697
2202,101,274740,655020,380280,435316.25,546033.6,0.0,64762.7468812
4663,215,1729320,1851720,122400,203572.953125,196347.6,0.0,-550075.007006
1820,111,1781880,3974400,2192520,2218663.25,2194347.6,2823403.25427,2148777.03471
6826,18,518700,1779540,1260840,1210417.75,1237573.2,1648328.18109,1312687.1755
7141,205,77760,460800,383040,576579.5625,511988.4,0.0,108237.298698
8173,197,621960,626580,4620,139629.765625,69048.0,780783.064758,1079014.05585
4083,131,2935500,6825900,3890400,3896131.0,3881640.0,3425895.38922,3527206.01732
5412,177,1488720,1713060,224340,323161.40625,231038.4,435171.313232,809446.510679
8227,37,118800,736020,617220,613427.5625,613801.2,1545758.47601,1503658.56956
6343,63,4156140,6232860,2076720,2077602.0,2077792.8,126900758.754,2150536.12441
5241,103,4186020,4719960,533940,547199.0625,552952.8,14034960293.6,563318.362375
4934,156,2416920,2639280,222360,232371.21875,225322.8,519266.656677,351528.410243
9055,76,7548780,7552500,3720,4072.92236328,3165.6,33143779550.0,151033.622753
203,149,177540,223140,45600,48669.296875,55388.4,0.0,212728.81702
6414,54,1277460,1314000,36540,18661.2109375,81338.4,0.0,-420657.539986
3238,184,5760,1800900,1795140,1725808.5,1675104.0,1004166.4209,1199005.49889
8492,133,5978040,6181200,203160,239703.375,237880.8,78653.3797607,2155.54208656
6949,89,1731840,1736340,4500,66035.09375,79432.8,204647.16925,419621.610911
2789,173,55680,3215700,3160020,3155059.5,3142765.2,2982342.49835,3101913.18703
7439,75,5704320,6135000,430680,362480.28125,276892.8,699518.339844,409389.761346
6161,155,2279160,3225180,946020,884325.6875,986088.0,1056803.7356,302314.733785
1646,12,338640,850020,511380,524869.0625,569370.0,658612.032532,1384674.02025
309,65,225600,7544400,7318800,6237593.5,6649126.8,7978997.35248,7285315.85532
521,150,555180,626340,71160,86092.6015625,200330.4,0.0,-735874.028239
1392,110,1267320,5579400,4312080,4456904.0,4275998.4,2571631.36279,3223510.24781
1253,131,459180,6825900,6366720,6229518.5,6222036.0,6243539.05231,5187823.54417
7962,7,26160,40380,14220,643262.9375,427905.6,691317.75238,638910.289784
7187,188,2990220,4327560,1337340,1342805.5,1338450.0,1495060.42792,1412306.94298
3418,166,1143000,1666080,523080,471024.84375,552654.0,7297.27026367,317565.964547
451,150,527400,626340,98940,206152.734375,228004.8,0.0,205312.756306
8950,29,54900,57540,2640,0.0,30042.0,0.0,-105545.941794
2770,165,73440,1262880,1189440,1133638.875,1124108.4,2190949323.39,1122142.34119
5908,4,170400,1326000,1155600,1133834.125,1155334.8,1368719.99994,1010810.87166
2639,107,2940,4991760,4988820,4263509.0,4368288.0,4109633.00311,5008429.23585
367,76,284400,7552500,7268100,7252674.5,7263856.8,9342820.84308,7751618.15387
3820,151,899220,3643800,2744580,2834912.75,2750067.6,2895035.04053,2596262.67159
4351,131,3107760,6825900,3718140,3756795.0,3721995.6,3584366.82013,3766887.10925
5731,134,3624600,3656580,31980,32729.2949219,341346.0,95538.9333496,95403.8587828
5644,76,4842900,7552500,2709600,2705581.5,2583729.6,3735240.76385,3069434.70092
8014,26,1481880,2036760,554880,654574.3125,546274.8,523756.116516,572773.950217
3503,188,3480,4327560,4324080,2721268.75,2822120.4,2432043.24353,1980803.30322
396,141,193140,7406100,7212960,7191987.0,7057168.8,5679810.50806,5578077.89349
1585,63,99060,6232860,6133800,5826919.5,5847289.2,3865462.50891,4055156.152
8736,40,148620,163800,15180,0.0,16600.8,518393.655212,966756.28083
8129,196,2600700,3281700,681000,703661.1875,684223.2,0.0,145958.250011
8559,220,2478060,2714040,235980,232341.625,232045.2,992639.675171,316395.164852
983,75,259560,6135000,5875440,5764138.0,6004705.2,5248427.3363,4525135.96446
498,60,370140,7401300,7031160,6845168.5,6370498.8,3111752.58612,4274034.17463
6935,195,72300,393120,320820,442744.4375,383221.2,1197969.09259,654957.901437
2246,156,156720,2639280,2482560,2827194.25,2672108.4,3071577.75873,3168586.29808
3139,142,2667540,7299960,4632420,4653831.0,4658114.4,4262487.10474,4700901.06242
4456,168,59820,438000,378180,319735.21875,690528.0,1464615.24402,1111434.88818
2273,75,1458060,6135000,4676940,3715488.5,3858546.0,3216229.96094,3445837.48772
4711,156,2289120,2639280,350160,349234.15625,349856.4,0.0,260753.005828
1762,1,432720,1447140,1014420,1004241.375,972319.2,1289581.76788,1715130.33067
3371,203,596160,1897500,1301340,1327712.125,1329657.6,812732.230469,1256919.47379
7360,167,272100,534900,262800,211611.421875,250429.2,0.0,22725.0133506
9009,63,6206940,6232860,25920,33247.1328125,79062.0,125145573.568,76439.2370692
1544,133,119100,6181200,6062100,6066392.0,5996498.4,4398349.57477,4279393.8149
6646,10,898920,979740,80820,280517.5625,203306.4,395046.303528,-277518.20532
2674,133,1165500,6181200,5015700,5009113.0,5018240.4,6462195.96564,4932780.92057
940,83,255600,1818000,1562400,1497544.25,1515852.0,2228882.33295,2234547.72774
7644,186,2694000,3636240,942240,895184.125,751425.6,3705266592.04,288076.954007
8935,57,2756640,2756640,0,0.0,108812.4,0.0,250591.658346
1825,98,1503360,7319880,5816520,5812930.0,5812725.6,5621781.19025,5596762.48889
3815,116,324900,786600,461700,363500.15625,461482.8,300146.85968,792853.588659
3201,156,1062600,2639280,1576680,1577002.375,1600248.0,1459933.6062,1472317.97716
5430,49,3988800,3991980,3180,0.0,40356.0,0.0,284734.353453
4628,191,2460,1811280,1808820,1817456.875,1670876.4,2568405.88995,1234857.10701
7663,183,38040,445560,407520,532748.4375,559654.8,0.0,-477646.609862
5958,63,3701340,6232860,2531520,2528137.75,2528624.4,7697116.59869,2644961.49992
6072,13,96960,2525940,2428980,2259183.5,2388286.8,1415569.60315,1153876.77444
4724,141,4039200,7406100,3366900,3369349.75,3364916.4,2619657.1803,3083433.29954
1710,98,1316580,7319880,6003300,5986359.0,5971502.4,6176861.39941,6273336.76843
3260,130,1784820,3083940,1299120,1305092.625,1299151.2,1127176.46509,1607041.20883
7549,172,971220,1443960,472740,419506.09375,257766.0,0.0,-716901.314497
175,60,0,7401300,7401300,3199440.5,3846261.6,3067092.30817,3061501.34645
331,79,149820,4151700,4001880,4036704.0,4002798.0,5082928.41388,4429873.19829
2304,126,202560,496560,294000,296498.9375,478382.4,627246.749878,915556.341373
3523,71,2421780,3996240,1574460,1490573.75,1495767.6,1663107.82867,995193.644815
8599,212,204240,204240,0,20660.9414062,65908.8,0.0,7345.72479721
2717,165,36720,1262880,1226160,1295787.875,1101291.6,608322.580017,901619.262038
7220,61,6225300,6225300,0,303.965270996,7958.4,1835438542.83,1866.65302533
2415,94,504000,534480,30480,237669.578125,288459.6,984866.872498,769190.2743
6065,204,120480,2567700,2447220,2445361.25,2420534.4,3024681.77643,3146867.36789
1987,56,1299600,6361440,5061840,5130243.0,4978556.4,4968400.55103,4355365.38376
1420,113,12240,3646740,3634500,5407192.5,5014407.6,4275670.25232,3727822.04443
1064,131,314400,6825900,6511500,6518291.5,6359930.4,5015670.03204,4476767.02326
4436,0,1521240,1560960,39720,32429.9863281,82629.6,0.0,46021.9943893
4653,74,2854140,2979600,125460,637944.125,508090.8,3438844.21814,2939705.09777
3726,73,820200,1303500,483300,539342.0625,782194.8,2502151.86676,827129.593025
246,120,226800,576000,349200,353774.28125,368624.4,955542.16333,1637495.63174
4690,158,1846140,2044680,198540,145366.0,156133.2,353528.91394,505284.637747
5029,86,3519180,3519180,0,180613.1875,251229.6,7645697803.58,14372.5829806
143,109,96900,274500,177600,0.0,237529.2,104837.061951,501937.455978
1570,1,170880,1447140,1276260,1272892.0,1305306.0,2171123.23767,2381379.16404
24,68,50400,262800,212400,588265.5625,447264.0,1499854.15021,2106553.50546
6735,204,735660,2567700,1832040,1842282.25,1841584.8,2182400.16473,1905509.36569
8180,224,14640,648060,633420,338575.84375,388844.4,0.0,237060.26532
500,79,401400,4151700,3750300,3489948.5,2810305.2,2362415.01147,3185068.10786
8446,30,463920,604800,140880,213416.015625,135919.2,848896.989746,184982.89233
6833,2,1706160,2555640,849480,769342.5625,749762.4,0.0,-151729.748169
5862,76,4964220,7552500,2588280,2588285.0,2585871.6,0.0,2664970.31478
5680,142,4656420,7299960,2643540,2642877.75,2643798.0,3916348.15259,2792440.40646
3171,67,2944320,3120480,176160,190998.46875,176856.0,0.0,190427.965871
8991,131,6794700,6825900,31200,0.0,40855.2,115574.321777,13890.651048
3782,188,197940,4327560,4129620,3918392.5,3747342.0,2517862.96985,2184778.30624
4574,135,3521760,5649480,2127720,2126798.5,2113466.4,2440748.76624,2421595.34018
1142,76,1089000,7552500,6463500,6465377.0,6454330.8,6690877.26355,6325288.02141
477,91,267420,1030200,762780,668978.1875,704907.6,1866098.7901,2059425.37254
5279,113,3181500,3646740,465240,429300.375,470731.2,59848.0975952,481406.212427
7080,48,131040,156420,25380,0.0,29986.8,416313.891113,911181.502209
2891,171,317100,435600,118500,23238.7421875,162565.2,668773.586487,980636.362453
7376,213,2750280,3206820,456540,519128.875,405924.0,14698988975.1,-67687.2320423
2002,102,85440,3198240,3112800,3149447.25,3032004.0,2064154.96063,2005022.18733
3202,142,2706540,7299960,4593420,4595125.5,4599061.2,3587893.66547,4481558.43005
6920,151,3388680,3643800,255120,307115.5,249399.6,1204495.43286,512986.863098
7722,76,6605880,7552500,946620,940825.8125,943664.4,13241200601.6,959402.35341
2278,83,1508400,1818000,309600,302697.90625,306288.0,76527.5742798,319991.826952
6384,18,86820,1779540,1692720,1633859.125,1665819.6,1280004.20929,1440642.0445
8939,65,7483800,7544400,60600,0.0,191247.6,447069.428162,208174.789871
4883,180,989280,3322080,2332800,2247355.0,2304081.6,1683167.84064,2227861.39012
577,106,504000,1023180,519180,515210.9375,532850.4,1599038.64246,365908.734056
5445,169,601320,2190660,1589340,1512883.375,1586061.6,1477885.45947,1546562.32184
5265,125,3969060,3969060,0,0.0,152319.6,0.0,-801004.899162
2267,65,2023200,7544400,5521200,5264428.5,4603881.6,5733407.62775,4770755.92073
5282,213,968460,3206820,2238360,2177672.0,2241108.0,1931335.21515,2409109.1377
555,120,576000,576000,0,0.0,194342.4,2916724.43494,2169076.54124
5268,71,3738600,3996240,257640,156740.6875,274209.6,15059540883.7,80291.0174896
4426,96,2081400,2123400,42000,134517.9375,66102.0,0.0,130608.33389
6850,89,1663680,1736340,72660,102675.945312,197306.4,1248225.34869,664627.663958
2377,1,876540,1447140,570600,522750.34375,470013.6,1381275.25903,1234830.93644
9010,13,2491860,2525940,34080,44341.3398438,27223.2,0.0,63224.2220397
6432,151,2922300,3643800,721500,716145.6875,699532.8,1006671.04401,864064.183936
898,118,161400,459900,298500,318310.78125,380344.8,518397.537781,813185.384292
1614,66,1480260,4817700,3337440,3253376.5,3430072.8,4010963.33643,3597743.34848
7212,4,1326000,1326000,0,0.0,43224.0,19679.1268921,41385.1086178
5997,76,5042220,7552500,2510280,2512218.0,2511477.6,2185379.67828,2405127.32282
2053,83,1341780,1818000,476220,477505.03125,479226.0,608090.237244,506089.754706
7472,75,5740260,6135000,394740,346255.0,224218.8,420518.681824,225023.004055
7511,219,2598480,3797940,1199460,1228032.25,1214334.0,1624934.00903,1408589.35663
1020,131,171240,6825900,6654660,6394339.0,6183616.8,3938940.26166,3807826.84706
1075,106,997200,1023180,25980,0.0,87801.6,160897.680481,-74150.1791433
1404,130,94740,3083940,2989200,2990486.0,2989981.2,2001711.48767,3314299.15438
6183,31,38520,1374660,1336140,1336211.375,1380087.6,1312248.24164,845953.69329
1801,79,1604340,4151700,2547360,2560639.25,2429325.6,6733014776.25,2117062.06584
5682,142,4656540,7299960,2643420,2637604.0,2640680.4,12184803220.6,2792389.01724
2949,84,2489820,3714840,1225020,1178811.5,1275332.4,1376580.00409,1571945.39433
686,80,144900,338580,193680,120340.570312,769544.4,1634269.92206,2149331.31969
531,93,443280,1242300,799020,997091.5625,962582.4,0.0,2738808.19349
1876,63,443160,6232860,5789700,5804636.5,5788614.0,5671276.59503,6049722.96058
2092,119,468960,2742780,2273820,2094710.125,1819090.8,1772900.70538,1909962.09796
4244,135,3215280,5649480,2434200,2433893.0,2437156.8,0.0,2541287.48868
2942,50,4500,35220,30720,25356.4550781,68564.4,42731.7426147,298082.697362
8099,30,111420,604800,493380,429518.9375,478262.4,1523132.271,1100506.26888
6453,155,2475300,3225180,749880,725053.4375,745964.4,659053.654297,844064.094675
4161,163,116040,548880,432840,706187.3125,572878.8,357212.348816,342764.99472
8251,13,1929000,2525940,596940,583910.6875,573458.4,177474.321472,277294.497067
7078,167,124080,534900,410820,466847.9375,429715.2,339567.353882,622977.677316
4485,199,742740,975720,232980,237678.515625,213357.6,0.0,22052.3345001
3771,203,865260,1897500,1032240,1045070.75,1024467.6,0.0,1073096.44892
524,142,279360,7299960,7020600,7390705.0,7020468.0,6375999.42328,5864253.44247
2013,102,86640,3198240,3111600,3260426.0,3098920.8,4603021.4906,3694023.96538
7960,11,1451340,1777560,326220,321419.03125,337153.2,401229.085083,731772.592341
9036,42,946680,953340,6660,54607.5585938,8749.2,265313.877869,371292.114952
3322,198,34500,708660,674160,694100.625,724554.0,688780.793762,1136406.21911
8001,18,1386960,1779540,392580,393759.75,348295.2,22473406711.2,275657.999285
5794,169,808260,2190660,1382400,1273718.75,1346308.8,951202.406067,1454543.30932
8373,212,49860,204240,154380,134165.96875,196056.0,0.0,-343597.274035
4998,71,3585120,3996240,411120,421226.59375,409623.6,0.0,301139.305765
7865,13,1674120,2525940,851820,845717.25,852844.8,982840.571716,850280.199021
7094,167,129840,534900,405060,385307.625,403526.4,0.0,179008.940879
8335,209,1075080,1091400,16320,33958.6484375,24298.8,1249699.96143,848911.782808
6148,26,9840,2036760,2026920,2225818.5,2083772.4,2542322.00128,2003278.8018
3559,137,159540,243720,84180,0.0,168901.2,0.0,-395441.645523
3334,130,1840140,3083940,1243800,1200665.375,1244494.8,296243.375,742758.862528
3807,98,3258180,7319880,4061700,4054319.0,4084179.6,18993833802.4,4168819.8072
8809,160,1422240,1564260,142020,136583.828125,137930.4,337427.36322,317367.508011
5720,57,168780,2756640,2587860,2607456.25,2213924.4,3015644.81726,2468413.12146
4229,107,1355400,4991760,3636360,3687327.75,3656407.2,4351248.69006,3920124.49137
2909,67,2612640,3120480,507840,519196.4375,506229.6,135051.24939,925187.672453
8363,212,42900,204240,161340,378198.21875,200720.4,0.0,-207143.942272
923,76,754920,7552500,6797580,6782925.0,6733849.2,7348467.98364,7038043.0722
4411,71,3123960,3996240,872280,987300.8125,875007.6,0.0,1228526.75537
4657,63,2803020,6232860,3429840,3370777.75,3464402.4,2576908.04193,3451867.38455
1763,56,1149240,6361440,5212200,5132151.0,4195272.0,4607955.12085,4092155.45438
5658,213,1368780,3206820,1838040,1886203.0,1892308.8,1543437.93469,1967059.53161
433,87,423000,1090800,667800,853586.1875,856902.0,1838001.81891,2394768.7116
1343,1,14340,1447140,1432800,2286521.0,2525870.4,0.0,1725016.91349
3963,203,1121640,1897500,775860,781282.75,787627.2,0.0,594873.639121
4890,107,1871880,4991760,3119880,3094094.5,3036267.6,3692898.31805,3269165.90966
5295,113,3188460,3646740,458280,484964.0,244981.2,722372.814331,939248.458999
5556,98,4590180,7319880,2729700,2738660.5,2773622.4,2448279.63892,2763279.93489
5454,169,602880,2190660,1587780,1509603.75,1581847.2,0.0,1457622.61674
6490,172,169200,1443960,1274760,1353033.25,1232514.0,716511.019043,745338.434796
4114,96,1897500,2123400,225900,298561.59375,267915.6,544952.301514,288714.163736
3347,72,2385960,2385960,0,0.0,44061.6,0.0,-60429.6460554
6310,141,5330820,7406100,2075280,1927023.5,1952206.8,8818228374.1,2448997.4005
1577,82,921360,2195880,1274520,1210700.5,1758902.4,722915.666382,1609823.68677
6260,26,93660,2036760,1943100,1969012.25,1947507.6,2604371.75439,2445335.1091
7509,157,1993260,1993260,0,132483.53125,75195.6,574442.541321,-69112.9950821
4299,133,2530500,6181200,3650700,3600127.0,3639972.0,3693479.02246,3849520.03599
5119,141,4264200,7406100,3141900,3141629.25,3142044.0,2903097.17572,3069301.42734
9078,9,18660,18660,0,737493.9375,758468.4,2452144.93201,1958505.5117
5795,103,4669020,4719960,50940,57344.21875,105163.2,0.0,184479.264301
5492,19,406860,608940,202080,403426.5,378592.8,1555589.84747,695841.227085
4477,199,739020,975720,236700,220959.015625,224460.0,173437.851074,17831.5955339
2777,92,127320,613860,486540,496404.40625,744022.8,1414847712.11,519956.708316
8310,26,1805160,2036760,231600,231023.34375,237649.2,778870.246765,214018.571678
1970,133,551760,6181200,5629440,5627915.0,5449999.2,6038725.81238,5164252.81575
6729,5,242700,748200,505500,559149.3125,524580.0,415176.586792,375847.826473
3128,151,295980,3643800,3347820,3293475.75,2477053.2,1448419.04022,1531744.9244
7965,6,123120,133560,10440,304785.6875,161379.6,1711479.39294,1414944.42232
5167,157,59160,1993260,1934100,1852282.875,1806409.2,860749.652832,834071.667062
6553,64,5032200,6845160,1812960,1794801.5,1638937.2,1799075.13641,1750735.70648
8999,206,1998360,2086740,88380,18718.1601562,132657.6,0.0,33165.2358247
1619,145,68580,586680,518100,524292.0625,663433.2,1361850.73553,1556737.59995
3409,137,64320,243720,179400,180039.359375,271708.8,306245.494995,455802.775405
8867,188,4321560,4327560,6000,69636.453125,40998.0,0.0,19425.4753685
7649,63,5228700,6232860,1004160,988914.5,985113.6,317646977.449,546917.738792
1679,110,1466700,5579400,4112700,4125257.5,4109974.8,3893514.92114,3545990.61656
1235,117,30180,1144740,1114560,1512357.5,1135556.4,3105021.92999,1916177.43638
7623,15,887340,1822860,935520,917507.5,944038.8,1166522.44263,978887.404293
2315,83,1527060,1818000,290940,307985.78125,277748.4,0.0,285038.040579
4899,142,4041360,7299960,3258600,3249220.0,3256700.4,3262614.96094,3278778.10204
9022,36,42960,129360,86400,127842.0,694728.0,929720.59436,1187141.22602
5798,63,3618840,6232860,2614020,2663113.75,2617940.4,0.0,2858915.29514
2832,158,260280,2044680,1784400,2129798.5,1954081.2,1648866.22571,2125437.11626
3012,67,2683020,3120480,437460,344304.625,430990.8,167934.311035,709165.001637
954,144,239400,1807260,1567860,1515958.0,1428818.4,2539655.75238,2202284.80739
5814,63,3638520,6232860,2594340,2587655.75,2609744.4,0.0,2813043.08851
8613,30,570420,604800,34380,87912.8828125,63505.2,548956.636963,-254272.405057
8619,196,3052500,3281700,229200,227871.875,219235.2,0.0,260974.591806
8300,14,1067700,1327560,259860,276340.46875,253212.0,668955.406799,380444.652059
8759,152,3680160,3766500,86340,72420.125,182601.6,0.0,250151.96089
7523,176,1206240,1462860,256620,190939.609375,258183.6,309886.665527,-414833.713622
3598,111,3266400,3974400,708000,688224.8125,698262.0,0.0,389175.988926
2256,108,844140,3191940,2347800,2377835.25,2346871.2,2372327.84747,2629099.04765
1143,83,571380,1818000,1246620,1197223.0,1059855.6,1779319.05328,1281137.59757
902,144,182040,1807260,1625220,1633073.875,1562928.0,1705432.20856,1657730.79184
4027,203,1153500,1897500,744000,731655.375,736927.2,865078.982727,665242.942285
3661,61,3322140,6225300,2903160,2888786.25,2951829.6,3327620.8689,2963503.85291
2230,108,808500,3191940,2383440,2369648.5,2387554.8,2665565.52869,2467190.0074
5446,107,2336520,4991760,2655240,2663607.5,2777116.8,2758555.86005,2673158.65893
8661,63,6030540,6232860,202320,198435.296875,200234.4,97735795.1946,290955.250249
5359,210,94920,1118160,1023240,1217538.375,1011168.0,262864.787598,513017.396131
6297,31,125100,1374660,1249560,1241399.625,1235236.8,1449948.72638,1626593.03084
8716,65,7372800,7544400,171600,127039.609375,436599.6,85674.7922974,42602.0160074
3158,173,445680,3215700,2770020,2782426.5,2773243.2,3131039.53986,2517353.27272
5236,180,1194840,3322080,2127240,2159451.0,2035231.2,1477697.08148,2037027.52142
4737,186,328380,3636240,3307860,3439691.5,3210752.4,3811617.05426,2930502.34365
2943,96,828300,2123400,1295100,1297345.875,1295910.0,1328339.99963,1232812.38552
5232,20,35160,39660,4500,867049.6875,639165.6,3333642965.88,1196614.70359
5827,220,147660,2714040,2566380,2472936.5,2414899.2,2400475.00781,2501995.02054
7019,18,631500,1779540,1148040,1146229.375,1128644.4,1237854.00354,1193912.50515
8192,14,852000,1327560,475560,619881.5625,451004.4,0.0,593929.06352
6066,204,129300,2567700,2438400,2413221.5,2431866.0,3005762.52051,3147088.69021
850,103,459540,4719960,4260420,3761173.75,3729217.2,4914533.34845,3958429.38437
3197,173,465660,3215700,2750040,2746609.5,2749698.0,2095722.21576,2649761.56146
1593,142,1194360,7299960,6105600,6041372.5,6039040.8,4888401.6767,5904038.09154
2733,165,44940,1262880,1217940,1271379.125,1042682.4,0.0,804033.285356
7617,15,884820,1822860,938040,936660.75,948458.4,79466.005249,575991.861177
4577,213,563280,3206820,2643540,2668005.75,2666658.0,3166824.7594,2963826.36211
3540,84,3033540,3714840,681300,686932.0,671149.2,180100.85675,672117.081456
1316,60,1118400,7401300,6282900,5530608.5,4628064.0,5370626.71063,4664098.86466
4796,142,3985980,7299960,3313980,3241890.75,3298627.2,2676902.34308,3286370.50938
905,144,182400,1807260,1624860,1710409.25,1603174.8,1375293.32013,1554212.35216
2457,156,423780,2639280,2215500,2415459.5,2226382.8,2825190.21997,3218723.46422
6830,204,923040,2567700,1644660,1563255.125,1616224.8,2206931.04431,1984487.79106
2495,144,1740300,1807260,66960,78982.6640625,72284.4,0.0,355546.458386
1711,82,1028880,2195880,1167000,1051931.5,1490702.4,1323591.6225,1648278.27154
7744,8,361680,615060,253380,249569.328125,235843.2,0.0,-528151.112827
6609,208,73140,1620480,1547340,1941297.25,1442431.2,2560945.06873,2061371.12015
8150,13,1843320,2525940,682620,671234.5625,683236.8,0.0,917817.470902
1526,122,547200,861720,314520,310309.78125,323310.0,0.0,261587.502866
5422,98,4510980,7319880,2808900,2855766.0,2799201.6,3042171.81641,3028839.07156
8725,37,557220,736020,178800,147342.328125,486596.4,0.0,126119.716942
7043,195,120120,393120,273000,342908.3125,301510.8,0.0,303981.833886
8863,13,2426460,2525940,99480,106768.117188,102482.4,0.0,33683.259907
4699,71,3408480,3996240,587760,588079.3125,658639.2,29349819739.8,617464.555982
6014,13,31680,2525940,2494260,2422908.0,2362129.2,1574245.66168,1074902.63806
2629,98,2181180,7319880,5138700,5143564.0,5124024.0,5426992.94354,5261369.85522
3621,188,76500,4327560,4251060,3731736.5,2584872.0,1924825.8692,1968415.91465
3690,116,117660,786600,668940,768287.5625,853923.6,1457188.00641,1352416.54456
7731,13,1586400,2525940,939540,900235.4375,945303.6,564718.279663,1040382.98041
3893,71,2800980,3996240,1195260,1175477.75,1184275.2,2810381.67059,1071119.13222
3391,155,11580,3225180,3213600,2556255.5,2111215.2,1219281.64264,1581120.31665
3595,116,47760,786600,738840,813109.8125,714354.0,704947.991638,872169.574429
25,111,46800,3974400,3927600,3857550.5,3474050.4,2636081.80994,3205939.36015
1501,146,1351020,6670800,5319780,5285457.0,5322615.6,4635317.72455,4942713.40481
5629,146,4852800,6670800,1818000,1741976.625,1840753.2,18992051472.8,1922193.44796
1160,76,1095840,7552500,6456660,6458599.0,6440481.6,7328946.73541,6231970.10966
6421,155,2451660,3225180,773520,782695.6875,774198.0,886711.716431,423868.101241
5395,146,4708680,6670800,1962120,1960834.625,1966165.2,1764120.21521,1984272.7237
938,62,13920,3674460,3660540,3767829.5,3917856.0,5791130.79413,5202730.45908
3256,161,597300,1955580,1358280,1339745.125,1196260.8,815169.496033,1524435.76596
7367,167,276600,534900,258300,276203.28125,260168.4,404274.087219,172496.85081
5661,57,137760,2756640,2618880,2685582.25,2622536.4,2931549.78998,2519225.24978
3167,23,904920,1894920,990000,971383.875,954116.4,1978288.33038,1261454.46074
3370,173,600060,3215700,2615640,2588383.0,2614857.6,1762561.78992,1678937.32403
8577,159,2476980,2480580,3600,0.0,72516.0,0.0,-1282772.38593
2783,98,2306040,7319880,5013840,4958199.5,4900507.2,4890873.3175,4975445.29353
4578,47,0,31200,31200,144353.671875,397305.6,1443657.11432,1329018.57166
3052,201,53040,1645440,1592400,1596351.5,1819569.6,2745003.56177,2098724.94581
5457,24,17340,1547520,1530180,1756939.375,1859629.2,2096436.13403,1430625.5286
6390,218,1922100,1974480,52380,89362.78125,144404.4,0.0,-561825.441534
1604,104,592500,935100,342600,375025.40625,473898.0,1904962746.68,419533.828524
7692,220,1788840,2714040,925200,902335.1875,919872.0,1503686.47571,711851.31619
6174,63,4024620,6232860,2208240,2205650.0,2208526.8,29901808.9086,2258338.62918
263,138,251280,1785600,1534320,1435736.75,1433649.6,2174197.43408,2293940.03976
5570,142,4575780,7299960,2724180,2682285.5,2713056.0,0.0,2953884.4026
111,120,105240,576000,470760,512076.28125,855643.2,2421850.79889,1937624.64942
7514,176,1201740,1462860,261120,237288.40625,252192.0,11081.9017944,-425520.422048
5832,102,3198240,3198240,0,0.0,205117.2,83029.2600098,307564.372603
4336,168,4140,438000,433860,2056853.625,1860243.6,1413724.12036,1603405.52476
2869,67,2600340,3120480,520140,473423.34375,493405.2,30642.2492065,788170.865797
3461,137,78120,243720,165600,241421.578125,246184.8,460535.095154,311110.8101
641,100,449640,919500,469860,461297.71875,554575.2,1841701.04584,1570021.91963
49,146,3180,6670800,6667620,7140908.5,6316646.4,3588086.7821,3645981.91055
6622,13,616920,2525940,1909020,1805442.5,1880263.2,1977066.51752,1686317.02317
7554,188,3343200,4327560,984360,1027147.625,1050650.4,170975.78772,762938.965841
5300,134,3203400,3656580,453180,446396.4375,457520.4,705966.285583,306433.078307
3140,156,1028100,2639280,1611180,1534850.5,1615017.6,1369108.71442,1515001.8263
7130,213,2601360,3206820,605460,618959.5625,616688.4,0.0,618456.267135
8020,63,5483340,6232860,749520,735069.3125,734508.0,0.0,769097.303045
506,60,373020,7401300,7028280,6948217.5,6377371.2,932100.549988,4417285.5529
1100,106,1023180,1023180,0,48406.6835938,78946.8,333935.77771,-148878.713169
67,146,39600,6670800,6631200,6299224.5,6364988.4,5003775.78033,4389969.76311
7401,27,118260,402780,284520,417307.71875,288598.8,1142273.27747,1277661.00295
8567,139,84360,273900,189540,198709.6875,135646.8,0.0,-135303.366302
5671,193,79800,187200,107400,894726.25,923428.8,0.0,-212044.497593
1140,104,266520,935100,668580,708820.5625,1259248.8,3426897.66064,4067687.36656
2253,77,950700,3257040,2306340,2369156.0,2372391.6,3094766.20477,2586870.9749
7980,25,1333860,1951380,617520,617899.75,616545.6,0.0,530684.439879
5179,20,0,39660,39660,0.0,335887.2,1413732.21942,1122347.47222
6710,174,663360,1300440,637080,633526.5,657427.2,603091.536743,266408.960052
2854,108,1373460,3191940,1818480,1815092.75,1809350.4,0.0,1851512.4414
7348,178,31740,904200,872460,862768.4375,872592.0,250100.069946,419819.578609
4898,107,1873200,4991760,3118560,3130481.25,3053929.2,3880616.54138,3156300.82839
7152,213,2609340,3206820,597480,589559.625,597592.8,867572.604858,662643.123502
4295,63,2468100,6232860,3764760,3814138.25,3746707.2,0.0,3812948.73284
6539,61,5671200,6225300,554100,669102.9375,783717.6,9874050257.94,813286.885729
2823,108,1361340,3191940,1830600,1858052.375,1827338.4,1626870.2287,1840915.17012
3237,192,298200,4648740,4350540,4363495.0,4357020.0,4314072.5769,3780129.74052
6165,131,4611060,6825900,2214840,2248515.0,2161597.2,2076592.86029,2167880.04145
4164,153,1413360,1618560,205200,210723.59375,217753.2,488930.804626,1277647.46249
4666,186,271620,3636240,3364620,3491051.25,3233809.2,3503354.68695,2989804.01721
7139,220,1297440,2714040,1416600,1415399.5,1418977.2,1968029.18555,1647121.1526
7113,167,134220,534900,400680,418697.1875,402691.2,52657.3001099,287498.434938
5607,159,0,2480580,2480580,1485989.125,1614289.2,1412390.04126,1395685.2529
7823,131,5966700,6825900,859200,854802.5,855339.6,1052385.94562,1056067.24204
1980,56,1296000,6361440,5065440,4468108.5,4704577.2,4429312.87714,3609375.33843
6687,204,681900,2567700,1885800,1786203.0,1872772.8,1846675.04486,2080435.35263
387,128,346140,346200,60,400824.9375,308678.4,0.0,-479476.962317
6768,46,1869420,2027040,157620,164911.078125,126280.8,439095.46637,-21084.8960634
7169,14,68400,1327560,1259160,1245504.5,1210623.6,2320921755.38,1136858.54764
2088,102,121980,3198240,3076260,3086929.75,3084270.0,3383506.78625,3174209.51349
7237,14,121680,1327560,1205880,1203196.5,1113772.8,0.0,1171239.67689
2824,0,205380,1560960,1355580,2583667.25,3045133.2,2264019.69177,2263300.28568
642,124,543720,754200,210480,262597.5625,347586.0,0.0,-1243301.64326
1169,105,1083660,1314480,230820,428415.03125,233820.0,67047.6262207,-329148.42262
8447,196,2944080,3281700,337620,358894.9375,344434.8,1457774.27472,308052.672748
8042,183,285000,445560,160560,45972.2890625,179391.6,0.0,-279431.537657
4509,71,3191760,3996240,804480,821210.9375,813823.2,0.0,985710.828497
8257,3,841980,1055580,213600,284323.28125,181000.8,0.0,-285301.210453
3439,155,26700,3225180,3198480,3048901.0,3310406.4,2562976.27515,3009872.0913
5507,24,47940,1547520,1499580,1420381.0,1221483.6,2668394.03406,2864641.78386
3037,114,145380,1201080,1055700,1070726.75,1314568.8,2993690.01886,2313985.08027
4835,142,4003080,7299960,3296880,3296174.5,3298090.8,12744110749.4,3241112.13731
2589,130,1179900,3083940,1904040,2324963.0,1981621.2,552163.717896,1534543.70708
70,68,111600,262800,151200,394452.59375,283366.8,3006635.80835,2650210.37939
7908,220,1914420,2714040,799620,846773.875,799315.2,241747.603394,438172.197942
6842,5,441540,748200,306660,308206.875,303704.4,0.0,278190.480722
1328,72,599160,2385960,1786800,1669809.5,1693686.0,3210674.78693,2418323.952
4862,168,434400,438000,3600,3025.30175781,23220.0,389231.766907,512622.654681
3853,116,358200,786600,428400,380776.5625,429445.2,682675.039673,739173.329473
3912,71,2821680,3996240,1174560,1277606.375,1172889.6,0.0,1394772.86806
2181,94,201000,534480,333480,330534.34375,337431.6,630205.85321,1519991.89793
4483,199,742260,975720,233460,241022.578125,215727.6,195393.052734,22257.8913886
2397,156,281280,2639280,2358000,2232738.0,2487639.6,2027845.4024,3099445.8114
7192,219,2383320,3797940,1414620,1379590.125,1423404.0,1991160.77124,1561165.38893
3048,192,13980,4648740,4634760,4751439.0,4665836.4,4018688.3797,3639095.97889
3449,96,1310940,2123400,812460,777827.75,745946.4,815658.618469,871991.480273
2831,63,1229280,6232860,5003580,5031856.0,5006660.4,0.0,4834067.20159
8051,211,38340,87180,48840,273031.96875,253038.0,0.0,161428.616177
2499,102,549840,3198240,2648400,2669319.0,2458450.8,2834740.69604,2495438.61784
6107,162,2727960,4836120,2108160,2060329.75,2122527.6,2114764.36829,2535937.39616
5517,10,0,979740,979740,1676529.625,1897321.2,2641998.10571,1754128.47774
3036,162,116100,4836120,4720020,4666197.0,4741513.2,4677607.58276,3959636.90869
5320,63,3184920,6232860,3047940,3000713.5,3106590.0,2273744.66235,2960424.65777
6903,18,569340,1779540,1210200,1207846.375,1206370.8,1705595.82111,1278269.99685
1161,72,454260,2385960,1931700,1922661.25,1896656.4,15346033220.6,2454391.4696
7384,178,61800,904200,842400,743192.0625,828217.2,0.0,-443039.277483
3454,114,563100,1201080,637980,561030.625,680173.2,1674211.98029,765193.044928
701,124,603000,754200,151200,204992.296875,281954.4,905657.398376,754749.339657
4854,110,4233600,5579400,1345800,1273441.375,1320222.0,1452054.02362,1475628.62851
456,106,430440,1023180,592740,390468.1875,997461.6,2319845.11145,976850.558565
3296,92,613680,613860,180,10506.5742188,20008.8,0.0,152386.129407
2731,135,1920540,5649480,3728940,3581629.5,3747736.8,3757359.70563,3567493.56996
8769,13,2365560,2525940,160380,343181.8125,251629.2,1373518.02399,307129.195815
2646,156,533160,2639280,2106120,1991713.375,2157294.0,1630486.5069,1842407.85954
8763,25,1951380,1951380,0,1258922.875,354218.4,1397735.2052,1231630.02316
3869,198,541440,708660,167220,122029.492188,191037.6,0.0,30015.1172352
4909,90,89280,1532940,1443660,1418382.625,1374644.4,1359611.33124,1165668.67413
5975,10,267000,979740,712740,660690.9375,754057.2,907854.82373,464027.168517
9030,206,2020140,2086740,66600,20675.9277344,60318.0,321880.346375,441479.769638
157,110,90900,5579400,5488500,5571525.0,5346300.0,4775682.96234,4135349.12282
5948,204,12420,2567700,2555280,1732958.625,2032340.4,2162922.29199,1530388.89687
7595,27,379140,402780,23640,20531.078125,25111.2,19271.4415894,430781.296294
1623,110,1425420,5579400,4153980,4119679.0,4160230.8,3031687.81903,3160781.55985
202,128,178740,346200,167460,165087.8125,360428.4,0.0,247070.369051
8347,224,260880,648060,387180,472678.90625,310362.0,0.0,-333764.291692
4467,186,16800,3636240,3619440,3769527.5,3244582.8,1361512.4281,1395410.06248
4373,215,1445460,1851720,406260,433235.40625,390572.4,1167155.76654,4378.87644784
144,106,45660,1023180,977520,1050565.25,1049337.6,1826650047.13,1757625.23968
94,111,119820,3974400,3854580,3632358.25,3975013.2,4318139.67993,3835595.39445
6176,210,889860,1118160,228300,251536.359375,238478.4,235810.582214,-56487.7991604
4339,203,1351500,1897500,546000,378183.21875,495729.6,4039556506.95,380744.688185
5281,214,8460,341760,333300,639958.6875,700833.6,0.0,-460848.107241
3364,130,1866780,3083940,1217160,1213569.625,1222035.6,654298.536682,890048.280396
8617,37,493200,736020,242820,217537.40625,245925.6,314728.345459,390072.263825
2921,84,2467980,3714840,1246860,1234155.125,1250407.2,2059244.42413,1829364.04494
8923,219,3737340,3797940,60600,31352.1484375,71038.8,458788.971375,158284.11872
2805,114,13080,1201080,1188000,1184809.625,1498096.8,2085444.31494,1908071.24483
1321,140,1110600,1300140,189540,202288.46875,310975.2,1099006.04004,1192730.44765
7283,204,1187700,2567700,1380000,1190543.75,994832.4,1058610.37311,1360368.75039
8765,13,2362680,2525940,163260,331616.28125,213610.8,765123.329895,384364.499528
7946,185,441420,441420,0,0.0,57156.0,48740.0666504,-68439.4800451
1044,131,190980,6825900,6634920,6759449.0,6543768.0,3719471.03699,4026380.77647
1340,117,115560,1144740,1029180,959877.375,1069588.8,3641806.75452,2252392.39416
622,88,73800,555360,481560,754208.6875,2459688.0,1963974.08704,1899430.40789
6005,13,22260,2525940,2503680,2185176.0,1830492.0,1224468.09357,980117.287454
5962,204,20280,2567700,2547420,2260976.25,2342728.8,2874959.97211,2787215.97818
967,144,245400,1807260,1561860,1165083.375,1346455.2,2431999.46454,2060553.69078
1165,72,459840,2385960,1926120,1763060.375,1884373.2,943430.090942,1693893.55269
6678,57,946740,2756640,1809900,1907386.75,1779057.6,0.0,1712324.1486
515,91,278940,1030200,751260,749121.8125,782318.4,738316.967407,1293470.05707
1958,98,1593660,7319880,5726220,5650923.0,5518305.6,4980111.26605,5199110.25769
6712,75,5134320,6135000,1000680,998724.625,978320.4,1003758.04028,994114.399086
7862,185,397440,441420,43980,38887.9453125,73075.2,103395.742126,-9031.81420063
7890,28,32400,493260,460860,491744.59375,451357.2,522484.693542,1072344.15972
1419,113,12180,3646740,3634560,4635468.5,4511012.4,3543668.26477,2968603.80227
4826,156,2354280,2639280,285000,287429.5,278100.0,0.0,295988.997873
2897,161,197520,1955580,1758060,1759058.125,1769485.2,1692578.71057,1960771.85169
8971,160,1515960,1564260,48300,65316.6484375,45385.2,0.0,66673.6309456
591,127,20520,599940,579420,568857.9375,658252.8,1102976.46277,1636483.33871
679,83,86400,1818000,1731600,2065686.375,1781247.6,1301331.64227,1893454.73744
1918,134,507120,3656580,3149460,3074696.75,3153507.6,2885363.8988,2327132.351
5383,196,418560,3281700,2863140,2864769.0,2790852.0,1639674.41571,2133658.32532
328,141,124500,7406100,7281600,7230524.5,6808394.4,5123896.92676,5255186.68066
5149,131,3666420,6825900,3159480,3040228.0,3171979.2,2739817.22516,3025193.06078
8738,220,2575800,2714040,138240,131387.546875,183022.8,178436.416809,101324.118373
4253,163,185820,548880,363060,410162.375,387480.0,749357.99939,495709.882006
544,84,395160,3714840,3319680,3579913.25,3288799.2,4859463.13623,4561951.77654
7168,135,5573280,5649480,76200,72346.96875,107344.8,0.0,364558.341635
6263,63,4095060,6232860,2137800,2135552.5,2133642.0,201767907.999,2240064.16295
4944,125,3792060,3969060,177000,336616.03125,205078.8,15494363366.4,746644.141487
8028,209,748800,1091400,342600,325478.0,336010.8,1273009.67358,1460219.65902
9061,76,7550700,7552500,1800,0.0,1560.0,92997.5668335,122835.585509
7788,63,5342940,6232860,889920,884023.3125,874269.6,146790988.292,839662.11881
6894,18,558000,1779540,1221540,1242598.5,1211631.6,1445160.52911,1043218.81111
5990,154,86400,115500,29100,419070.25,429999.6,1739567.48846,1992874.68703
3899,141,3416580,7406100,3989520,3985381.0,3986788.8,3951652.00977,3894073.41091
5421,63,3398940,6232860,2833920,2810773.0,2831233.2,3502418.47614,2984989.29822
1081,88,555360,555360,0,27752.7714844,154837.2,1366194.97046,1515272.66949
606,82,68040,2195880,2127840,2126414.0,2223555.6,2507583.00562,2000478.74411
1440,63,0,6232860,6232860,5599762.0,5088900.0,3721314.22516,3382606.05794
6970,48,59040,156420,97380,108880.875,147066.0,1329194.41895,854621.460055
41,51,0,280800,280800,312475.53125,622374.0,1165532.78149,1447884.49816
2893,130,1381560,3083940,1702380,1717939.0,1674973.2,0.0,2479305.73478
3340,23,1027320,1894920,867600,864872.4375,852445.2,8011813221.47,533808.53516
4269,73,1303500,1303500,0,263427.25,254816.4,0.0,-251402.858925
5753,89,642900,1736340,1093440,918756.75,693237.6,251114.760681,470276.949133
7838,196,2429820,3281700,851880,814240.6875,846916.8,650263.340393,899978.891087
6455,155,2475600,3225180,749580,720921.5,741477.6,780668.295715,995921.192442
3182,192,245160,4648740,4403580,4347962.0,4422333.6,4402573.66327,4145069.59246
1061,86,225180,3519180,3294000,3096947.5,3318063.6,3556431.39484,3422306.86696
7156,167,156420,534900,378480,367236.125,371970.0,0.0,193675.900437
1722,135,1106880,5649480,4542600,4067230.25,3159298.8,1344452.95612,1556923.73804
6520,10,813480,979740,166260,153359.65625,203287.2,192171.140259,-64639.7738671
4839,169,101400,2190660,2089260,1930644.125,2129161.2,1910423.81848,2023256.40756
231,51,166200,280800,114600,862556.4375,1441893.6,564861.751892,1114979.18609
8264,13,1962600,2525940,563340,545405.6875,536002.8,21062562453.5,382705.316893
1594,142,1194360,7299960,6105600,6030207.5,6047845.2,5080411.18018,5848761.71445
3028,162,103500,4836120,4732620,4677318.5,4742125.2,4229828.76379,3941597.39333
158,79,4500,4151700,4147200,4144450.5,3443990.4,2733264.1441,2877086.22207
5503,102,2999400,3198240,198840,180334.90625,374778.0,0.0,627047.546638
1948,98,1589160,7319880,5730720,5638368.5,5514470.4,5546781.9129,5489195.07591
2807,92,160860,613860,453000,386133.75,679905.6,2064382758.22,256777.656097
8532,40,27120,163800,136680,143071.421875,138537.6,905677.969238,1065313.43844
1348,67,1292580,3120480,1827900,1651880.25,1337379.6,3919963.12744,2970183.66163
3129,130,1694880,3083940,1389060,1321290.875,1388460.0,1739158.31647,1697799.18466
2488,98,2098560,7319880,5221320,5221940.5,5120046.0,1738721815.11,5156118.35477
7492,189,52260,308460,256200,465661.8125,314385.6,1279664.06818,1062925.09361
739,56,123060,6361440,6238380,5648151.0,3525146.4,4161822.81622,3664893.18462
6309,172,54360,1443960,1389600,1305685.5,1356432.0,1749674.34692,1191525.71244
8030,220,1994100,2714040,719940,718622.0625,715737.6,1169983.14551,553706.455112
210,141,26100,7406100,7380000,5829049.5,4840348.8,4712062.82953,4647001.38194
3496,86,2319780,3519180,1199400,1234471.625,1172204.4,2464031.29388,1786768.60577
1371,112,225420,1303440,1078020,884205.9375,993261.6,670839.35437,1216479.34479
5073,156,2493420,2639280,145860,122428.5,130850.4,10359938489.6,-54379.6560117
8568,40,53580,163800,110220,130052.867188,135424.8,687866.72522,984153.129703
5592,217,523620,557700,34080,109432.617188,32305.2,0.0,431207.354129
7715,178,416940,904200,487260,244792.234375,226088.4,0.0,69095.5245328
7745,186,2776200,3636240,860040,886118.9375,864351.6,0.0,1296517.21916
5015,217,33660,557700,524040,615295.3125,509485.2,1941934.56604,2554629.33731
1674,146,1473060,6670800,5197740,5198133.0,5137390.8,5954731.69849,5636500.32269
1822,66,1760460,4817700,3057240,3082995.5,3048724.8,3607912.91357,3295815.61295
5469,210,283620,1118160,834540,951019.5625,1027824.0,88950.1130981,240542.416546
8817,160,1432380,1564260,131880,120842.984375,133011.6,204175.818909,302834.057512
8934,196,3223620,3281700,58080,74871.125,67663.2,0.0,114191.801704
8488,14,1187520,1327560,140040,109120.976562,138884.4,283285.898743,185821.632626
255,99,3600,28560,24960,0.0,1251850.8,1759019.81049,2513161.57751
404,141,194400,7406100,7211700,7045245.0,6735270.0,7927473.06781,6016278.01199
4520,213,418380,3206820,2788440,2781335.75,2793255.6,3101305.26678,3558189.29365
135,146,86460,6670800,6584340,6477104.0,6590713.2,5008211.67963,4753475.1081
1735,79,1559700,4151700,2592000,2592322.0,2610963.6,2881850.59094,2620293.35083
8510,57,2513460,2756640,243180,251592.484375,265974.0,14751392078.6,138608.558905
5292,113,3184260,3646740,462480,426066.0,255540.0,667036.681824,484612.988317
7685,15,939540,1822860,883320,875370.875,881570.4,0.0,651156.047346
6122,63,3990720,6232860,2242140,2249861.0,2246250.0,0.0,2374875.17723
3483,148,1786860,1938900,152040,156787.234375,147104.4,733870.879211,217313.610024
4391,156,1982100,2639280,657180,665114.625,616872.0,1460195.25568,537139.115008
1946,98,1588980,7319880,5730900,5646395.5,5462962.8,5755173.73993,5597994.04569
5145,131,3662700,6825900,3163200,3169339.25,3179648.4,3227375.1134,3121932.94115
6728,13,683940,2525940,1842000,1825407.0,1834244.4,1996824.54932,1679152.55431
7525,64,5788440,6845160,1056720,1090655.125,980991.6,2151715.96545,1203745.71722
3876,203,1059420,1897500,838080,841440.0,835118.4,12741627293.2,814059.298318
8609,63,5995740,6232860,237120,243680.03125,233343.6,292570639.612,400322.780359
7919,170,20580,665160,644580,300321.3125,360030.0,76924.6160278,243484.430015
7564,27,349020,402780,53760,37648.3359375,181699.2,456846.643921,338947.581216
2325,156,190080,2639280,2449200,3101557.5,2686722.0,3693618.09393,3637343.90145
8207,13,1891560,2525940,634380,627060.6875,638295.6,638852.00354,324422.685144
3194,130,1733160,3083940,1350780,1359672.625,1348294.8,1410195.21301,1485703.37247
3412,137,65160,243720,178560,172809.0625,278589.6,645065.826416,317135.780535
7622,15,886800,1822860,936060,932429.5625,942444.0,675757.42627,757810.859103
4501,96,2123400,2123400,0,990.71661377,1896.0,604200.715393,320199.664302
5641,177,1626660,1713060,86400,43314.109375,162928.8,63656.8116455,-132390.693717
6111,220,492060,2714040,2221980,2174049.0,2212464.0,1457967.88354,2294017.5801
6821,13,883680,2525940,1642260,1619102.375,1636287.6,1811529.06519,1675913.2463
1441,113,28920,3646740,3617820,6107407.5,5812954.8,5384222.60913,4706389.31673
1859,138,1782000,1785600,3600,664.188598633,26896.8,0.0,-159259.66171
4268,73,1300800,1303500,2700,308318.78125,249720.0,0.0,133184.391527
2582,143,430260,1898460,1468200,1435896.375,1422026.4,1113640.67084,935556.009963
450,150,527400,626340,98940,87750.5703125,217291.2,168935.966248,9695.73387278
1103,77,0,3257040,3257040,3558753.5,3358594.8,3619244.7403,2555947.08219
1873,111,1835220,3974400,2139180,2180868.25,2203623.6,2228399.97015,2066531.08883
8220,196,2677320,3281700,604380,619158.8125,605712.0,0.0,170586.399336
7218,61,6225300,6225300,0,259.893188477,7508.4,74504.3757935,1866.65302533
5077,98,4155300,7319880,3164580,3125990.75,3114247.2,3504514.7193,2946869.77455
5549,63,3473340,6232860,2759520,2751530.25,2754626.4,2223560.36346,2701472.42319
8966,206,1986480,2086740,100260,0.0,146803.2,30282.6190186,196507.630198
4608,199,957840,975720,17880,114496.476562,71667.6,0.0,-166061.197303
8338,208,1561140,1620480,59340,41779.1054688,71018.4,0.0,45325.18536
3865,98,3307500,7319880,4012380,4059455.5,3920205.6,0.0,3954420.23923
1682,98,1270980,7319880,6048900,6075045.0,5897226.0,6468850.84802,6726408.46897
5245,20,39660,39660,0,990134.25,720830.4,3207092584.14,1207128.81941
602,56,35160,6361440,6326280,2806911.25,2510848.8,2109224.34375,2359801.7382
7021,213,2529060,3206820,677760,660423.75,675628.8,1035346.80164,555568.14774
4784,98,3997380,7319880,3322500,3226414.75,3183044.4,3460490.01672,3415021.75263
3767,73,856320,1303500,447180,441654.34375,456745.2,0.0,578964.542823
4986,213,803040,3206820,2403780,2311146.75,2383938.0,14708432151.5,2746385.46269
8405,13,2147160,2525940,378780,374094.625,365050.8,0.0,363733.790906
8026,26,1488720,2036760,548040,510205.3125,554841.6,534652.585266,448098.064305
454,52,382260,608400,226140,206066.703125,1040666.4,0.0,506680.146981
2218,82,1478580,2195880,717300,772118.25,711277.2,1247570.48938,532029.642802
1054,72,341160,2385960,2044800,2107608.0,2008393.2,6284097638.16,2386727.74953
4837,90,47700,1532940,1485240,1394921.625,1442389.2,1421620.97662,969156.17037
8642,188,4193760,4327560,133800,126179.53125,151352.4,0.0,41588.7421426
5155,19,46080,608940,562860,660920.9375,713893.2,0.0,-78901.1779112
6565,46,1724160,2027040,302880,319179.09375,337584.0,15632846479.1,445847.233133
7290,164,41040,123600,82560,188387.953125,330735.6,0.0,-312964.375878
7711,141,6486000,7406100,920100,914844.125,935001.6,1368606.91187,843080.512776
3665,203,783720,1897500,1113780,1107465.5,1114728.0,4949355432.4,26171.6762778
8174,197,622020,626580,4560,61816.6601562,57639.6,653659.025208,887846.108837
6119,89,1039080,1736340,697260,693598.1875,867193.2,1533409.80347,930209.899951
863,131,7620,6825900,6818280,6472740.5,5588686.8,2735519.47559,2533127.69358
2261,117,888180,1144740,256560,344620.03125,222556.8,402919.647095,702487.303118
1628,123,13980,3545820,3531840,3203630.5,3567520.8,2556108.11334,2338343.8035
4656,168,313680,438000,124320,199061.84375,363900.0,891417.296936,306663.172144
55,109,10800,274500,263700,256640.734375,680610.0,2243476.39471,1715875.99324
4554,156,2074200,2639280,565080,567682.625,557839.2,293860.207642,596675.246703
5370,146,4673100,6670800,1997700,2036411.125,2062573.2,2255247.96002,1987942.26464
771,76,656760,7552500,6895740,6879912.5,6892900.8,6989072.39496,6622204.20191
1477,113,45300,3646740,3601440,5464184.0,5577812.4,4190113.15393,3653405.916
1904,115,643260,954000,310740,454253.75,554410.8,1616212.22076,1684405.30355
8943,13,2459400,2525940,66540,69535.5390625,66711.6,0.0,92726.3789764
4887,213,749580,3206820,2457240,2447486.75,2468452.8,2520677.64087,2716704.8358
7138,5,622620,748200,125580,106436.742188,118022.4,3975.56347656,-35752.8361048
5967,155,1967100,3225180,1258080,1210350.75,1206831.6,1180137.1214,625484.320566
731,53,353040,582540,229500,310715.53125,226690.8,184264.311279,851723.790037
3112,96,1086600,2123400,1036800,1058772.625,1037337.6,1169787.185,1133875.9709
7815,31,1374660,1374660,0,46415.5976562,10460.4,818230.239136,290650.210718
4643,141,3997200,7406100,3408900,3352177.0,3380432.4,3456848.5459,3264872.27092
7702,176,1454340,1462860,8520,48622.4960938,57201.6,319164.524597,-609391.27261
5367,216,226380,496500,270120,299410.75,454462.8,314867.970154,481278.415208
2198,142,1737960,7299960,5562000,5532478.5,5617390.8,6078734.07611,5258279.20031
5849,89,697860,1736340,1038480,885402.5,741496.8,1404616.24841,1069806.91566
2549,83,1814400,1818000,3600,298.22756958,13179.6,0.0,-35683.9241049
8061,209,768600,1091400,322800,339565.21875,320047.2,1213136.46808,1405632.0678
6774,191,1651020,1811280,160260,147303.609375,150733.2,0.0,176440.359034
90,111,115860,3974400,3858540,3606572.25,3976912.8,2730044.22119,3070639.66926
1031,86,90660,3519180,3428520,3450008.25,3442904.4,2676585.58569,3160180.41446
1277,122,379140,861720,482580,517575.4375,601196.4,424607.770264,782148.221825
1172,112,80340,1303440,1223100,1213837.25,1162240.8,889377.066467,1431006.82535
1617,61,1507920,6225300,4717380,4759291.5,4778882.4,0.0,4766361.3159
2014,126,960,496560,495600,577727.6875,701626.8,1934330.41479,1937979.8378
3188,142,2692980,7299960,4606980,4597500.5,4603737.6,4771577.45404,4557052.7709
1553,134,101820,3656580,3554760,3391426.75,3459165.6,3945243.07599,3987114.05083
836,66,777120,4817700,4040580,4111379.75,3815042.4,0.0,3809307.18334
2638,1,1153080,1447140,294060,145895.0,476791.2,0.0,179004.834145
1300,132,13440,1658640,1645200,1653355.125,1579980.0,2135936.6759,2194132.38027
5758,220,100440,2714040,2613600,2398581.25,2320647.6,2838333.4151,2125267.21456
3946,71,2848560,3996240,1147680,1121178.875,1148673.6,1544797.97473,1472443.42078
7690,76,6591540,7552500,960960,954683.6875,933998.4,9755596387.99,503475.342308
1119,112,41880,1303440,1261560,1421702.0,1274992.8,1571025.96509,1581831.24043
958,72,161460,2385960,2224500,2332051.5,1860608.4,3251691.5556,2439877.36643
7558,75,5913060,6135000,221940,516299.9375,765738.0,70226.5895386,-33272.3806921
1092,131,339840,6825900,6486060,6116441.5,6256718.4,3155794.67749,3845240.21674
8662,64,6781920,6845160,63240,57396.6015625,84750.0,151777.782654,130955.574708
8306,22,428820,810360,381540,342047.8125,335536.8,534818.556091,804208.477319
2518,108,1136940,3191940,2055000,2023791.25,2046207.6,1269866.2572,1708699.70047
4291,63,2465520,6232860,3767340,3798759.5,3746151.6,3011042.63708,3814053.60112
6029,13,43020,2525940,2482920,2335983.5,2220192.0,1555623.59833,1068010.04193
1453,60,1204800,7401300,6196500,6138259.0,5549012.4,4903103.81714,4883799.14222
3239,130,1779480,3083940,1304460,1351288.625,1338135.6,1671369.28461,1494144.14041
8077,211,61800,87180,25380,44353.8710938,75186.0,0.0,-110380.442497
5900,196,721320,3281700,2560380,2532900.0,2556957.6,5931839482.16,2260403.23051
1458,130,139740,3083940,2944200,2950845.0,2984683.2,2362743.5871,2875905.1663
6906,222,217800,1113000,895200,901881.4375,851563.2,132352.737915,294071.437412
3133,192,219240,4648740,4429500,4411518.5,4378410.0,5203685.4259,4784466.69141
6932,4,1177800,1326000,148200,152919.875,149756.4,0.0,94235.6749283
8375,207,192840,272580,79740,133240.15625,142506.0,0.0,-2217.96093802
3916,60,3426000,7401300,3975300,2780421.75,3490388.4,3925885.6178,3524683.94804
7665,183,41460,445560,404100,553753.5,468586.8,0.0,-479111.202693
1832,135,1171800,5649480,4477680,4027803.0,3571958.4,3573968.77802,2910806.62031
5926,4,176880,1326000,1149120,1157840.75,1146620.4,111247.55896,945308.919468
303,79,136320,4151700,4015380,3652199.5,3691401.6,5349665.88782,4564367.73684
5099,196,109560,3281700,3172140,3175561.25,2913301.2,2115174.19836,1383229.75959
2047,133,607800,6181200,5573400,5607034.5,5561684.4,5306963.28296,4870409.32009
4640,131,3388500,6825900,3437400,3366322.75,3420666.0,3048157.33319,3314657.8116
3205,142,2706720,7299960,4593240,4597459.5,4593046.8,3908087.0788,4495804.83934
8915,58,914940,992100,77160,54516.546875,82477.2,522241.677002,19155.8659773
8778,13,2366640,2525940,159300,176091.5,209832.0,0.0,-292542.476375
5307,196,222360,3281700,3059340,3105223.25,2471452.8,2109459.97687,1861870.63128
6781,204,844140,2567700,1723560,1785141.5,1712521.2,1956227.71802,1782998.46213
5122,187,267600,2496960,2229360,1545151.75,1643120.4,794692.709534,864591.118883
8008,18,1393140,1779540,386400,402939.59375,345218.4,1808649.65118,401466.813017
2147,145,577200,586680,9480,87688.6015625,55358.4,0.0,-440702.130178
3512,86,2331180,3519180,1188000,1137888.0,1167990.0,1087612.76257,1169747.30246
7036,160,41520,1564260,1522740,1163174.625,1349106.0,1031073.47607,1592142.43574
1365,132,61020,1658640,1597620,1818781.125,1269121.2,1892267.29761,1972081.68753
5843,63,3645540,6232860,2587320,2651792.25,2598610.8,0.0,2625694.96564
6382,220,674760,2714040,2039280,2018194.625,1979107.2,2277056.95984,1933864.94883
7006,204,1027320,2567700,1540380,1468341.5,1542679.2,1435889.94678,1356685.16889
3834,98,3286980,7319880,4032900,4019751.5,4044360.0,4267201.04089,4238344.6313
7063,31,747180,1374660,627480,572787.0,600418.8,718664.61615,520446.768305
2545,78,1814400,1818900,4500,10088.5712891,250611.6,0.0,74365.7859846
4328,203,1347900,1897500,549600,416008.15625,512505.6,11114439387.6,203541.539271
6986,151,3425820,3643800,217980,206884.90625,255542.4,0.0,266721.172148
4852,74,2976000,2979600,3600,0.0,216580.8,2537973.55444,2305332.13382
6226,162,2835660,4836120,2000460,1974003.125,1985211.6,1685212.34912,2214721.5435
2020,83,1325640,1818000,492360,453479.9375,501194.4,581111.490417,580616.160094
1951,83,1270440,1818000,547560,547263.625,544435.2,1399778.21924,509636.983107
164,146,125700,6670800,6545100,6482026.0,6500763.6,5878017.47858,5228101.31187
3960,114,1057140,1201080,143940,202511.4375,413781.6,498851.673828,469004.074457
7572,15,853500,1822860,969360,930245.5625,904348.8,0.0,563292.670671
8501,40,2880,163800,160920,859574.5,216253.2,308782.169922,489247.10842
3308,173,544800,3215700,2670900,2663445.0,2612664.0,2843992.12286,2130179.07945
8406,43,4500,4500,0,59908.75,151228.8,158032.359497,416353.199256
5591,57,82560,2756640,2674080,2710196.75,2626836.0,2693023.78137,2448420.61263
5711,10,133560,979740,846180,1015311.3125,1040826.0,1774236.94727,1170402.00558
4514,151,1332240,3643800,2311560,2333473.75,2309556.0,1753909.32843,2277808.65668
7846,6,51840,133560,81720,396121.34375,459056.4,1656766.58594,1689725.49229
8103,37,32460,736020,703560,571498.875,590971.2,1326708.36926,999344.968959
4055,184,673200,1800900,1127700,1117563.75,984148.8,703036.360046,831612.540275
2424,83,1753200,1818000,64800,181356.453125,242628.0,0.0,-109046.650525
4418,135,3312840,5649480,2336640,2391571.0,2286337.2,2209226.36121,2336572.96443
8638,40,89760,163800,74040,125037.296875,134221.2,917801.952393,1394255.36834
7566,167,534900,534900,0,14702.4472656,233047.2,0.0,-471536.918168
455,79,382320,4151700,3769380,3730079.25,3668526.0,3299918.40735,3954148.37864
4024,135,3073380,5649480,2576100,2584346.25,2611737.6,1063481979.13,2814881.29279
3959,123,2161620,3545820,1384200,1404860.875,1343022.0,22473736862.1,1285452.00819
6402,18,97740,1779540,1681800,1603233.0,1550276.4,1489659.15625,1511833.44629
2795,79,2423700,4151700,1728000,1337209.125,1520647.2,1700434.01691,1660583.25437
5781,63,3614940,6232860,2617920,2644533.75,2619278.4,13074590237.8,2526043.04854
6255,131,4680300,6825900,2145600,2196284.25,2069770.8,1939657.19574,2250354.05518
9013,131,6798300,6825900,27600,30973.8613281,15580.8,0.0,13282.3772483
471,79,393600,4151700,3758100,3484555.25,3290245.2,2137739.64728,3789642.51489
6051,204,104700,2567700,2463000,2513687.5,2442093.6,3058538.22437,3106653.18996
7987,196,2516100,3281700,765600,739333.25,753386.4,53443.2480469,569278.494456
5866,169,845820,2190660,1344840,1340149.375,1348322.4,1716168.08917,1246667.94291
6952,5,515820,748200,232380,258995.53125,293210.4,283918.225647,314072.921491
5455,196,463920,3281700,2817780,2487435.0,2568512.4,2767047.68036,2038844.03136
630,56,41880,6361440,6319560,4820252.5,2241739.2,4480706.1568,3849565.55315
4294,131,3059040,6825900,3766860,3773741.5,3764022.0,3821785.22717,3727657.10297
8857,37,632460,736020,103560,117083.039062,125283.6,0.0,-54174.56941
736,118,59760,459900,400140,264953.8125,625462.8,1899778323.06,166217.597632
5589,217,523200,557700,34500,38499.7109375,33073.2,28030.8494873,349369.133352
3860,98,3297360,7319880,4022520,4052455.0,3983509.2,21007599874.5,4046293.0706
6482,196,1284900,3281700,1996800,1990538.375,1996874.4,0.0,2318305.49379
3852,184,537960,1800900,1262940,1266936.375,1151851.2,1565631.71014,1092931.29806
849,142,502080,7299960,6797880,6752831.5,6804176.4,7659099.06628,6632726.96989
807,75,103080,6135000,6031920,5759009.0,5803770.0,5280262.69312,4535465.3022
6348,220,665400,2714040,2048640,2053681.75,2011256.4,2132936.92969,2049269.63638
884,118,156180,459900,303720,348218.75,352908.0,1112906.42926,498193.755305
3520,86,2332980,3519180,1186200,1155379.75,1183690.8,1148110.37415,1587063.36255
1927,134,511980,3656580,3144600,3138729.5,3153978.0,2140849.96436,2339741.47544
5382,49,3942900,3991980,49080,41842.5703125,59470.8,0.0,115053.959472
2577,158,79320,2044680,1965360,1994999.75,2038328.4,2845710.66724,2690295.90355
3689,116,114720,786600,671880,796360.6875,802428.0,1652613.63477,1414771.90831
5154,69,2016300,2073180,56880,188813.65625,154674.0,195058.617065,-199754.825001
6100,155,2221800,3225180,1003380,1003286.75,1000159.2,1156292.88239,934460.765279
3389,71,2339640,3996240,1656600,1240107.375,1266732.0,294135.431091,-50762.7221899
1567,63,92520,6232860,6140340,6022066.5,6033807.6,5463797.01611,5057321.5257
8160,63,5563740,6232860,669120,670817.5625,666831.6,0.0,746282.583762
6980,31,701400,1374660,673260,691226.6875,673867.2,0.0,720686.589813
7454,8,24060,615060,591000,586197.1875,635140.8,0.0,5606.86679547
425,142,239340,7299960,7060620,7020245.0,7074855.6,5446659.29529,5550272.54926
7093,167,129780,534900,405120,400770.21875,405645.6,823772.847412,393344.873855
8558,139,82080,273900,191820,164635.421875,131854.8,0.0,-333384.173217
405,79,220080,4151700,3931620,3912904.25,3884150.4,5491954.99475,4873303.64466
6905,188,2831160,4327560,1496400,1535867.625,1559142.0,1782627.83807,1632400.70878
3151,73,429480,1303500,874020,807664.75,817725.6,1433144.11157,1010297.44652
4404,215,1457520,1851720,394200,323835.25,355568.4,0.0,-290473.667573
6578,63,4304040,6232860,1928820,1923801.125,1906227.6,5181357.78595,1937101.41956
1048,86,105780,3519180,3413400,3323577.25,3323767.2,2970704.1861,2987614.55041
539,76,505080,7552500,7047420,7060915.5,7035142.8,5467952.10364,6430731.6096
7922,15,1091820,1822860,731040,742007.125,743133.6,75167.6762085,755003.885445
5153,157,39000,1993260,1954260,1551012.25,1658145.6,272238.620056,728388.530375
5954,10,251160,979740,728580,812816.625,787765.2,796627.366089,532259.181497
5212,216,0,496500,496500,1126229.875,945288.0,2082826.45844,1723932.75641
2431,108,1098240,3191940,2093700,1971536.5,2130618.0,2099628.25067,2515516.75183
8731,162,4829760,4836120,6360,28491.5566406,140485.2,146053.748535,-43739.1259664
7042,195,117420,393120,275700,337056.3125,305395.2,0.0,305138.091384
834,121,244440,856140,611700,606548.5625,598450.8,749328.425537,689599.255156
8157,196,2612220,3281700,669480,668083.125,668230.8,0.0,920023.179936
5219,213,939480,3206820,2267340,2249404.25,2260837.2,2857066.85461,2384673.73771
1274,108,10020,3191940,3181920,3896217.5,3161866.8,3977413.77539,3953794.77493
8526,159,2442780,2480580,37800,22968.3671875,41649.6,0.0,-1156269.26778
590,56,28800,6361440,6332640,2346214.75,2466079.2,1793013.63025,2488818.56715
8115,28,175620,493260,317640,262074.734375,267138.0,797667.755676,495368.804776
7476,174,1273260,1300440,27180,0.0,55101.6,0.0,-449817.223175
6839,213,2422560,3206820,784260,740164.125,736915.2,7594697126.55,983301.523646
3785,141,3217500,7406100,4188600,4187139.5,4187313.6,0.0,4309669.20886
6601,151,3043920,3643800,599880,595936.875,563556.0,308394.45343,691614.461331
1204,117,14280,1144740,1130460,1224187.25,1217583.6,1435280.61713,1871025.65752
7995,172,1390920,1443960,53040,100617.5,119752.8,100356.975769,-299484.142755
3928,114,1029180,1201080,171900,204253.265625,204637.2,885668.613953,513353.561559
1376,130,81540,3083940,3002400,3273775.75,3052717.2,4570126.1925,3246019.93207
118,76,57360,7552500,7495140,6678579.0,5838534.0,4662239.90295,4188569.49943
1676,135,926100,5649480,4723380,4661832.5,3199952.4,2888700.56189,2493728.12114
8465,188,4085160,4327560,242400,250368.25,244432.8,807978.408752,548968.145819
3546,147,1317000,1479360,162360,215280.90625,219907.2,273168.80542,67602.9623612
610,140,430620,1300140,869520,903189.75,947958.0,1903234.77045,2245635.54006
1622,134,153300,3656580,3503280,3497650.75,3456360.0,2781606.43158,2680511.25301
6871,13,908520,2525940,1617420,1616595.25,1597244.4,0.0,1645420.53362
7607,98,6321780,7319880,998100,981634.875,1014464.4,248540.790039,1145629.61449
1197,77,66000,3257040,3191040,3137274.0,3200954.4,1397323.16803,1949938.34313
6044,204,89340,2567700,2478360,2455044.0,2445406.8,3104359.07599,3185210.80019
1497,33,74400,78900,4500,25970.3789062,269065.2,393161.255615,618693.688393
3316,130,1815180,3083940,1268760,1258331.125,1269495.6,1189806.23291,1096761.46656
5971,57,290100,2756640,2466540,2428771.5,2466490.8,0.0,2620053.12107
7658,220,1745640,2714040,968400,975534.0625,975232.8,69216.2598267,576567.402946
1581,119,0,2742780,2742780,1659494.0,1732974.0,857474.18811,1989174.40475
8720,188,4243560,4327560,84000,82614.1953125,84447.6,128526.247925,-15603.5418573
3536,165,738960,1262880,523920,609807.125,600920.4,0.0,-281480.359534
163,111,193800,3974400,3780600,3791710.5,3775900.8,3896666.36725,3713962.35237
0,68,0,262800,262800,1526501.125,1313212.8,1018973.15186,1355930.98177
8416,14,1153980,1327560,173580,166144.640625,157783.2,0.0,121038.033508
6999,204,1024560,2567700,1543140,1499009.0,1544994.0,1428054.72668,1541340.38103
6213,213,1881720,3206820,1325100,1489192.375,1404964.8,0.0,1479943.98512
3850,114,975240,1201080,225840,244968.328125,219354.0,140033.971497,626387.844483
453,76,468120,7552500,7084380,7152387.0,7091559.6,5962699.19073,7368837.99373
4084,116,518400,786600,268200,279056.84375,263533.2,296889.693481,115094.280689
4508,213,412440,3206820,2794380,2827935.75,2800179.6,3265563.40527,3510767.7893
2569,158,78120,2044680,1966560,2087567.75,1982877.6,2113328.42938,2913919.56022
8883,221,934800,934800,0,16206.3730469,42472.8,839552.264771,404843.069093
1931,72,1143720,2385960,1242240,1294169.25,1364684.4,1504539.46674,1545974.17144
3107,158,572280,2044680,1472400,1389131.625,1387302.0,1719609.80737,1785680.97535
1176,105,1096260,1314480,218220,207774.96875,228382.8,241298.471191,-240385.96461
6398,18,94740,1779540,1684800,1665376.0,1645382.4,1131970.31232,1384759.27572
2023,86,1041180,3519180,2478000,2484081.25,2482675.2,2277658.36707,2278959.48666
3019,158,368880,2044680,1675800,1718406.625,1708263.6,1790677.06329,2378577.85211
6870,13,908400,2525940,1617540,1615872.875,1599655.2,750497.754517,1627180.03515
702,124,603000,754200,151200,201739.078125,251427.6,1061491.82208,754749.339657
5213,196,173160,3281700,3108540,2702030.5,2261265.6,2332136.84399,1748730.70438
8954,22,810360,810360,0,1162532.5,986605.2,2982435.2923,3293684.41322
8332,152,3416340,3766500,350160,356490.875,348499.2,0.0,211243.97193
5303,134,3206400,3656580,450180,445964.90625,452110.8,588541.175171,305148.347753
7193,15,486900,1822860,1335960,1307187.875,1335418.8,0.0,2450.83473308
6103,204,282360,2567700,2285340,2309088.75,2324080.8,3081022.24249,2957389.61383
3975,60,3462900,7401300,3938400,3632805.5,3325444.8,4609172.51514,3740559.34883
6196,76,5356800,7552500,2195700,2057158.0,2223811.2,0.0,2052480.87231
1384,33,6240,78900,72660,206288.78125,347857.2,797006.105225,1167573.84952
7522,167,395340,534900,139560,95630.390625,144482.4,0.0,194550.220621
1379,49,536400,3991980,3455580,2814676.75,1938376.8,3961462.65698,3188616.10739
796,144,99240,1807260,1708020,1726122.25,1650486.0,2073910.73218,1929598.22183
1395,133,19920,6181200,6161280,5627175.5,5508654.0,3948359.99884,3699109.86245
7689,186,2747400,3636240,888840,889640.0625,861356.4,27174621141.9,390955.431329
9075,21,470460,470460,0,0.0,193528.8,0.0,-329849.83323
1736,79,1559700,4151700,2592000,2601625.5,2596420.8,2823450.38696,2647055.28082
7826,131,5968500,6825900,857400,855604.6875,856017.6,1492596.76654,1055296.4037
1680,146,1482000,6670800,5188800,5197925.5,5135437.2,5866494.91046,5600386.84209
6517,26,261840,2036760,1774920,1756335.625,1775659.2,0.0,2121475.12445
6257,151,2820180,3643800,823620,860153.3125,832986.0,0.0,947612.980401
6834,2,1706220,2555640,849420,799414.0625,767457.6,0.0,-146529.004067
6890,151,3367320,3643800,276480,273149.96875,327704.4,0.0,308904.46365
4440,168,54060,438000,383940,376938.1875,693021.6,986830.156433,934286.841903
5301,134,3203400,3656580,453180,446396.4375,458149.2,225197.200989,306433.078307
1135,76,1087200,7552500,6465300,6468692.5,6468712.8,6968846.42358,6187242.31217
3050,192,14400,4648740,4634340,4826063.5,4610377.2,4075123.74268,3682028.03337
1518,132,154500,1658640,1504140,1550138.25,1412972.4,1626977.2179,1711661.90447
1462,148,0,1938900,1938900,1523076.5,1867702.8,1890546.44879,2366283.16242
8225,14,899400,1327560,428160,438941.71875,421759.2,0.0,-680127.421805
7874,179,188760,345960,157200,160911.25,185095.2,197938.422485,1222634.93522
1285,108,14220,3191940,3177720,3270191.0,3197019.6,3332817.07166,3449737.40282
5114,187,265440,2496960,2231520,1611297.75,1648618.8,1273413.8819,989001.973246
3034,173,210900,3215700,3004800,3003314.25,3068098.8,2895639.13513,2514889.30479
7923,209,686040,1091400,405360,373323.4375,330145.2,1696338.48407,1425669.999
5339,152,812460,3766500,2954040,2317939.75,2353327.2,2295593.10553,1690735.28355
1111,87,1034460,1090800,56340,56233.5898438,256528.8,261014.318115,21462.9510979
8415,220,2388840,2714040,325200,312448.90625,326198.4,497489.282043,128765.481219
3277,135,2442000,5649480,3207480,3102318.25,2979458.4,2888255.88147,2900093.70794
1845,115,590580,954000,363420,771752.4375,1041093.6,890545.271057,1442328.24473
5510,142,4538760,7299960,2761200,2678717.75,2745391.2,0.0,2724408.89088
7854,42,103680,953340,849660,455572.90625,549616.8,1676008.13055,1345423.67227
3837,203,1031820,1897500,865680,869070.8125,863529.6,152873.420898,983337.987694
5396,98,4500180,7319880,2819700,2836754.0,2889304.8,2907363.91119,2970044.8963
4654,142,3894960,7299960,3405000,3388721.0,3410779.2,4821093.77197,3448990.07762
5201,177,1215600,1713060,497460,393463.78125,498339.6,587256.143982,340445.691343
4134,23,1677660,1894920,217260,295492.3125,193333.2,253755.677185,103065.254855
4745,156,2315760,2639280,323520,336179.6875,327226.8,0.0,397407.8525
685,83,90000,1818000,1728000,2012094.625,1618759.2,3191785.7829,2598847.19402
7589,25,1073940,1951380,877440,866363.6875,885675.6,420676.179199,773790.502042
6714,146,5716800,6670800,954000,952827.375,950424.0,1325555.7558,991771.792426
5190,98,4212180,7319880,3107700,3207877.75,2978794.8,2961096.65717,2944038.16216
8743,160,1388280,1564260,175980,138571.546875,164170.8,309734.379456,214235.25415
3668,147,1398720,1479360,80640,23515.7070312,60222.0,0.0,-868615.514348
5789,134,3656580,3656580,0,309225.15625,470379.6,662098.701538,134843.034238
3159,156,1039140,2639280,1600140,1591471.5,1569494.4,1945646.98553,1434958.32837
6278,31,110040,1374660,1264620,1149258.5,1242904.8,1624335.47479,1527733.46692
2040,72,1213740,2385960,1172220,1075323.25,1180922.4,1107005.9248,1150251.04662
8697,131,6647340,6825900,178560,168983.4375,225675.6,6508517738.35,228656.809962
7308,167,242640,534900,292260,304464.59375,288673.2,0.0,78530.8656664
3891,116,384420,786600,402180,409967.0625,418118.4,792846.844055,266759.465501
1335,76,1244280,7552500,6308220,6360597.5,6284018.4,6689237.47467,6437867.40136
434,87,424200,1090800,666600,770153.3125,856351.2,1748097.23761,2333501.05095
1407,77,210840,3257040,3046200,2839658.75,3109902.0,3743377.15198,3756051.66601
232,51,168420,280800,112380,670428.9375,1292923.2,323456.75061,1060350.49019
640,75,0,6135000,6135000,4777946.5,4243006.8,2673050.17749,2499100.19514
4001,71,2876400,3996240,1119840,1122377.5,1140525.6,861999.05896,971512.282452
5991,76,5036400,7552500,2516100,2518657.75,2513006.4,2505635.87335,2603818.89601
517,111,575520,3974400,3398880,3392382.25,3322234.8,3705282.95276,3601623.41038
2793,79,2419200,4151700,1732500,862186.9375,1526394.0,0.0,-64432.0365199
5639,146,4856400,6670800,1814400,1724265.5,1839667.2,2139269.1181,1891045.80006
2364,156,245340,2639280,2393940,2395334.25,2503933.2,2778692.00092,3258764.72669
4893,2,48960,2555640,2506680,2459975.0,2085090.0,1234617.46472,1127313.12792
1977,86,1003860,3519180,2515320,2526592.25,2515155.6,2337670.53503,2496245.39089
7051,213,2553180,3206820,653640,653459.4375,656060.4,0.0,511608.54603
8408,133,5922900,6181200,258300,260508.21875,289828.8,0.0,-36722.0390828
632,150,621180,626340,5160,16047.2929688,52892.4,0.0,-32820.3069604
8525,192,4590840,4648740,57900,146474.265625,109716.0,422427.010132,276101.330635
6570,208,42840,1620480,1577640,1612244.125,1621676.4,2630521.44525,2512381.67827
2478,142,2076360,7299960,5223600,5176132.0,5294029.2,0.0,4962681.18369
1452,79,1234800,4151700,2916900,2603468.0,2848479.6,2875027.62372,2601361.42603
3004,108,1463940,3191940,1728000,1738707.75,1695216.0,1632242.3725,1913963.56664
6392,31,176520,1374660,1198140,1208984.625,1189267.2,1433841.50092,1139786.02982
4305,219,42960,3797940,3754980,3481100.5,3718532.4,1933433.0072,1845291.10402
3476,203,643320,1897500,1254180,1308388.75,1245220.8,828595.879028,1676018.66524
4921,90,93420,1532940,1439520,1443237.125,1442115.6,1977581.19897,2004001.85286
8598,42,706800,953340,246540,269572.6875,207490.8,0.0,-382167.167697
3292,192,318240,4648740,4330500,4304357.0,4235341.2,3344550.25085,3578773.38881
8063,26,1510860,2036760,525900,554998.3125,488631.6,318888.534058,470945.138825
4168,107,1303020,4991760,3688740,3672442.0,3694354.8,3732135.54388,3372895.15228
3801,151,868740,3643800,2775060,2633413.0,2788393.2,2659049.32178,2013575.63522
7445,197,20400,626580,606180,755742.375,507518.4,1809264.78888,1871519.23895
7216,3,22740,1055580,1032840,1166675.0,982002.0,1098707.20258,1456010.39128
5284,113,3181860,3646740,464880,548256.0625,377751.6,409704.283997,834069.052061
4686,151,1539300,3643800,2104500,2117600.75,1997593.2,1712673.75287,1922915.58624
8356,30,398400,604800,206400,456469.875,413926.8,646289.568237,116458.308151
4797,186,358800,3636240,3277440,3390813.25,3240266.4,3984520.06067,3088182.83776
3989,141,3475200,7406100,3930900,3943617.25,3940924.8,3901536.26477,4242936.17434
2625,123,961380,3545820,2584440,2583966.5,2569660.8,2539334.91736,2639222.0374
8762,219,3644940,3797940,153000,163200.234375,217738.8,0.0,414663.693457
7331,133,4949520,6181200,1231680,1260714.0,1203816.0,1204651.09949,1556748.0578
4108,0,1330860,1560960,230100,245005.71875,244239.6,1045335.85327,900179.538339
5255,63,3141300,6232860,3091560,3139446.0,3095608.8,3523076.63525,3031243.5334
1745,63,355200,6232860,5877660,5903518.0,5875902.0,5893007.68591,6106985.01116
6561,64,5036700,6845160,1808460,1812940.0,1547841.6,1467745.6615,1613150.87273
5582,177,1587900,1713060,125160,143334.671875,136366.8,0.0,257028.995073
5924,196,728100,3281700,2553600,2548925.0,2537762.4,2982178.5777,2621929.34292
3083,141,2602260,7406100,4803840,4772450.0,4804641.6,4414471.58179,5023518.13794
2678,156,560220,2639280,2079060,2036711.625,2133165.6,1784927.77698,1728151.97395
4408,141,3732240,7406100,3673860,3672781.25,3679806.0,4190639.44482,3678687.5124
7455,220,1479240,2714040,1234800,1191255.0,1205641.2,1090619.87457,1121910.58057
7241,3,44100,1055580,1011480,1009576.25,1010440.8,1150973.36957,1000332.90364
2901,141,2455620,7406100,4950480,4894395.5,4917236.4,4535871.63715,4932798.93827
2928,156,733620,2639280,1905660,1939582.75,1903801.2,2704507.1972,2247061.50302
2159,77,868440,3257040,2388600,2497858.75,2419119.6,1890914.28888,2516798.33602
3659,199,99000,975720,876720,907133.625,861187.2,1769433.3988,2247368.05835
8633,42,725340,953340,228000,226600.671875,223064.4,0.0,147540.612394
8376,37,333540,736020,402480,403786.21875,395626.8,2109035.80499,2835999.02696
5623,213,1337040,3206820,1869780,1905587.375,1891485.6,2587299.64227,1988610.41525
4292,219,33840,3797940,3764100,3715644.0,3557361.6,2393832.14172,1839990.59021
2672,215,23100,1851720,1828620,1300456.125,1346290.8,289987.273499,1084427.0444
2316,156,188640,2639280,2450640,2859006.0,2499147.6,2543086.85223,2729576.46081
1074,88,551760,555360,3600,110633.289062,219384.0,1409149.85126,1514086.60019
7937,30,0,604800,604800,342338.90625,505100.4,1064707.36304,612286.499073
3628,66,3282600,4817700,1535100,1516291.875,1460677.2,1580891.74896,1817464.05945
2684,123,1005900,3545820,2539920,2683589.5,2510274.0,2231998.86456,2320768.55732
3170,67,2944140,3120480,176340,191090.109375,177582.0,0.0,190505.049705
3450,203,626880,1897500,1270620,1363868.0,1215918.0,1705757.12817,2052164.65496
5796,19,583800,608940,25140,29421.9746094,38286.0,0.0,-60384.5285767
6619,191,1543320,1811280,267960,220907.765625,181734.0,0.0,236981.712933
5270,131,3740100,6825900,3085800,3085932.75,3085056.0,2800196.40472,2824817.37518
9044,63,6232140,6232860,720,0.0,69092.4,62523362.0791,127784.548741
4079,107,1268160,4991760,3723600,3695612.25,3675585.6,3995947.91418,3534185.3362
6236,31,81180,1374660,1293480,1267284.375,1265925.6,922441.626709,891623.403534
5844,131,4236900,6825900,2589000,2588834.0,2596440.0,3194776.73315,2736213.9566
7129,48,153840,156420,2580,0.0,18290.4,880507.113281,79264.5003203
3562,116,31800,786600,754800,778212.8125,723800.4,1047799.42633,1529835.84004
4112,0,1332840,1560960,228120,231334.859375,241831.2,910448.137146,828391.408823
5904,63,3671640,6232860,2561220,2558379.75,2562404.4,153702191.189,2543946.96342
1912,77,707340,3257040,2549700,2559485.5,2553465.6,2885898.90485,2905261.86568
2072,63,558540,6232860,5674320,5678196.0,5674042.8,5494486.81525,5412109.05668
2409,94,500400,534480,34080,229682.171875,287592.0,847246.775513,770731.950963
6137,220,507900,2714040,2206140,2332582.25,2122808.4,2073236.66656,2411952.77673
217,146,157440,6670800,6513360,6531081.0,6511329.6,7219842.58691,6074734.05493
261,141,85500,7406100,7320600,6343738.0,5876676.0,4310945.0849,4477161.69394
371,76,284460,7552500,7268040,6951467.0,7266526.8,8315822.58691,7128402.01346
4478,135,3341700,5649480,2307780,2397443.75,2272192.8,2297998.664,2260034.04579
5161,217,108120,557700,449580,530038.5625,670603.2,1406969.54077,1211771.79283
1704,119,100620,2742780,2642160,2671173.0,2488537.2,3128692.63641,2797192.35409
3506,184,179400,1800900,1621500,1712032.5,1621974.0,1399996.03247,1122881.68563
8473,133,5973540,6181200,207660,226208.734375,210016.8,304324.026917,228659.497162
1388,77,200220,3257040,3056820,2859500.25,3075937.2,4198297.13086,3625909.51642
8862,204,2459940,2567700,107760,136262.703125,113822.4,0.0,-61594.2187369
2165,94,195060,534480,339420,355516.625,349071.6,721292.210205,1241001.4495
4885,161,1870080,1955580,85500,243267.421875,65820.0,859288.335022,510369.665046
6383,151,2896920,3643800,746880,732059.0,747042.0,670800.955139,613986.280426
7611,27,387000,402780,15780,77089.7265625,39483.6,0.0,486709.768205
4723,131,3432300,6825900,3393600,3405370.0,3386050.8,3173708.80731,3153603.9839
3385,114,539760,1201080,661320,660840.3125,824868.0,1130388.14471,1252735.88697
2350,66,2159340,4817700,2658360,2588230.25,2679963.6,2575187.21332,2642610.8668
7762,58,68280,992100,923820,863057.9375,873014.4,0.0,-92770.4748279
4892,169,137100,2190660,2053560,1849816.25,2046040.8,1992613.53632,2217053.8452
1584,134,136260,3656580,3520320,3444253.0,3413546.4,2063332.53992,2574094.17288
183,100,0,919500,919500,2474793.25,2974039.2,1954976.67822,2396871.68669
5054,146,4359360,6670800,2311440,2312725.0,2316436.8,16608382947.1,2419706.14647
3755,203,861900,1897500,1035600,1031878.875,1036746.0,209286.163879,1109740.55117
322,76,232080,7552500,7320420,6986906.0,7181366.4,6785062.0827,7609236.68891
4927,202,166740,166740,0,25998.1308594,689522.4,0.0,-104689.871383
7204,61,6220800,6225300,4500,0.0,11000.4,1836448239.14,22606.5054183
513,91,278880,1030200,751320,746677.4375,751538.4,1061117.16913,1336857.83184
812,76,679260,7552500,6873240,6828885.0,6688360.8,7509515.56781,6736887.54109
994,87,799140,1090800,291660,224149.625,353803.2,746681.834045,583732.773512
8522,30,513900,604800,90900,102334.859375,125635.2,0.0,-39938.2254709
2652,69,18660,2073180,2054520,2324723.75,1997136.0,2584541.05402,2275770.49222
3582,203,720900,1897500,1176600,1277519.75,1176108.0,1064038210.03,1752436.97169
3674,203,791100,1897500,1106400,1109984.75,1106167.2,627792835.546,1236269.9694
7909,28,39300,493260,453960,522246.9375,455337.6,457591.043396,984830.941081
8333,3,1006920,1055580,48660,42707.6992188,47995.2,0.0,-307743.668132
3262,142,2750100,7299960,4549860,4603660.5,4485670.8,0.0,4524084.76585
6982,31,701580,1374660,673080,672379.5625,671158.8,230499.342407,561535.051937
1124,86,273960,3519180,3245220,3227792.25,3254680.8,2597190.26501,2520230.70479
5227,54,220080,1314000,1093920,1187726.875,1122906.0,682792.287231,886784.702049
7650,189,259860,308460,48600,125536.75,76866.0,1263347.1955,1717513.91126
4530,201,1293240,1645440,352200,341146.1875,325990.8,0.0,298257.729898
7307,164,49500,123600,74100,97751.921875,81427.2,0.0,-657508.951875
1689,110,1493640,5579400,4085760,4088424.0,3979748.4,3604472.20306,3337962.58115
4217,135,3186900,5649480,2462580,2451388.5,2459228.4,2429263.5415,2364029.80199
196,120,179940,576000,396060,425088.34375,589750.8,2011815.16052,2221868.46898
6908,204,970140,2567700,1597560,1589452.375,1570300.8,1000707.40857,1566850.06282
6791,191,1780920,1811280,30360,20988.5820312,115122.0,235237.105652,387551.898737
4047,213,133020,3206820,3073800,3181677.5,3108099.6,4501518.31799,3829904.53474
8723,188,4244760,4327560,82800,46534.4023438,85599.6,0.0,-125076.199972
2493,135,1770300,5649480,3879180,3848895.75,3894140.4,4175109.3736,3745620.9206
1767,138,1724220,1785600,61380,59948.0429688,598674.0,0.0,212077.060974
1580,79,1321500,4151700,2830200,2840606.5,2842113.6,0.0,2338727.10221
6773,46,1871400,2027040,155640,56434.6914062,128857.2,0.0,-56396.1525801
4489,23,1891320,1894920,3600,0.0,26764.8,0.0,62883.9704436
549,83,0,1818000,1818000,2862835.75,3115996.8,3892009.7475,3458545.86648
1207,12,46500,850020,803520,1552460.625,840213.6,511013.856689,1571123.26859
1905,115,643260,954000,310740,600033.25,573235.2,1592144.78986,1820771.1047
330,141,124620,7406100,7281480,7275906.5,6932617.2,5741724.55811,5522397.139
6470,54,1314000,1314000,0,1450.33862305,15165.6,183051.885071,105458.292664
4077,213,158040,3206820,3048780,2968783.75,3046806.0,3910494.83417,3789989.81004
3971,166,1650300,1666080,15780,129119.007812,274455.6,190343.091614,-331753.449204
1027,83,375600,1818000,1442400,1441540.875,1442283.6,1498315.81671,1708856.66878
8311,26,1805160,2036760,231600,249197.84375,232992.0,367573.394287,344719.954449
1655,142,1226760,7299960,6073200,5942411.0,6038688.0,7142481.31464,6599403.4903
3386,203,603960,1897500,1293540,1281675.25,1316289.6,1354236.02881,1765256.1142
3030,107,268200,4991760,4723560,4795311.0,4608541.2,6186871.69061,4574108.82207
4929,98,4074480,7319880,3245400,3159751.75,3279690.0,3240449.37152,3572219.55379
4764,168,383280,438000,54720,107762.84375,248078.4,99850.855835,163945.831801
920,72,108360,2385960,2277600,2299998.75,2096643.6,2509820.81012,2400754.29117
8639,160,1328700,1564260,235560,225406.234375,220087.2,0.0,270405.179969
8855,57,2720700,2756640,35940,58346.3398438,54730.8,2602943010.21,-419294.149801
6479,75,4967160,6135000,1167840,1174283.5,1145151.6,2158333.55017,1437078.34071
3617,66,3261600,4817700,1556100,1480860.0,1566700.8,2022758.26019,1832114.85824
6261,63,4093140,6232860,2139720,2137092.25,2138672.4,401359403.502,2245800.03262
5344,142,4303980,7299960,2995980,2982071.0,2962717.2,4145343.35846,3036074.64523
5299,210,25680,1118160,1092480,1127992.875,1055617.2,952332.144226,787796.733199
2215,143,31800,1898460,1866660,1882378.25,1778739.6,1536642.36627,1720817.90029
8442,14,1163520,1327560,164040,201974.28125,159028.8,540403.843689,239895.418606
1402,130,92820,3083940,2991120,2998240.0,3034960.8,3138111.31396,3315121.38194
4904,196,0,3281700,3281700,2961467.0,2243588.4,1094996.30878,1443499.2637
5648,89,592980,1736340,1143360,1173113.5,1087080.0,1274158.45923,1274433.00459
8139,197,608220,626580,18360,72800.5625,75141.6,880772.35022,1303193.11591
5513,152,1050660,3766500,2715840,2987809.5,2499288.0,2917557.0639,3116264.00063
4871,215,1851720,1851720,0,0.0,324952.8,0.0,-923780.260513
5697,196,627300,3281700,2654400,2702012.25,2450092.8,1851723.33911,2049106.24454
4468,186,16860,3636240,3619380,3682304.0,3243194.4,2015171.54376,1395384.36787
1638,79,1351860,4151700,2799840,2766965.0,2732936.4,0.0,3122722.46232
5922,4,172560,1326000,1153440,1199315.375,1161780.0,1757503.28485,959476.020689
8924,206,1962660,2086740,124080,91388.234375,187002.0,1141344.07147,444795.466172
2004,86,1035180,3519180,2484000,2471813.75,2464642.8,1158230.22845,1804128.01665
894,110,739320,5579400,4840080,4568174.5,4151931.6,3656065.78662,3520084.34748
5819,17,17400,626460,609060,900248.125,792075.6,1651973.27405,1349388.28332
6633,32,166920,1205580,1038660,960673.625,968011.2,421900.066162,564594.908129
2852,158,268080,2044680,1776600,1838386.5,1836568.8,2468223.71985,2606959.304
715,118,53820,459900,406080,610273.6875,523424.4,4463088.86676,3952365.8878
6967,157,1654500,1993260,338760,352512.96875,439615.2,498801.578796,233396.622619
3510,184,180000,1800900,1620900,1587769.0,1590387.6,1428801.46442,1172885.24416
5296,134,3198420,3656580,458160,517866.96875,401392.8,753860.968567,190790.586314
5806,76,4930020,7552500,2622480,2615390.0,2614982.4,0.0,2684484.69332
5375,49,3938400,3991980,53580,147150.453125,55138.8,1486164.16205,3460.40492183
58,150,59400,626340,566940,789945.125,2512719.6,2284017.75287,1466343.75258
5726,103,4636200,4719960,83760,112207.65625,115502.4,0.0,168668.081907
1600,82,927000,2195880,1268880,1227618.125,1181091.6,1822091.31555,1353896.97686
6583,188,2485560,4327560,1842000,1822538.75,1790150.4,1461494.4472,1679549.1207
1130,76,1083000,7552500,6469500,6461748.5,6468373.2,305824774.678,6015448.43502
3452,23,1083900,1894920,811020,960394.3125,820682.4,781863.520081,1072679.29315
6417,210,1053720,1118160,64440,67887.09375,64150.8,196568.230774,-62209.1551089
6053,76,5097600,7552500,2454900,2454694.75,2452485.6,9463885942.33,2426286.45292
5237,125,3957960,3969060,11100,31184.4238281,113818.8,0.0,-197311.8004
6866,188,2802660,4327560,1524900,1556595.25,1526911.2,2410436.91431,1316462.92515
6804,213,2405700,3206820,801120,732549.0,774842.4,0.0,906715.053196
8952,219,3746340,3797940,51600,387264.0625,55465.2,0.0,396094.071971
5625,159,26160,2480580,2454420,1455493.75,1832554.8,1717052.71631,1438793.28714
5183,135,3877200,5649480,1772280,1697791.625,1734678.0,1652566.57013,1548024.55368
1158,104,273180,935100,661920,925109.9375,1030371.6,5919173.50604,3746788.75308
7647,183,23040,445560,422520,468652.5625,554980.8,37867.1849365,307149.052805
533,141,391320,7406100,7014780,7100123.0,6937956.0,6764989.86255,6023714.45707
6125,196,1043700,3281700,2238000,2361041.25,2327917.2,2498017.34259,2267264.90725
535,103,244620,4719960,4475340,3642088.5,1818330.0,1956324.89386,1978312.91464
1818,63,389100,6232860,5843760,5856551.5,5843403.6,5198839.17755,5601931.56283
2698,98,2244780,7319880,5075100,5069541.0,5087054.4,4046115.28204,4925560.63971
7950,220,1940940,2714040,773100,781243.4375,771391.2,1047936.05646,732784.819404
7171,162,3561300,4836120,1274820,1250430.5,1267807.2,569590924.694,1247784.5351
4646,156,2251860,2639280,387420,405257.21875,387258.0,680109.589417,505702.974519
4109,143,1732320,1898460,166140,177583.859375,138060.0,1503606.28094,879912.629939
5018,86,3515580,3519180,3600,168178.703125,193762.8,22204211458.2,5723.19841579
1746,63,355260,6232860,5877600,5894534.0,5875962.0,6347162.66675,6106959.31654
3900,141,3416880,7406100,3989220,3985317.0,3985994.4,4069882.96948,3893944.93785
7380,213,2750700,3206820,456120,511059.4375,413708.4,2647019767.35,-67867.0943198
8912,152,3766500,3766500,0,0.0,71962.8,0.0,172568.926558
6357,25,33420,1951380,1917960,1967161.75,1932415.2,3346519.6463,2645535.55459
7631,222,790200,1113000,322800,288966.03125,220482.0,0.0,-746487.664436
7569,205,460800,460800,0,43643.9609375,305059.2,0.0,-564212.867605
1897,101,81660,655020,573360,648722.9375,707133.6,1089618.05499,1276936.26919
3571,203,715440,1897500,1182060,1186896.25,1182114.0,993479.431213,896776.111988
2206,117,825360,1144740,319380,252166.53125,299301.6,56943.7307129,773994.022679
6457,110,5528100,5579400,51300,68971.984375,506396.4,5351713101.41,441304.487639
212,128,191460,346200,154740,139281.203125,270607.2,376128.36908,880101.66833
3068,201,78240,1645440,1567200,1600074.75,1720814.4,2301311.99023,1860040.08148
7699,15,954780,1822860,868080,864911.625,894346.8,2108339.03827,1017888.46759
2447,101,597420,655020,57600,361534.28125,174025.2,0.0,-545488.120092
4713,213,651600,3206820,2555220,2568898.0,2545608.0,2848492.21039,2556334.04186
170,146,126900,6670800,6543900,6535857.5,5893903.2,6114166.16211,5165811.95186
3671,79,3155700,4151700,996000,982931.6875,865405.2,3056107.35413,1263342.86915
9040,13,2514720,2525940,11220,25962.6035156,17724.0,134508.63446,115571.623543
2877,96,791400,2123400,1332000,1336795.125,1236068.4,2062646.19897,1476205.19824
2516,153,38100,1618560,1580460,2349413.5,1828593.6,3170032.74994,2598208.20254
5256,113,3169560,3646740,477180,510208.21875,265284.0,1247115.94775,1015549.99287
7920,170,20700,665160,644460,557641.4375,603657.6,0.0,112665.533459
675,93,546600,1242300,695700,693049.5625,671560.8,974889.058044,739768.800732
5506,57,27660,2756640,2728980,2743308.75,2726473.2,3189550.39362,2682883.81354
8054,178,621600,904200,282600,228812.359375,250706.4,581375.710999,40342.3423187
2227,63,664260,6232860,5568600,5572867.0,5570340.0,0.0,5439262.65494
6232,220,581520,2714040,2132520,2279201.5,1873999.2,0.0,2012863.48701
532,88,16200,555360,539160,1405512.0,927153.6,2154423.35327,2394290.69351
7425,178,78000,904200,826200,868726.875,813586.8,204260.470703,204415.203138
4424,141,3736740,7406100,3669360,3668401.0,3683155.2,3335963.22809,3498137.34006
240,111,242280,3974400,3732120,3704217.75,3732291.6,4617988.84595,4242712.88965
7814,219,2937420,3797940,860520,857860.3125,860715.6,1204109.55359,1293827.31137
7913,179,203880,345960,142080,145906.03125,141922.8,2102899656.0,327481.133151
5938,218,1437420,1974480,537060,524558.0,510679.2,0.0,27289.3517517
4804,90,31200,1532940,1501740,1576251.375,1431402.0,1387501.68079,1542133.42457
3508,199,0,975720,975720,2366109.5,2184019.2,2954282.36487,1924572.62964
5003,69,1933860,2073180,139320,96180.515625,117632.4,0.0,-413032.887043
3011,67,2682960,3120480,437520,439350.71875,431953.2,845801.343994,709190.696248
8794,196,3139740,3281700,141960,119524.382812,129672.0,0.0,319515.015568
7426,174,1226340,1300440,74100,97713.328125,283674.0,0.0,-387511.324888
5942,76,4998960,7552500,2553540,2551785.75,2548957.2,23003079067.5,2896367.29247
4715,69,1774860,2073180,298320,282499.125,249326.4,0.0,72798.4186409
6198,210,911760,1118160,206400,29282.7050781,272635.2,0.0,-310832.457761
2296,126,197460,496560,299100,697311.6875,865862.4,1342197.03827,1358723.03325
4470,133,2614980,6181200,3566220,3683659.0,3561224.4,4118212.87866,3773232.65192
229,146,161940,6670800,6508860,6548887.5,6556962.0,8452177.38635,7221695.64633
8047,178,618900,904200,285300,246970.328125,233389.2,1089596.70166,75087.9784135
2845,215,160800,1851720,1690920,1403069.25,1677818.4,34478.8040771,699073.588557
2084,61,1958760,6225300,4266540,4222518.0,4327486.8,0.0,4040207.79799
8615,63,6001140,6232860,231720,227770.078125,226215.6,195131430.883,253989.455781
2960,108,1442940,3191940,1749000,1813995.75,1760570.4,1974293.86621,1837450.50061
4916,125,3778560,3969060,190500,237466.515625,196567.2,370192.401062,579558.374354
1878,115,630000,954000,324000,517257.59375,626826.0,1140266.28558,1518321.63375
6201,76,5360400,7552500,2192100,2179767.75,2215378.8,8594251234.71,2207674.02931
1461,1,87780,1447140,1359360,1221942.75,1375826.4,1056865.45984,1038452.01188
6379,151,2895660,3643800,748140,733716.875,747891.6,234899.861816,706424.17999
2815,123,1119180,3545820,2426640,2486440.25,2361326.4,3008447.06061,2298733.09897
5046,71,3624300,3996240,371940,369087.28125,366321.6,8075285506.82,302955.702941
2298,83,1519200,1818000,298800,299949.0,280550.4,0.0,321350.025146
1073,118,456300,459900,3600,0.0,780826.8,194763.932007,-11652.6284816
4914,142,4047060,7299960,3252900,3301114.5,3197128.8,3555550.63763,3369575.59435
8163,13,1849260,2525940,676680,690003.625,674160.0,1861935.37103,1078875.47612
6579,131,4895460,6825900,1930440,1896511.0,1929520.8,1126646.09369,2212298.47616
1670,1,220020,1447140,1227120,1204396.125,1187560.8,1788580.35315,2170378.87146
5700,4,74760,1326000,1251240,1044899.1875,1134892.8,63971.3526001,483956.079901
5916,57,256680,2756640,2499960,2438965.25,2499280.8,0.0,2133974.33759
6718,10,945720,979740,34020,0.0,65163.6,545778.353088,-225503.277379
4758,86,3373140,3519180,146040,152861.953125,146130.0,299987.545471,377026.245699
6685,61,5759700,6225300,465600,930489.3125,860251.2,283848.906799,649080.452155
2599,103,2106060,4719960,2613900,2633853.5,2462233.2,2174818.55066,2098186.96691
6754,32,260760,1205580,944820,886136.0625,876858.0,346835.012329,492211.787496
4743,142,3955680,7299960,3344280,3351944.0,3325988.4,2927305.8175,3382677.22133
5500,142,4535160,7299960,2764800,2722295.75,2748418.8,0.0,2725950.56754
6408,31,187680,1374660,1186980,1143091.125,1183816.8,1038079.39484,878389.824997
5752,220,99660,2714040,2614380,2369015.25,2274060.0,2211508.02423,1993593.84079
7488,15,693240,1822860,1129620,1110973.75,1121064.0,828737.474365,1058728.2442
1241,131,450900,6825900,6375000,6368442.0,6373447.2,5713611.39117,4914343.26114
5535,10,20460,979740,959280,1481525.75,1300536.0,1719299.6557,1859648.61068
8215,11,1616040,1777560,161520,167263.5,173497.2,0.0,312248.289925
7888,22,31500,810360,778860,475858.6875,531915.6,1487519.73566,1099204.48345
993,66,895860,4817700,3921840,3943593.25,3733346.4,2966142.89478,3777280.04469
6790,191,1777320,1811280,33960,19542.8730469,119997.6,0.0,186574.883479
2656,63,1084020,6232860,5148840,5143823.5,5216654.4,0.0,5233876.9868
8842,76,7430400,7552500,122100,77805.015625,98818.8,0.0,228353.35241
388,128,346200,346200,0,383449.8125,447376.8,0.0,-479502.656928
5981,13,9960,2525940,2515980,2303900.0,1975809.6,1761569.56531,1497463.64889
6924,18,595140,1779540,1184400,1184022.0,1181658.0,1010771.4646,1208331.96394
6900,167,11040,534900,523860,535740.5625,523966.8,1626831.21881,1310718.94674
6494,155,2506200,3225180,718980,714313.375,714697.2,871847.797668,737638.805158
3778,98,3128580,7319880,4191300,4200466.0,4148820.0,4885336.20227,4357150.89751
292,91,0,1030200,1030200,2542718.75,3068977.2,2556202.96033,2830455.12291
6306,31,134820,1374660,1239840,1279413.25,1205528.4,1064707.60706,600908.987713
1386,77,200040,3257040,3057000,3062098.0,3072618.0,4695316.41656,3798196.35835
8086,76,6829200,7552500,723300,705096.375,690906.0,2819165108.78,565881.093464
3344,67,3069900,3120480,50580,68093.140625,117105.6,0.0,-352247.891762
8403,28,493260,493260,0,0.0,13268.4,779950.481445,857089.943881
1784,98,1481040,7319880,5838840,5808333.0,5834636.4,6009269.12042,5510896.59153
3918,114,1024680,1201080,176400,218734.265625,203698.8,812626.325989,610761.273441
5100,157,24240,1993260,1969020,2069609.625,1963213.2,1940001.51715,1403869.53896
924,105,729720,1314480,584760,504386.9375,560308.8,2388500.76569,1227161.23926
3563,147,1326660,1479360,152700,156907.328125,185985.6,0.0,112889.284932
4472,156,2008320,2639280,630960,611931.75,610437.6,1172565.72278,581026.48523
5740,57,171780,2756640,2584860,2777982.75,2325932.4,3085499.6756,2599105.5921
3732,203,833100,1897500,1064400,1008957.875,1057314.0,0.0,1218027.73841
6974,222,258540,1113000,854460,885108.25,824136.0,0.0,-121352.147548
205,68,219000,262800,43800,426109.125,144322.8,2482268.03705,2935418.12319
760,124,625800,754200,128400,40615.0234375,144782.4,70119.8026123,318072.227522
997,76,835620,7552500,6716880,6771262.5,6529987.2,6827369.99066,6706543.13744
6035,220,266400,2714040,2447640,2423356.5,2404209.6,2596847.07257,2476000.84896
2119,66,1965600,4817700,2852100,2850840.5,2852116.8,3305912.80585,2857957.22939
5988,220,233520,2714040,2480520,2524255.0,2476429.2,2999696.16437,2452022.41651
2836,215,155760,1851720,1695960,1456196.75,1700206.8,784467.7677,972978.421227
2574,156,500880,2639280,2138400,2245094.25,2140634.4,1219154.20593,1432247.40149
2416,66,2312100,4817700,2505600,2508058.0,2495482.8,2560419.54089,2388685.30065
8880,196,3197760,3281700,83940,18564.7109375,78513.6,0.0,86215.4223088
1226,12,57000,850020,793020,305961.875,812089.2,427769.313171,798099.95776
6680,18,281460,1779540,1498080,1767170.625,1602824.4,401141.523438,1181756.93558
569,135,9000,5649480,5640480,2523946.0,2169222.0,2872247.64099,2539738.46438
6456,31,223620,1374660,1151040,1178645.75,1170590.4,1272454.88,1353917.23834
2975,108,1450140,3191940,1741800,1743405.625,1741972.8,1654845.61438,1659790.49666
5086,156,2501580,2639280,137700,105385.304688,129460.8,10360508587.4,-66648.4454045
5076,180,1104000,3322080,2218080,2171191.75,2212663.2,2302211.18591,1993591.39018
247,65,172800,7544400,7371600,6543920.0,5488800.0,5171173.8703,5627403.51706
7451,188,3148980,4327560,1178580,1109417.875,1200604.8,1409523.20959,1065239.22249
5072,98,4152480,7319880,3167400,3123342.0,3121347.6,3526108.52521,2953512.43921
2644,135,1856940,5649480,3792540,3827075.75,3789674.4,5905363.30377,3869037.49693
7202,213,2639580,3206820,567240,573306.625,561654.0,82830.0387573,609722.322585
4917,130,3083940,3083940,0,59859.1796875,42382.8,0.0,271858.854157
5788,63,3618540,6232860,2614320,2634165.25,2619094.8,5860670211.5,2674593.24061
7033,167,82680,534900,452220,487558.96875,478190.4,5684.95849609,517985.223986
406,53,24120,582540,558420,591698.625,974210.4,3165522.89484,2458033.72625
6193,63,4046940,6232860,2185920,2185894.75,2197165.2,0.0,2164828.94458
4864,215,1848120,1851720,3600,0.0,334129.2,0.0,-742309.103596
7997,7,40380,40380,0,483020.9375,384988.8,1545068.23285,1616003.75491
4972,90,118500,1532940,1414440,1295837.125,1190422.8,0.0,207359.642819
1983,72,1172760,2385960,1213200,1300086.0,1354393.2,1950845.84924,1545171.81121
2753,98,2278740,7319880,5041140,5032272.0,5018440.8,2717257170.66,4690905.15607
5810,89,670920,1736340,1065420,984426.125,718110.0,1549356.67889,1193199.44812
3390,114,542220,1201080,658860,620879.25,657244.8,0.0,298647.42156
5470,196,471300,3281700,2810400,2577418.5,2769397.2,2559831.43048,2019503.13208
3948,116,433800,786600,352800,273730.0625,345314.4,0.0,228528.104414
2660,133,1146540,6181200,5034660,5055410.5,5052876.0,6335867.56342,4912809.82705
3075,151,124380,3643800,3519420,2512100.25,2367525.6,2358103.5448,1821301.75046
929,144,192240,1807260,1615020,1517961.625,1500595.2,2664271.72321,2155735.56245
5332,146,4532220,6670800,2138580,2159273.25,2141438.4,2605687.38757,2325560.09095
96,149,88140,223140,135000,145232.4375,192742.8,2137552.62634,1799776.26737
8976,160,1521060,1564260,43200,66169.203125,44200.8,6816480044.82,59653.7346907
194,100,4560,919500,914940,1912918.0,2387690.4,2658276.3988,2615124.37534
8636,64,6760380,6845160,84780,85820.4140625,139699.2,378710.47644,366788.988054
4502,153,1618560,1618560,0,0.0,9283.2,657918.136047,801423.999783
1055,131,278700,6825900,6547200,6525550.5,6539403.6,4470208.98755,4222959.40132
8359,30,398460,604800,206340,464658.46875,413482.8,761036.142639,59383.9483041
2825,69,163680,2073180,1909500,1809385.125,1965280.8,843593.268982,1225377.88061
3313,114,477660,1201080,723420,717645.625,671800.8,384725.881897,796502.192403
7869,15,1063020,1822860,759840,784550.75,765379.2,291076.929443,708355.102746
7636,219,2794680,3797940,1003260,975975.8125,1013149.2,1192268.96735,841083.8164
1373,146,1275360,6670800,5395440,5409596.5,5383389.6,4800835.41321,5416873.0065
6554,208,28440,1620480,1592040,1628311.375,1480765.2,788597.276611,1220251.74909
8151,224,0,648060,648060,117666.21875,481825.2,704421.198486,637391.421608
4102,131,2940720,6825900,3885180,3835037.75,3875952.0,2961032.08948,3451748.70628
981,105,798720,1314480,515760,511740.6875,517776.0,860125.791077,635390.842705
5208,146,4445820,6670800,2224980,2352315.0,2176213.2,1395930.6123,2410107.76552
4589,182,849660,915060,65400,125254.453125,336313.2,0.0,-96077.0956129
3955,123,2160420,3545820,1385400,1404268.5,1343382.0,509712.60321,1296886.24361
8873,29,21360,57540,36180,72973.78125,198926.4,0.0,12399.9207571
1065,112,0,1303440,1303440,1819761.75,1370562.0,3615545.39111,2973340.62944
3427,137,69180,243720,174540,128739.304688,223903.2,30727.3756714,225301.764735
8072,222,1081800,1113000,31200,38763.5390625,31054.8,0.0,-604227.958817
5524,76,4776000,7552500,2776500,2785475.5,2771643.6,2676653.94696,2765365.15963
3704,148,1938900,1938900,0,0.0,182412.0,0.0,-362736.966106
5476,213,1243500,3206820,1963320,1970945.0,1948737.6,2893833.60803,2491664.69256
4762,215,1794600,1851720,57120,56582.6953125,249324.0,0.0,-627782.607255
4906,142,4042980,7299960,3256980,3250797.5,3252566.4,0.0,3321020.45114
4832,156,2357460,2639280,281820,285716.1875,275536.8,1170801.95648,237206.417046
5956,204,18780,2567700,2548920,2312310.75,2343778.8,2931795.83582,2743924.22051
8783,37,575280,736020,160740,155418.65625,486298.8,0.0,142498.096428
7770,58,80100,992100,912000,941923.9375,864766.8,0.0,-361577.356209
7646,63,5228340,6232860,1004520,674908.625,815934.0,635979129.388,881142.443164
177,141,6000,7406100,7400100,3782905.75,3087969.6,3138521.78363,3104211.04392
2125,63,614160,6232860,5618700,5530290.0,5560914.0,5721758.92938,5475087.93632
1966,111,1882560,3974400,2091840,2112722.25,2121896.4,2655008.78259,1848600.38959
6247,11,80820,1777560,1696740,1815027.25,1661344.8,1824188.06854,2531548.57914
7037,195,115200,393120,277920,288312.15625,335492.4,0.0,122565.136379
1349,67,1292820,3120480,1827660,1608447.125,1243623.6,4234239.60358,3099378.40527
1583,135,875220,5649480,4774260,1895342.25,3565250.4,1148844.71222,1886736.23111
4845,156,2368920,2639280,270360,251572.828125,274641.6,1522613.36798,264592.507867
178,120,171600,576000,404400,457963.375,508303.2,1715213.70837,1821411.28618
4017,184,646800,1800900,1154100,1152477.5,1123136.4,1359676.16125,1080831.14307
1942,96,18060,2123400,2105340,1904283.875,1737776.4,1463037.08099,1516430.60551
2966,173,169020,3215700,3046680,3070402.75,3024847.2,2583151.92487,2593140.14966
4829,169,91860,2190660,2098800,2105562.75,2211808.8,1788950.44214,2317983.10793
5567,214,337260,341760,4500,69082.4921875,56512.8,0.0,486176.575451
392,53,17100,582540,565440,369679.0625,709234.8,881001.203125,1861211.41724
7493,220,1529640,2714040,1184400,1159776.75,1157934.0,247455.859741,380397.982384
762,76,652800,7552500,6899700,7103177.0,6904831.2,6722325.62549,6793672.58462
4133,198,708660,708660,0,0.0,26691.6,0.0,-693517.91331
2150,96,163800,2123400,1959600,1772731.625,1393532.4,636884.291992,1165460.93946
2452,94,534480,534480,0,0.0,159146.4,400599.71344,298111.016218
7203,61,6220800,6225300,4500,0.0,11706.0,1835576083.75,22606.5054183
2748,73,11100,1303500,1292400,1981189.625,1503825.6,2046299.20966,2119931.5379
3111,130,1671660,3083940,1412280,1413343.375,1415875.2,0.0,1612780.56614
2724,200,29040,59160,30120,0.0,307476.0,785026.895691,1811509.38077
7754,31,1319580,1374660,55080,50470.0703125,59190.0,0.0,-257633.36411
4091,151,1074960,3643800,2568840,2570247.75,2564293.2,2525575.02039,2216104.34538
5429,49,3987540,3991980,4440,0.0,58411.2,495543418.913,432744.978385
2995,67,2672700,3120480,447780,438695.03125,422076.0,307646.721802,501665.795454
6463,188,2399160,4327560,1928400,1933525.25,1559730.0,2093179.32593,2008711.36408
9016,131,6799200,6825900,26700,0.0,11481.6,0.0,-175555.114517
5221,156,2579700,2639280,59580,55713.8007812,60138.0,130843.545044,-12809.22469
6492,63,4244820,6232860,1988040,2097583.75,2031950.4,110374654.186,2237117.5392
1071,78,518400,1818900,1300500,1422962.5,1038756.0,75258.5491943,718923.518135
4939,146,4290300,6670800,2380500,2192434.5,2622984.0,3318858.61395,2846160.40003
7939,63,5429340,6232860,803520,829750.6875,794133.6,0.0,683842.309352
2668,69,31860,2073180,2041320,2087472.875,1971895.2,1807212.30139,1643396.84091
7357,5,744600,748200,3600,0.0,246016.8,0.0,-414936.705227
7499,27,198720,402780,204060,196942.578125,203622.0,0.0,210694.232347
7971,196,2506260,3281700,775440,780791.75,772051.2,762334.277344,822733.743584
43,51,3000,280800,277800,161452.5625,453326.4,654833.853699,1523599.27025
953,66,863940,4817700,3953760,3942637.0,3791328.0,4177274.52795,3875333.66193
2868,173,108360,3215700,3107340,3046292.25,3080511.6,3511575.6087,2964393.20587
5355,142,4322340,7299960,2977620,2976813.0,2926872.0,3796840.81873,2646179.2961
2902,173,117600,3215700,3098100,3084970.0,3130491.6,4026127.4408,2984310.9083
808,83,158400,1818000,1659600,1603141.75,1651130.4,2544211.84918,2655561.19205
960,131,84780,6825900,6741120,6749157.5,6624177.6,4730620.32458,4466833.3319
3930,218,0,1974480,1974480,1606472.25,1477041.6,1599313.6322,1691621.33108
6210,176,225180,1462860,1237680,1633337.25,1242360.0,904262.426697,481537.796888
3986,130,2403540,3083940,680400,635619.0625,678680.4,0.0,862208.309475
2875,171,312600,435600,123000,275332.75,130333.2,415530.334229,960370.287125
6595,75,5053560,6135000,1081440,1086001.375,1076293.2,1129304.53931,1126776.89559
1029,83,376200,1818000,1441800,1442106.625,1441442.4,1530301.57953,1774727.91984
6042,210,633600,1118160,484560,484457.0625,494427.6,917158.388306,678503.835093
1234,117,30120,1144740,1114620,1496171.75,1198810.8,3024024.17596,1949391.07475
7751,219,2882340,3797940,915600,896348.9375,890152.8,140275.950989,767523.233358
1243,138,1225200,1785600,560400,504883.28125,487958.4,15061500665.6,447360.05266
2285,134,757920,3656580,2898660,2884481.5,2816661.6,2135358.16486,1841814.97662
1964,113,511860,3646740,3134880,3008419.75,2934729.6,3462316667.89,2867083.38584
7930,15,1100820,1822860,722040,715756.0,734628.0,0.0,619443.234652
895,106,699840,1023180,323340,462143.75,291930.0,109451.453308,631763.962056
8586,159,2480580,2480580,0,0.0,59236.8,0.0,-1408924.71049
2360,135,1568220,5649480,4081260,4445587.0,4013937.6,4095081.3653,3519420.42808
6092,220,453060,2714040,2260980,2306057.5,2261370.0,2975862.08795,2539754.14793
6575,26,303720,2036760,1733040,1501013.75,1703216.4,1330635.89948,1745806.12343
1377,133,14400,6181200,6166800,5942851.0,3885652.8,2380028.13019,2554549.4039
5084,71,3636600,3996240,359640,282607.8125,356247.6,0.0,234365.02102
4828,2,2880,2555640,2552760,2371950.5,2188782.0,1913426.95447,1597132.04791
2008,126,0,496560,496560,849467.375,834472.8,1275784.85504,1749223.96181
6049,63,3776400,6232860,2456460,2455411.75,2446760.4,0.0,2605769.95843
6268,172,24480,1443960,1419480,1414357.5,1410778.8,1168127.2926,743773.993711
1429,121,825900,856140,30240,35274.5117188,42456.0,0.0,-439075.44285
6034,57,342720,2756640,2413920,2407489.0,2402374.8,0.0,2298856.02626
651,84,459780,3714840,3255060,3248420.0,3095604.0,3203814.85248,3096274.07893
3402,137,61080,243720,182640,191082.625,274968.0,287831.223206,517768.729429
8419,37,373980,736020,362040,325545.6875,352698.0,851800.252441,955997.114573
916,142,532380,7299960,6767580,6611151.0,6738993.6,6475145.26788,6618620.21744
2818,63,1222740,6232860,5010120,5010730.0,5009593.2,0.0,5104912.64541
6530,10,823920,979740,155820,153423.203125,186412.8,0.0,170138.307304
2821,0,204840,1560960,1356120,2514456.25,3017593.2,2832154.01184,2300957.34319
3267,162,420660,4836120,4415460,4383663.5,4288882.8,3733056.99255,4158938.239
5610,193,23400,187200,163800,318094.3125,992451.6,0.0,506035.44526
5564,113,3509460,3646740,137280,116325.742188,235528.8,567871.742859,486331.392919
290,120,264900,576000,311100,387628.09375,556855.2,679954.052795,1102122.60959
5170,125,3920160,3969060,48900,0.0,54525.6,575958.062012,65055.1026123
2494,156,445980,2639280,2193300,2304238.25,2182878.0,2379256.8183,3365325.17601
5117,156,2518320,2639280,120960,122025.109375,141822.0,14361992789.9,113578.33832
8449,224,335580,648060,312480,293089.71875,268518.0,0.0,-218182.525579
2736,110,2461080,5579400,3118320,3172664.5,3153130.8,3021398.04877,2895361.66586
6860,61,6018060,6225300,207240,225678.296875,223758.0,842226.300842,458059.184395
999,86,37680,3519180,3481500,3135235.25,2991294.0,2922522.92853,3035519.42617
574,127,16440,599940,583500,481091.8125,839991.6,1729430.8645,1954608.68046
105,76,46200,7552500,7506300,6959921.0,6235879.2,5529811.54926,4564004.13873
467,103,217500,4719960,4502460,3151033.75,2339131.2,2171006.60248,2778065.29225
377,79,201660,4151700,3950040,3954537.0,3949718.4,5059326.19922,4311718.04928
859,84,606420,3714840,3108420,2965845.5,2813512.8,2846095.26874,2600607.3014
5979,63,3716160,6232860,2516700,2517095.0,2513482.8,27775500.1105,2589002.14842
2223,112,932760,1303440,370680,611730.6875,440143.2,333777.897888,268479.2722
492,141,374400,7406100,7031700,7025262.5,7027933.2,6451231.85217,6194760.24009
5483,102,2989980,3198240,208260,212544.15625,200066.4,867868.358276,762419.567622
1273,117,50460,1144740,1094280,1456989.75,1368475.2,2153753.29248,1903774.41095
8722,221,851400,934800,83400,88684.7890625,83852.4,613458.536621,56862.3618698
1548,132,172440,1658640,1486200,1560390.375,1463163.6,3591122.28839,3579470.97531
7521,185,41400,441420,400020,391048.625,408818.4,2108424.84735,749679.3989
2809,63,1220940,6232860,5011920,4983971.0,4995066.0,0.0,4872774.94845
4213,73,1256400,1303500,47100,37900.9609375,99495.6,0.0,-202844.182136
8392,220,2363940,2714040,350100,337716.25,346875.6,145951.976746,306515.69522
5004,69,1933860,2073180,139320,135027.265625,129216.0,0.0,-468564.933978
4050,116,493200,786600,293400,400142.46875,245078.4,298622.764038,230043.465856
8462,133,5962920,6181200,218280,222550.875,217240.8,365790.826599,306945.78951
273,87,164100,1090800,926700,996638.125,871808.4,1074555.86169,1728288.0141
9001,42,924360,953340,28980,0.0,28039.2,135103.393799,179616.555568
4548,213,434040,3206820,2772780,2755656.75,2760555.6,2630551.94574,3067358.82777
2612,92,0,613860,613860,978312.125,1517388.0,0.0,376499.205345
1982,63,504540,6232860,5728320,5738140.5,5730196.8,6660907.03363,5764199.39985
8588,14,1255560,1327560,72000,112377.523438,74528.4,37151.6404419,163440.072794
200,149,173040,223140,50100,29720.875,58587.6,0.0,214651.781314
4550,156,2072820,2639280,566460,556949.1875,575163.6,1131815.56128,738122.838585
7876,170,0,665160,665160,405639.875,537756.0,365858.40918,472660.156328
8485,212,129420,204240,74820,119509.273438,95223.6,0.0,25206.6901549
1947,98,1588980,7319880,5730900,5675223.5,5463022.8,5485696.91425,5532156.51203
7379,16,13200,117000,103800,12323.6347656,127927.2,0.0,-1622068.99511
1456,63,11400,6232860,6221460,6135577.5,6071430.0,3949753.90424,3847323.62707
1599,122,606480,861720,255240,235909.125,254491.2,0.0,161642.758339
1808,104,872100,935100,63000,68826.8984375,195496.8,0.0,-67406.3853107
5285,103,4204620,4719960,515340,561754.5,492157.2,0.0,564517.480564
3275,23,976500,1894920,918420,903184.75,902934.0,247069.523438,645695.861466
8476,139,24600,273900,249300,160409.796875,248703.6,528056.20166,385657.467233
3698,199,119340,975720,856380,1259957.625,1075108.8,1576285.60071,2539666.13534
7292,3,67560,1055580,988020,982941.1875,980314.8,728345.983276,1108854.18644
3351,23,1031820,1894920,863100,862728.375,845337.6,15591271288.0,523905.825053
2765,165,70500,1262880,1192380,1219302.625,1181328.0,705379.006958,989245.615447
1834,133,456420,6181200,5724780,5305985.5,5472462.0,5772023.07422,5345484.17402
8140,190,14880,705600,690720,734705.0,654514.8,0.0,-422974.832007
7383,178,61800,904200,842400,741184.4375,816351.6,0.0,-518151.232388
5137,98,4180380,7319880,3139500,3168206.75,3169275.6,4585033.2771,3379559.58931
1734,63,336240,6232860,5896620,5878069.0,5888304.0,6173137.55591,6280065.4849
1634,135,904440,5649480,4745040,4451541.0,4277559.6,2499889.82379,2253943.62951
6087,13,118680,2525940,2407260,2306351.5,2352582.0,2232100.59827,1709944.40187
2152,133,684360,6181200,5496840,5419236.5,5321359.2,5285177.65472,4514269.22463
4127,165,1262880,1262880,0,22001.8242188,123372.0,287353.712402,-404938.138756
3667,148,1917240,1938900,21660,0.0,32143.2,0.0,-1160453.74039
1033,62,136860,3674460,3537600,3565442.0,3699728.4,3565747.24036,4860036.08629
3281,166,1048260,1666080,617820,696096.0,802687.2,541114.272949,607607.044976
1765,122,861720,861720,0,205278.84375,533426.4,0.0,41933.3309491
4915,142,4047060,7299960,3252900,3301114.5,3171966.0,2696834.25372,3369575.59435
8274,14,1010460,1327560,317100,325420.28125,319592.4,257379.175781,29346.5785362
2199,82,1468680,2195880,727200,911588.75,772675.2,0.0,425825.898896
3010,67,2682900,3120480,437580,419870.375,427820.4,655299.461914,562236.994398
234,124,124200,754200,630000,957433.0,1893924.0,1945142.29401,1059026.80314
5920,76,4984140,7552500,2568360,2565738.25,2566047.6,2905346.27655,2664757.79919
3709,203,808800,1897500,1088700,1082073.0,1087777.2,21596440116.3,1264899.21737
6572,32,128880,1205580,1076700,1046328.75,964657.2,80802.5895386,687096.842769
7427,164,123540,123600,60,26725.984375,2512.8,0.0,132172.421175
349,51,277200,280800,3600,0.0,80254.8,0.0,141844.551136
4876,168,438000,438000,0,447.427581787,17805.6,824.002258301,88840.216122
8440,30,461640,604800,143160,184464.84375,141086.4,1493779.93188,278127.032956
6777,46,1873860,2027040,153180,64433.7734375,92265.6,88375.3961182,-57449.6316337
2005,63,529740,6232860,5703120,5687439.5,5699235.6,4790264.18665,5078613.54949
8583,30,552240,604800,52560,50373.4140625,74328.0,1211.34899902,-181484.111671
4750,151,1594680,3643800,2049120,2051968.625,2027058.0,1994585.72858,2056969.3018
957,80,338580,338580,0,0.0,330192.0,746857.943665,302138.955019
1891,133,507240,6181200,5673960,5696307.5,5479185.6,5590773.16534,5093181.44262
7947,63,5432940,6232860,799920,854089.375,806550.0,0.0,622402.649861
6097,174,232860,1300440,1067580,1055209.875,1087682.4,1314995.77539,943473.412062
8438,30,461100,604800,143700,168481.09375,144392.4,976506.438599,178607.433798
7041,195,117360,393120,275760,336355.28125,316513.2,0.0,305163.785995
2176,101,263400,655020,391620,392969.625,448044.0,0.0,56313.0781102
2813,165,123480,1262880,1139400,1263494.5,1335135.6,1960516.62933,1044465.00684
2835,158,262320,2044680,1782360,2113584.0,1902003.6,2651564.01355,2415803.12594
6616,204,649740,2567700,1917960,1855527.375,1899892.8,1761893.35504,2111600.27021
4067,184,676800,1800900,1124100,1069362.125,1009164.0,718720.23114,737882.920173
8808,76,7413120,7552500,139380,140167.078125,117637.2,0.0,25026.2651848
7810,22,0,810360,810360,535641.5,426651.6,270780.903564,1022591.55418
5739,216,465780,496500,30720,36253.421875,29912.4,125144.158569,-288864.585096
5902,57,255060,2756640,2501580,2487000.75,2500154.4,9761428332.82,2317720.88379
7755,58,65940,992100,926160,930585.5,830413.2,0.0,-22668.7042408
3332,130,1828800,3083940,1255140,1306377.125,1008660.0,483272.782227,915969.206852
8307,208,1546260,1620480,74220,97351.125,142645.2,32007.3205566,119381.688123
2600,123,952320,3545820,2593500,2587547.5,2593418.4,2402443.61194,2649721.89603
2864,141,2443920,7406100,4962180,4820744.5,4895552.4,4280526.78577,4488762.34595
1796,63,377940,6232860,5854920,5864204.5,5855966.4,4617134.79456,5453857.72237
2258,75,1452660,6135000,4682340,3711157.75,3837934.8,7172207223.15,3554607.45848
6990,146,6022800,6670800,648000,654824.8125,673500.0,830444.648254,774283.191371
7184,14,81120,1327560,1246440,1240912.75,1178019.6,0.0,1102964.69751
1610,132,220740,1658640,1437900,1501138.875,1376833.2,2713893.88025,2270364.03781
2899,114,48120,1201080,1152960,1569695.0,1351442.4,2227836.84363,2033507.34684
2217,84,1845360,3714840,1869480,1931117.0,2388757.2,1819859.89899,1739524.90468
4484,186,34080,3636240,3602160,3086329.25,2328034.8,1022740.13489,981297.06298
4406,152,137760,3766500,3628740,1793712.75,1406155.2,1149194.15399,1387066.80306
7725,178,423060,904200,481140,242345.015625,239330.4,392783.036133,351311.864708
3518,71,2416620,3996240,1579620,1655295.875,1504333.2,1543945.27246,919656.626482
6256,204,409080,2567700,2158620,2110135.0,2069694.0,2678400.81439,2441882.37938
8903,190,615480,705600,90120,94089.75,190362.0,0.0,-836592.191449
1491,110,1331400,5579400,4248000,4158999.5,4248518.4,3504514.56952,3141933.43834
8062,159,2006880,2480580,473700,390924.1875,452563.2,0.0,-213012.613586
1011,66,937080,4817700,3880620,3902438.25,3666634.8,4124525.3855,3685745.33557
125,106,18000,1023180,1005180,996210.9375,1008198.0,0.0,729528.572717
6227,162,2835720,4836120,2000400,1968782.5,1981322.4,1954334.63843,2236675.3457
7485,27,185460,402780,217320,230280.53125,215946.0,2612707.39362,2188558.23813
3968,71,2857200,3996240,1139040,1137283.125,1143489.6,1272505.9577,960390.134175
4152,114,1164180,1201080,36900,34834.4453125,57745.2,0.0,-84320.3314724
4732,187,62100,2496960,2434860,2045538.875,1941374.4,740438.616821,903077.9006
2332,23,64380,1894920,1830540,1786613.75,1750304.4,2192387411.75,2090784.30641
6403,151,2909040,3643800,734760,769808.1875,708438.0,955870.363342,926390.100726
5083,146,4369680,6670800,2301120,2338309.5,2300720.4,18445338070.6,2297734.8291
5865,196,706860,3281700,2574840,2483550.5,2532922.8,2667235.38257,2323210.2995
6521,10,813600,979740,166140,156780.6875,200196.0,557691.332642,-64691.1630892
6895,195,34920,393120,358200,461599.75,524234.4,959568.851746,998966.787755
1134,76,1087200,7552500,6465300,6468692.5,6468524.4,6412616.0589,6187242.31217
6606,5,155340,748200,592860,566281.3125,480818.4,0.0,146498.245058
1409,1,44580,1447140,1402560,1527410.75,1320966.0,0.0,289717.27025
6150,131,4603320,6825900,2222580,2221739.75,2246236.8,2405074.91504,2089847.19801
748,80,181920,338580,156660,261235.671875,566112.0,983039.466858,1587469.66114
9041,131,6822300,6825900,3600,0.0,2478.0,0.0,197586.653643
1502,12,235500,850020,614520,598960.875,617458.8,60835.3825073,826704.050986
6916,222,222300,1113000,890700,871653.1875,859665.6,44809.4098511,244364.170914
3251,77,1896660,3257040,1360380,1328492.0,1341826.8,1235195.8501,1603013.12699
1729,79,1555200,4151700,2596500,2656048.25,2649145.2,1777739.08508,2499002.43911
3892,213,25680,3206820,3181140,2661760.0,2229427.2,2778399.34393,1920923.4733
2957,135,2083920,5649480,3565560,3110273.0,3069819.6,4012650.22998,3517333.31434
8237,63,5633340,6232860,599520,599100.75,600088.8,237833005.394,452351.449486
6166,98,5131800,7319880,2188080,2188331.5,2116948.8,6510822560.63,2281502.70999
2986,132,1430400,1658640,228240,217777.140625,262873.2,970664.864136,317506.591281
5192,157,64680,1993260,1928580,1880220.5,1597905.6,1165408.67981,1124766.30421
7068,209,4500,1091400,1086900,1192115.0,1277227.2,619908.971436,816467.090451
4882,161,1870080,1955580,85500,212351.65625,58852.8,0.0,337284.328951
4136,153,1401480,1618560,217080,289997.5,352413.6,1753342.12146,1370101.15181
2195,63,644340,6232860,5588520,5578528.5,5589982.8,4934675.89111,5298926.54796
5350,177,1315440,1713060,397620,504050.53125,538414.8,481528.546997,523128.890113
9067,76,7552500,7552500,0,91458.140625,162879.6,26137.8673706,124792.493132
2186,1,716880,1447140,730260,718521.75,683060.4,1178654.1156,576135.083705
6731,75,5159760,6135000,975240,972739.0,972196.8,1334186.02771,1056798.16676
17,149,0,223140,223140,2442661.0,2030689.2,1688476.25183,2309193.48488
7739,219,2875140,3797940,922800,950337.6875,921144.0,1515227.29797,1221727.58726
1481,146,1341840,6670800,5328960,5365412.5,5265451.2,5921877.38153,5195520.19641
6555,208,28440,1620480,1592040,1623876.875,1648387.2,2020320.23083,2083453.56622
6759,75,5178000,6135000,957000,965925.9375,903394.8,923874.860107,965558.506617
1128,121,611700,856140,244440,268288.25,221006.4,0.0,-590220.076825
7224,61,6225300,6225300,0,0.0,17020.8,1543569.50159,112823.229844
2970,162,74400,4836120,4761720,4885163.0,4726920.0,2939819.42908,3380851.51708
7382,195,328200,393120,64920,225923.265625,82125.6,0.0,-463842.441961
5057,156,2488260,2639280,151020,160016.375,148544.4,0.0,-54897.9675669
7299,219,2444940,3797940,1353000,1336531.0,1254286.8,1723920.11829,1654661.70582
5516,213,1261740,3206820,1945080,1925464.25,1927174.8,0.0,2293022.0713
8728,188,4245960,4327560,81600,71828.15625,79754.4,0.0,-120075.153269
4332,84,3684300,3714840,30540,0.0,36790.8,0.0,105112.208282
948,76,794460,7552500,6758040,6757222.5,6699759.6,6741923.25342,6816735.03494
6670,4,856860,1326000,469140,473663.4375,367806.0,418742.655762,245882.503389
5786,177,1709460,1713060,3600,52536.859375,353494.8,69478.1529541,-443841.920238
3032,130,1473480,3083940,1610460,1589206.875,1603780.8,1547924.00616,1951358.432
5061,157,0,1993260,1993260,1268104.625,977770.8,1371209.67694,1306770.15674
1686,133,244080,6181200,5937120,5861222.0,5952662.4,4482740.63281,4486393.68138
4645,133,2859600,6181200,3321600,3246302.5,3298108.8,3722032.53363,3405960.12875
1466,33,64680,78900,14220,0.0,149256.0,407281.360718,645026.099309
3222,77,1872060,3257040,1384980,1364339.875,1455444.0,2101775.01263,1719168.49501
3711,203,813900,1897500,1083600,1116971.0,1082814.0,1006191.54401,1498600.80048
2740,73,0,1303500,1303500,1870578.25,1998277.2,2318374.13739,2297580.10017
529,91,283440,1030200,746760,745664.25,759354.0,1628876.55109,1109642.92
3309,192,331980,4648740,4316760,4329547.0,4229272.8,4253908.56714,3567662.88417
6089,204,239340,2567700,2328360,2290386.75,2350225.2,2865459.42889,3073165.14007
4117,218,108840,1974480,1865640,1506624.375,1308823.2,1805255.78033,1026314.05987
9073,37,736020,736020,0,0.0,73290.0,0.0,417009.831648
1256,61,1266180,6225300,4959120,4943990.0,4943690.4,0.0,5182089.40717
3007,130,1458360,3083940,1625580,1641772.625,1614991.2,1872651.62,1871398.35141
4417,0,1514820,1560960,46140,48368.3867188,277692.0,0.0,435021.182237
793,84,545100,3714840,3169740,2805974.75,2480131.2,2551788.25702,2670288.95553
968,118,229500,459900,230400,344048.8125,414972.0,1550919.02594,733959.087012
407,76,367200,7552500,7185300,7240812.0,7170949.2,8377979.32336,9350186.42484
2156,94,188280,534480,346200,319336.90625,367358.4,882457.705444,1355344.97859
7211,213,2640480,3206820,566340,541551.8125,551971.2,1639819.66772,645581.904907
5577,213,1304760,3206820,1902060,1909943.125,1894917.6,1670989.11865,1885427.66316
5654,220,60480,2714040,2653560,2402260.75,2438878.8,2393016.95526,2270794.63743
6239,11,76020,1777560,1701540,1674321.75,1655872.8,2530899.59113,2123013.40777
1448,133,70620,6181200,6110580,5910207.0,6033685.2,4782438.7326,4560795.10577
2075,108,695340,3191940,2496600,2393683.5,2448061.2,3183149.271,2768393.13358
6274,63,4104120,6232860,2128740,2131377.5,2132949.6,448642660.213,2248648.09333
7209,162,3587460,4836120,1248660,1229154.25,1230450.0,1604269.07544,1214445.44232
8885,219,3717540,3797940,80400,47023.7617188,82248.0,136631.57605,186367.691923
944,80,313200,338580,25380,7072.52636719,248676.0,214467.551208,390168.370102
7531,16,117000,117000,0,29854.3339844,19906.8,279267.844177,-112020.544021
221,84,26520,3714840,3688320,4509497.0,2462664.0,4583291.61176,4227874.9632
7103,213,2585880,3206820,620940,633852.625,636748.8,1211898.23737,632743.783747
6631,75,5079180,6135000,1055820,1056803.125,1057023.6,1192809.96729,724128.722264
8970,42,914700,953340,38640,94490.0859375,49292.4,3408450698.5,23402.2870377
4403,215,1457460,1851720,394260,322687.625,361359.6,425062.096497,-203121.666337
87,149,77940,223140,145200,366460.75,241684.8,1729978.86127,1683130.53688
2632,161,16320,1955580,1939260,2012662.75,2132877.6,0.0,1691468.07604
1733,98,1448280,7319880,5871600,5889424.0,5856122.4,6507537.66357,5888175.4458
7847,209,644880,1091400,446520,527143.875,181634.4,638726.989197,908787.457377
2797,171,271260,435600,164340,231158.328125,355150.8,1325568.07129,1415978.78177
4849,103,3973320,4719960,746640,742461.125,653940.0,819113.701721,716622.686381
7861,13,1673760,2525940,852180,829624.0625,853788.0,1336933.0697,822061.295416
6672,31,364500,1374660,1010160,901693.875,836612.4,450507.707703,680508.812647
93,149,83520,223140,139620,46091.1015625,239646.0,1969620.71039,1975722.40051
1173,122,310320,861720,551400,601812.0,572280.0,855782.499268,1318855.46777
3006,130,1458360,3083940,1625580,1612916.625,1611921.6,1531995.78943,1871398.35141
6817,204,913920,2567700,1653780,1620519.25,1630981.2,1438239.84875,1572992.26998
6254,63,4088880,6232860,2143980,2191587.75,2142908.4,600804199.413,2163299.33775
811,106,637560,1023180,385620,372104.6875,391270.8,639526.189636,615147.318197
2378,166,183600,1666080,1482480,1454996.875,1302482.4,1985647.86804,2220889.04646
3957,79,3487500,4151700,664200,636859.9375,819398.4,1788208.37561,1022337.12684
7969,2,2555640,2555640,0,102306.765625,160948.8,26877.4651489,-541039.734007
8253,220,2153340,2714040,560700,578008.875,525006.0,387686.352905,305440.632775
6279,18,22800,1779540,1756740,1786223.0,1641760.8,1182540.94525,1496185.73408
7248,213,2668680,3206820,538140,519353.4375,529452.0,0.0,438836.303815
4092,107,1270620,4991760,3721140,3455140.0,3656487.6,3484839.48486,3494812.45924
2908,142,2353500,7299960,4946460,4909741.5,4938348.0,5325862.63623,5253797.71321
6115,220,493800,2714040,2220240,2205578.0,2187891.6,2587378.86212,2452573.18927
8277,14,1017720,1327560,309840,322474.75,317818.8,817029.517883,291589.526309
1095,127,534540,599940,65400,85275.375,283488.0,111993.863892,222100.15921
1506,105,1314420,1314480,60,0.0,37023.6,355876.682983,145985.436381
6661,46,1783380,2027040,243660,12881.1054688,87724.8,523038.659851,42665.4792039
4878,156,2380080,2639280,259200,164227.015625,204302.4,473067.085144,-13469.685182
7311,24,1485300,1547520,62220,53828.3164062,60021.6,39759.4313965,152582.343028
6195,63,4046940,6232860,2185920,2180245.5,2191350.0,0.0,2164828.94458
2853,158,268740,2044680,1775940,1838539.875,1835793.6,2132887.22485,2483985.55052
1928,63,473940,6232860,5758920,5781549.5,5779987.2,5196785.47754,5790329.49424
933,66,824340,4817700,3993360,3613314.75,3849007.2,4633280.23987,4394451.58146
2174,94,198600,534480,335880,422364.9375,334318.8,1146908.50226,1441626.23117
7925,7,0,40380,40380,792893.1875,548829.6,1532426.92291,667484.958613
7966,209,716220,1091400,375180,351021.25,374280.0,2031463.39313,1783054.58737
7289,15,544080,1822860,1278780,1276824.125,1176612.0,1447083.1828,885193.843232
4113,163,95640,548880,453240,595974.0,511812.0,962582.640137,959642.265946
1089,72,406980,2385960,1978980,2060012.25,2072242.8,3526551.83844,3093963.71353
1880,111,1836060,3974400,2138340,2157290.75,2169286.8,1983293.90735,2186647.6342
395,53,19620,582540,562920,423436.9375,945867.6,1319334.47388,2049211.38708
2042,144,1292040,1807260,515220,512853.09375,486475.2,492743.277771,718750.046797
4973,135,3759180,5649480,1890300,1835504.125,1825825.2,1383069.66925,1713998.05014
1263,122,374700,861720,487020,487741.65625,577994.4,1325883.41711,771501.356128
6221,146,5396340,6670800,1274460,1264464.125,1312177.2,1508217.90308,1291053.73933
6084,204,151980,2567700,2415720,2402062.25,2379321.6,3279649.84167,3107288.21953
3594,199,48000,975720,927720,1493487.75,1658127.6,1756668.12701,2110330.62492
361,142,66300,7299960,7233660,7300013.5,7093534.8,4695924.77606,4249912.58952
6380,141,5365380,7406100,2040720,1905389.0,1951594.8,0.0,1978701.39581
8153,13,1844760,2525940,681180,664462.625,676130.4,0.0,822599.630223
5449,214,267900,341760,73860,183533.515625,239997.6,1355607.07605,775638.797209
5944,76,4999500,7552500,2553000,2544871.0,2549245.2,30441745505.9,2896136.04097
6562,32,117660,1205580,1087920,1043773.75,952411.2,364230.075134,858558.090547
3261,130,1784820,3083940,1299120,1305092.625,1299079.2,0.0,1607041.20883
1602,123,0,3545820,3545820,3648501.25,3513678.0,3064228.82703,2736414.59666
1944,94,40380,534480,494100,346939.4375,688766.4,1721737.91284,1591722.59881
2134,134,654600,3656580,3001980,2962988.0,3006134.4,2291058.12915,1801348.37196
8805,13,2388000,2525940,137940,149300.90625,178903.2,12741132479.0,80717.77866
673,87,567660,1090800,523140,491885.34375,570150.0,986823.378601,777994.972927
5335,63,3208080,6232860,3024780,2990890.5,3079616.4,9002607061.01,2918221.55435
4533,107,1534200,4991760,3457560,3476042.5,3453033.6,2914832.68781,3327187.7098
2781,171,254460,435600,181140,142922.546875,319935.6,1445158.27765,1525791.08811
6730,5,242700,748200,505500,549383.625,532368.0,309686.568665,375847.826473
1463,146,1338000,6670800,5332800,5340274.5,5336503.2,4821721.91034,5186113.07654
821,127,164340,599940,435600,424224.40625,391894.8,276445.537354,801110.460808
8676,37,526560,736020,209460,214995.171875,205046.4,0.0,321182.417658
5000,71,3585720,3996240,410520,374363.09375,408259.2,20448667580.9,300882.359654
6936,204,998580,2567700,1569120,1621756.625,1569705.6,1209896.65204,1511323.03605
8495,40,0,163800,163800,916993.25,216613.2,904346.272095,436217.700837
1920,96,11460,2123400,2111940,2019845.5,1951756.8,1507901.33057,1655518.17114
8866,196,3192900,3281700,88800,92501.921875,87087.6,0.0,-69919.679009
1496,140,1207680,1300140,92460,49682.703125,82803.6,559485.553589,888912.595221
6874,151,3353580,3643800,290220,276728.15625,298498.8,0.0,204531.787281
763,142,436140,7299960,6863820,6998159.5,6775479.6,6322277.96918,6139389.30237
5552,169,664260,2190660,1526400,1449650.0,1523820.0,796923.530212,1314557.31161
5105,103,4113300,4719960,606660,596221.5625,613624.8,3644350528.53,779644.432491
6674,204,678780,2567700,1888920,2475499.75,1983066.0,1785573.07977,2355572.09277
5067,213,852900,3206820,2353920,2330507.75,2350077.6,1011170.76715,2384288.62071
5973,10,263820,979740,715920,717494.375,779282.4,852201.01062,496147.16044
1681,76,1468800,7552500,6083700,6086391.0,6134206.8,6429059.1806,6427364.52261
8746,162,4834680,4836120,1440,35042.625,108276.0,0.0,-279451.820904
4729,213,674940,3206820,2531880,2553045.0,2532658.8,2764621.09216,2530060.82447
862,76,724860,7552500,6827640,6842078.0,6768307.2,6369420.88629,6357448.58614
2688,96,651000,2123400,1472400,1358489.625,1191303.6,532948.658142,1148613.34795
6353,196,1209300,3281700,2072400,2084483.5,2071246.8,1955578.90704,2164233.81854
