,id,elapsed_time,total_time,remaining_time,LM_pred
5523,76,4772400,7552500,2780100,2470826.97076
113,76,56100,7552500,7496400,5678371.06122
5932,204,0,2567700,2567700,2190984.73621
5616,220,20400,2714040,2693640,1588129.4696
4190,203,1248900,1897500,648600,0.0
3116,141,2744100,7406100,4662000,4562888.02979
7743,98,6421080,7319880,898800,1137708.77679
8393,196,2907780,3281700,373920,400993.2724
5314,156,2635680,2639280,3600,686106.194092
6486,63,4244220,6232860,1988640,219171791.613
2305,98,1845180,7319880,5474700,7073640.94147
5305,214,24420,341760,317340,81513.0880127
1924,83,1263420,1818000,554580,390071.523254
7052,151,3467400,3643800,176400,271147.545227
4759,131,3459900,6825900,3366000,3624435.47284
4432,63,2540880,6232860,3691980,0.0
6798,75,5332500,6135000,802500,479632.960022
7568,75,5916660,6135000,218340,376054.62738
5104,103,4112820,4719960,607140,6718268446.24
8017,22,112980,810360,697380,0.0
1184,129,1184400,1188000,3600,0.0
2752,156,619440,2639280,2019840,1996410.94128
5425,63,3401940,6232860,2830920,3616028.6568
5917,220,180060,2714040,2533980,1854966.37256
4167,163,117840,548880,431040,0.0
115,146,70560,6670800,6600240,5387938.68274
8899,58,907560,992100,84540,98414.9945068
1291,66,1261200,4817700,3556500,3116969.93378
7500,13,1308240,2525940,1217700,338437.07312
7932,220,1936440,2714040,777600,857252.530884
3093,130,1540380,3083940,1543560,1088144.13153
7625,63,5218140,6232860,1014720,0.0
1564,110,1391040,5579400,4188360,3830677.84967
1295,66,1269600,4817700,3548100,3265613.98676
3817,182,242580,915060,672480,0.0
4014,203,1147080,1897500,750420,0.0
660,84,464940,3714840,3249900,4289633.36554
6473,218,1974480,1974480,0,0.0
2979,67,2667840,3120480,452640,885407.557434
4356,107,1441800,4991760,3549960,3401248.94891
4442,156,1998000,2639280,641280,1053231.7652
3743,73,847500,1303500,456000,562261.075684
20,67,300,3120480,3120180,0.0
4474,135,3333660,5649480,2315820,2380779.48108
8269,196,2768520,3281700,513180,0.0
4539,151,1342740,3643800,2301060,2640729.77222
1050,118,329820,459900,130080,472211.181152
6299,146,5444400,6670800,1226400,0.0
869,110,727680,5579400,4851720,3466537.26019
2959,114,99480,1201080,1101600,1999979.9566
3069,72,2061960,2385960,324000,1593686.22198
4107,0,1330860,1560960,230100,1304470.77802
7931,15,1100820,1822860,722040,383955.534851
1201,77,73320,3257040,3183720,1290575.65881
313,91,14460,1030200,1015740,2776924.13708
7885,42,113880,953340,839460,1836576.02826
4297,213,284520,3206820,2922300,3619049.94348
3788,130,2147460,3083940,936480,18600744924.6
1250,140,1051320,1300140,248820,448710.21167
8477,139,24600,273900,249300,497682.765015
2193,101,272460,655020,382560,537719.887268
8450,224,335580,648060,312480,0.0
7001,204,1026180,2567700,1541520,1481496.58746
5771,134,3652980,3656580,3600,149002.461853
1651,97,292800,294600,1800,2383159.0509
8458,37,393000,736020,343020,894739.959534
4877,130,3055140,3083940,28800,0.0
5090,19,16740,608940,592200,518031.836487
8426,65,7193040,7544400,351360,172694.465698
2509,153,34080,1618560,1584480,863994.455811
3077,142,2489160,7299960,4810800,4631418.01245
7585,131,5790300,6825900,1035600,1260876.73291
2324,63,737280,6232860,5495580,0.0
3066,141,2591760,7406100,4814340,5176381.11005
696,84,511380,3714840,3203460,3166865.44177
6852,187,1814940,2496960,682020,606338.458557
4234,213,247140,3206820,2959680,3633580.99445
9021,37,715500,736020,20520,0.0
3636,71,2502720,3996240,1493520,1991268.7876
5848,123,3544020,3545820,1800,0.0
6882,5,465900,748200,282300,279930.837952
8667,30,604800,604800,0,0.0
8875,224,586860,648060,61200,0.0
8355,14,1099320,1327560,228240,0.0
2105,77,827040,3257040,2430000,2822346.94763
922,131,35340,6825900,6790560,5063068.3797
3264,107,582180,4991760,4409580,4501664.95923
8554,196,3020100,3281700,261600,0.0
3921,60,3429600,7401300,3971700,4361748.60266
8391,37,348120,736020,387900,2333457.8092
588,106,506220,1023180,516960,3313452518.47
213,146,156420,6670800,6514380,5778487.8277
1998,63,527820,6232860,5705040,5874801.71289
5808,4,118140,1326000,1207860,763514.75238
2189,166,24600,1666080,1641480,1500179.89398
5075,62,3592860,3674460,81600,0.0
3232,192,287700,4648740,4361040,4565598.36139
5735,4,84720,1326000,1241280,266135.892395
3703,203,807900,1897500,1089600,19296725501.4
5459,24,17940,1547520,1529580,2677318.34338
2956,135,2083860,5649480,3565620,4504180.48462
8491,65,7226040,7544400,318360,408522.187988
6277,63,4104360,6232860,2128500,224903364.846
6104,155,2226300,3225180,998880,296521.347046
5899,196,721320,3281700,2560380,5932316495.57
5939,220,194100,2714040,2519940,2354713.59857
2839,203,90780,1897500,1806720,1168415.91479
2517,142,2094360,7299960,5205600,0.0
2485,143,366300,1898460,1532160,1289096.5423
5574,10,40800,979740,938940,1227445.61169
6596,131,4905060,6825900,1920840,0.0
2455,101,599220,655020,55800,0.0
6955,204,1002960,2567700,1564740,1231602.05493
8578,64,6729900,6845160,115260,638834.580383
6346,63,4157520,6232860,2075340,64097929.9284
891,144,174840,1807260,1632420,1668872.17847
8892,13,2436420,2525940,89520,30438356424.6
3772,147,1479360,1479360,0,395848.361084
7968,2,2555580,2555640,60,24126.6790161
2166,112,908100,1303440,395340,643182.392517
3706,203,808200,1897500,1089300,18648700821.3
3254,130,1782480,3083940,1301460,939774.136597
8377,14,1115040,1327560,212520,0.0
3775,188,192360,4327560,4135200,3105177.70923
2131,77,859440,3257040,2397600,2112717.38849
6094,63,3954060,6232860,2278800,2365731.14191
4731,187,62040,2496960,2434920,725140.260559
3707,182,26700,915060,888360,141924.782288
8940,219,3742560,3797940,55380,340883.057922
4119,218,109020,1974480,1865460,1521671.61786
8853,13,2421420,2525940,104520,0.0
5809,4,118200,1326000,1207800,790487.166809
5388,214,234840,341760,106920,715162.875
5986,204,44700,2567700,2523000,3093490.12567
7415,8,0,615060,615060,383066.228943
942,83,258120,1818000,1559880,2538763.10803
1374,103,1002120,4719960,3717840,3412289.11792
1238,131,450480,6825900,6375420,5411302.38208
7031,157,1684200,1993260,309060,0.0
7855,13,1671840,2525940,854100,274711.620667
4212,119,2310780,2742780,432000,354158.124695
6998,222,268800,1113000,844200,0.0
281,51,222000,280800,58800,0.0
3357,130,1855380,3083940,1228560,1330733.3172
295,65,214200,7544400,7330200,8120596.94556
3283,148,1653900,1938900,285000,524497.429199
1102,61,1152480,6225300,5072820,4695208.94989
1192,87,1090800,1090800,0,0.0
1008,66,926460,4817700,3891240,3925511.06866
2866,158,277800,2044680,1766880,1023793.35248
2751,130,1294200,3083940,1789740,790675.598572
3941,155,519000,3225180,2706180,2010344.10748
2188,12,850020,850020,0,194328.874023
7606,188,3386820,4327560,940740,389513.741577
1139,104,266460,935100,668640,6659466.96436
1524,132,157380,1658640,1501260,2398216.36902
8776,64,6833100,6845160,12060,134693.187073
550,120,572400,576000,3600,2610128.72827
5748,213,1405140,3206820,1801680,0.0
829,83,177300,1818000,1640700,2351489.51306
3919,166,1614600,1666080,51480,1330079.32489
5371,214,204420,341760,137340,16554794660.7
2483,70,1690920,3064200,1373280,1107610.34546
5169,98,4208580,7319880,3111300,3302341.08582
4940,2,68340,2555640,2487300,1497904.82733
4945,103,4020060,4719960,699900,555116.39917
6233,220,581580,2714040,2132460,0.0
2472,143,360120,1898460,1538340,1020106.87115
8043,211,34560,87180,52620,590788.583496
5162,217,108180,557700,449520,1735705.97516
5189,20,3600,39660,36060,905823.053345
3979,114,1062600,1201080,138480,667044.740417
6820,5,431580,748200,316620,0.0
5736,4,84720,1326000,1241280,837666.035339
6770,13,722280,2525940,1803660,1881298.88812
6564,61,5686200,6225300,539100,0.0
6943,31,686520,1374660,688140,888889.958374
4847,2,20880,2555640,2534760,1462887.83429
5839,213,1459260,3206820,1747560,2093954.52399
4207,135,3182400,5649480,2467080,2192841.2359
6704,204,698760,2567700,1868940,2163588.4054
790,75,95280,6135000,6039720,4870868.17957
1212,77,83580,3257040,3173460,2137832.5047
6693,204,689100,2567700,1878600,1945213.03571
6516,110,5567400,5579400,12000,0.0
1976,133,557340,6181200,5623860,5894879.48688
8739,162,4831620,4836120,4500,476625.127014
5826,220,147660,2714040,2566380,3169504.25568
2375,156,252600,2639280,2386680,3182132.81927
5378,71,3945600,3996240,50640,2652289941.71
3813,119,2052480,2742780,690300,1413030.71979
8916,219,3731400,3797940,66540,91255.7024536
6533,32,102240,1205580,1103340,878423.720276
5663,193,74340,187200,112860,0.0
1470,138,1379340,1785600,406260,616162.172119
368,124,257400,754200,496800,2676015410.23
6238,63,4076400,6232860,2156460,2894405359.39
4612,142,3876600,7299960,3423360,2826121.19568
3685,203,794160,1897500,1103340,1577751.84155
6926,167,38100,534900,496800,0.0
8908,37,651840,736020,84180,0.0
1357,138,1309620,1785600,475980,914997.061584
8146,13,1843020,2525940,682920,167298.998901
8936,29,51180,57540,6360,0.0
7222,205,116100,460800,344700,0.0
146,76,86400,7552500,7466100,8053928.19983
8499,159,2421180,2480580,59400,0.0
486,141,372000,7406100,7034100,6668074.56183
5959,56,4492800,6361440,1868640,2619288.11963
1190,127,599940,599940,0,0.0
1041,88,422340,555360,133020,845566.898682
3165,98,2701380,7319880,4618500,4982703.31622
198,138,180000,1785600,1605600,2825548.95013
1218,122,347820,861720,513900,325940.307495
1881,98,1555740,7319880,5764140,5976093.12628
2202,101,274740,655020,380280,0.0
4663,215,1729320,1851720,122400,0.0
1820,111,1781880,3974400,2192520,2823403.25427
6826,18,518700,1779540,1260840,1648328.18109
7141,205,77760,460800,383040,0.0
8173,197,621960,626580,4620,780783.064758
4083,131,2935500,6825900,3890400,3425895.38922
5412,177,1488720,1713060,224340,435171.313232
8227,37,118800,736020,617220,1545758.47601
6343,63,4156140,6232860,2076720,126900758.754
5241,103,4186020,4719960,533940,14034960293.6
4934,156,2416920,2639280,222360,519266.656677
9055,76,7548780,7552500,3720,33143779550.0
203,149,177540,223140,45600,0.0
6414,54,1277460,1314000,36540,0.0
3238,184,5760,1800900,1795140,1004166.4209
8492,133,5978040,6181200,203160,78653.3797607
6949,89,1731840,1736340,4500,204647.16925
2789,173,55680,3215700,3160020,2982342.49835
7439,75,5704320,6135000,430680,699518.339844
6161,155,2279160,3225180,946020,1056803.7356
1646,12,338640,850020,511380,658612.032532
309,65,225600,7544400,7318800,7978997.35248
521,150,555180,626340,71160,0.0
1392,110,1267320,5579400,4312080,2571631.36279
1253,131,459180,6825900,6366720,6243539.05231
7962,7,26160,40380,14220,691317.75238
7187,188,2990220,4327560,1337340,1495060.42792
3418,166,1143000,1666080,523080,7297.27026367
451,150,527400,626340,98940,0.0
8950,29,54900,57540,2640,0.0
2770,165,73440,1262880,1189440,2190949323.39
5908,4,170400,1326000,1155600,1368719.99994
2639,107,2940,4991760,4988820,4109633.00311
367,76,284400,7552500,7268100,9342820.84308
3820,151,899220,3643800,2744580,2895035.04053
4351,131,3107760,6825900,3718140,3584366.82013
5731,134,3624600,3656580,31980,95538.9333496
5644,76,4842900,7552500,2709600,3735240.76385
8014,26,1481880,2036760,554880,523756.116516
3503,188,3480,4327560,4324080,2432043.24353
396,141,193140,7406100,7212960,5679810.50806
1585,63,99060,6232860,6133800,3865462.50891
8736,40,148620,163800,15180,518393.655212
8129,196,2600700,3281700,681000,0.0
8559,220,2478060,2714040,235980,992639.675171
983,75,259560,6135000,5875440,5248427.3363
498,60,370140,7401300,7031160,3111752.58612
6935,195,72300,393120,320820,1197969.09259
2246,156,156720,2639280,2482560,3071577.75873
3139,142,2667540,7299960,4632420,4262487.10474
4456,168,59820,438000,378180,1464615.24402
2273,75,1458060,6135000,4676940,3216229.96094
4711,156,2289120,2639280,350160,0.0
1762,1,432720,1447140,1014420,1289581.76788
3371,203,596160,1897500,1301340,812732.230469
7360,167,272100,534900,262800,0.0
9009,63,6206940,6232860,25920,125145573.568
1544,133,119100,6181200,6062100,4398349.57477
6646,10,898920,979740,80820,395046.303528
2674,133,1165500,6181200,5015700,6462195.96564
940,83,255600,1818000,1562400,2228882.33295
7644,186,2694000,3636240,942240,3705266592.04
8935,57,2756640,2756640,0,0.0
1825,98,1503360,7319880,5816520,5621781.19025
3815,116,324900,786600,461700,300146.85968
3201,156,1062600,2639280,1576680,1459933.6062
5430,49,3988800,3991980,3180,0.0
4628,191,2460,1811280,1808820,2568405.88995
7663,183,38040,445560,407520,0.0
5958,63,3701340,6232860,2531520,7697116.59869
6072,13,96960,2525940,2428980,1415569.60315
4724,141,4039200,7406100,3366900,2619657.1803
1710,98,1316580,7319880,6003300,6176861.39941
3260,130,1784820,3083940,1299120,1127176.46509
7549,172,971220,1443960,472740,0.0
175,60,0,7401300,7401300,3067092.30817
331,79,149820,4151700,4001880,5082928.41388
2304,126,202560,496560,294000,627246.749878
3523,71,2421780,3996240,1574460,1663107.82867
8599,212,204240,204240,0,0.0
2717,165,36720,1262880,1226160,608322.580017
7220,61,6225300,6225300,0,1835438542.83
2415,94,504000,534480,30480,984866.872498
6065,204,120480,2567700,2447220,3024681.77643
1987,56,1299600,6361440,5061840,4968400.55103
1420,113,12240,3646740,3634500,4275670.25232
1064,131,314400,6825900,6511500,5015670.03204
4436,0,1521240,1560960,39720,0.0
4653,74,2854140,2979600,125460,3438844.21814
3726,73,820200,1303500,483300,2502151.86676
246,120,226800,576000,349200,955542.16333
4690,158,1846140,2044680,198540,353528.91394
5029,86,3519180,3519180,0,7645697803.58
143,109,96900,274500,177600,104837.061951
1570,1,170880,1447140,1276260,2171123.23767
24,68,50400,262800,212400,1499854.15021
6735,204,735660,2567700,1832040,2182400.16473
8180,224,14640,648060,633420,0.0
500,79,401400,4151700,3750300,2362415.01147
8446,30,463920,604800,140880,848896.989746
6833,2,1706160,2555640,849480,0.0
5862,76,4964220,7552500,2588280,0.0
5680,142,4656420,7299960,2643540,3916348.15259
3171,67,2944320,3120480,176160,0.0
8991,131,6794700,6825900,31200,115574.321777
3782,188,197940,4327560,4129620,2517862.96985
4574,135,3521760,5649480,2127720,2440748.76624
1142,76,1089000,7552500,6463500,6690877.26355
477,91,267420,1030200,762780,1866098.7901
5279,113,3181500,3646740,465240,59848.0975952
7080,48,131040,156420,25380,416313.891113
2891,171,317100,435600,118500,668773.586487
7376,213,2750280,3206820,456540,14698988975.1
2002,102,85440,3198240,3112800,2064154.96063
3202,142,2706540,7299960,4593420,3587893.66547
6920,151,3388680,3643800,255120,1204495.43286
7722,76,6605880,7552500,946620,13241200601.6
2278,83,1508400,1818000,309600,76527.5742798
6384,18,86820,1779540,1692720,1280004.20929
8939,65,7483800,7544400,60600,447069.428162
4883,180,989280,3322080,2332800,1683167.84064
577,106,504000,1023180,519180,1599038.64246
5445,169,601320,2190660,1589340,1477885.45947
5265,125,3969060,3969060,0,0.0
2267,65,2023200,7544400,5521200,5733407.62775
5282,213,968460,3206820,2238360,1931335.21515
555,120,576000,576000,0,2916724.43494
5268,71,3738600,3996240,257640,15059540883.7
4426,96,2081400,2123400,42000,0.0
6850,89,1663680,1736340,72660,1248225.34869
2377,1,876540,1447140,570600,1381275.25903
9010,13,2491860,2525940,34080,0.0
6432,151,2922300,3643800,721500,1006671.04401
898,118,161400,459900,298500,518397.537781
1614,66,1480260,4817700,3337440,4010963.33643
7212,4,1326000,1326000,0,19679.1268921
5997,76,5042220,7552500,2510280,2185379.67828
2053,83,1341780,1818000,476220,608090.237244
7472,75,5740260,6135000,394740,420518.681824
7511,219,2598480,3797940,1199460,1624934.00903
1020,131,171240,6825900,6654660,3938940.26166
1075,106,997200,1023180,25980,160897.680481
1404,130,94740,3083940,2989200,2001711.48767
6183,31,38520,1374660,1336140,1312248.24164
1801,79,1604340,4151700,2547360,6733014776.25
5682,142,4656540,7299960,2643420,12184803220.6
2949,84,2489820,3714840,1225020,1376580.00409
686,80,144900,338580,193680,1634269.92206
531,93,443280,1242300,799020,0.0
1876,63,443160,6232860,5789700,5671276.59503
2092,119,468960,2742780,2273820,1772900.70538
4244,135,3215280,5649480,2434200,0.0
2942,50,4500,35220,30720,42731.7426147
8099,30,111420,604800,493380,1523132.271
6453,155,2475300,3225180,749880,659053.654297
4161,163,116040,548880,432840,357212.348816
8251,13,1929000,2525940,596940,177474.321472
7078,167,124080,534900,410820,339567.353882
4485,199,742740,975720,232980,0.0
3771,203,865260,1897500,1032240,0.0
524,142,279360,7299960,7020600,6375999.42328
2013,102,86640,3198240,3111600,4603021.4906
7960,11,1451340,1777560,326220,401229.085083
9036,42,946680,953340,6660,265313.877869
3322,198,34500,708660,674160,688780.793762
8001,18,1386960,1779540,392580,22473406711.2
5794,169,808260,2190660,1382400,951202.406067
8373,212,49860,204240,154380,0.0
4998,71,3585120,3996240,411120,0.0
7865,13,1674120,2525940,851820,982840.571716
7094,167,129840,534900,405060,0.0
8335,209,1075080,1091400,16320,1249699.96143
6148,26,9840,2036760,2026920,2542322.00128
3559,137,159540,243720,84180,0.0
3334,130,1840140,3083940,1243800,296243.375
3807,98,3258180,7319880,4061700,18993833802.4
8809,160,1422240,1564260,142020,337427.36322
5720,57,168780,2756640,2587860,3015644.81726
4229,107,1355400,4991760,3636360,4351248.69006
2909,67,2612640,3120480,507840,135051.24939
8363,212,42900,204240,161340,0.0
923,76,754920,7552500,6797580,7348467.98364
4411,71,3123960,3996240,872280,0.0
4657,63,2803020,6232860,3429840,2576908.04193
1763,56,1149240,6361440,5212200,4607955.12085
5658,213,1368780,3206820,1838040,1543437.93469
433,87,423000,1090800,667800,1838001.81891
1343,1,14340,1447140,1432800,0.0
3963,203,1121640,1897500,775860,0.0
4890,107,1871880,4991760,3119880,3692898.31805
5295,113,3188460,3646740,458280,722372.814331
5556,98,4590180,7319880,2729700,2448279.63892
5454,169,602880,2190660,1587780,0.0
6490,172,169200,1443960,1274760,716511.019043
4114,96,1897500,2123400,225900,544952.301514
3347,72,2385960,2385960,0,0.0
6310,141,5330820,7406100,2075280,8818228374.1
1577,82,921360,2195880,1274520,722915.666382
6260,26,93660,2036760,1943100,2604371.75439
7509,157,1993260,1993260,0,574442.541321
4299,133,2530500,6181200,3650700,3693479.02246
5119,141,4264200,7406100,3141900,2903097.17572
9078,9,18660,18660,0,2452144.93201
5795,103,4669020,4719960,50940,0.0
5492,19,406860,608940,202080,1555589.84747
4477,199,739020,975720,236700,173437.851074
2777,92,127320,613860,486540,1414847712.11
8310,26,1805160,2036760,231600,778870.246765
1970,133,551760,6181200,5629440,6038725.81238
6729,5,242700,748200,505500,415176.586792
3128,151,295980,3643800,3347820,1448419.04022
7965,6,123120,133560,10440,1711479.39294
5167,157,59160,1993260,1934100,860749.652832
6553,64,5032200,6845160,1812960,1799075.13641
8999,206,1998360,2086740,88380,0.0
1619,145,68580,586680,518100,1361850.73553
3409,137,64320,243720,179400,306245.494995
8867,188,4321560,4327560,6000,0.0
7649,63,5228700,6232860,1004160,317646977.449
1679,110,1466700,5579400,4112700,3893514.92114
1235,117,30180,1144740,1114560,3105021.92999
7623,15,887340,1822860,935520,1166522.44263
2315,83,1527060,1818000,290940,0.0
4899,142,4041360,7299960,3258600,3262614.96094
9022,36,42960,129360,86400,929720.59436
5798,63,3618840,6232860,2614020,0.0
2832,158,260280,2044680,1784400,1648866.22571
3012,67,2683020,3120480,437460,167934.311035
954,144,239400,1807260,1567860,2539655.75238
5814,63,3638520,6232860,2594340,0.0
8613,30,570420,604800,34380,548956.636963
8619,196,3052500,3281700,229200,0.0
8300,14,1067700,1327560,259860,668955.406799
8759,152,3680160,3766500,86340,0.0
7523,176,1206240,1462860,256620,309886.665527
3598,111,3266400,3974400,708000,0.0
2256,108,844140,3191940,2347800,2372327.84747
1143,83,571380,1818000,1246620,1779319.05328
902,144,182040,1807260,1625220,1705432.20856
4027,203,1153500,1897500,744000,865078.982727
3661,61,3322140,6225300,2903160,3327620.8689
2230,108,808500,3191940,2383440,2665565.52869
5446,107,2336520,4991760,2655240,2758555.86005
8661,63,6030540,6232860,202320,97735795.1946
5359,210,94920,1118160,1023240,262864.787598
6297,31,125100,1374660,1249560,1449948.72638
8716,65,7372800,7544400,171600,85674.7922974
3158,173,445680,3215700,2770020,3131039.53986
5236,180,1194840,3322080,2127240,1477697.08148
4737,186,328380,3636240,3307860,3811617.05426
2943,96,828300,2123400,1295100,1328339.99963
5232,20,35160,39660,4500,3333642965.88
5827,220,147660,2714040,2566380,2400475.00781
7019,18,631500,1779540,1148040,1237854.00354
8192,14,852000,1327560,475560,0.0
6066,204,129300,2567700,2438400,3005762.52051
850,103,459540,4719960,4260420,4914533.34845
3197,173,465660,3215700,2750040,2095722.21576
1593,142,1194360,7299960,6105600,4888401.6767
2733,165,44940,1262880,1217940,0.0
7617,15,884820,1822860,938040,79466.005249
4577,213,563280,3206820,2643540,3166824.7594
3540,84,3033540,3714840,681300,180100.85675
1316,60,1118400,7401300,6282900,5370626.71063
4796,142,3985980,7299960,3313980,2676902.34308
905,144,182400,1807260,1624860,1375293.32013
2457,156,423780,2639280,2215500,2825190.21997
6830,204,923040,2567700,1644660,2206931.04431
2495,144,1740300,1807260,66960,0.0
1711,82,1028880,2195880,1167000,1323591.6225
7744,8,361680,615060,253380,0.0
6609,208,73140,1620480,1547340,2560945.06873
8150,13,1843320,2525940,682620,0.0
1526,122,547200,861720,314520,0.0
5422,98,4510980,7319880,2808900,3042171.81641
8725,37,557220,736020,178800,0.0
7043,195,120120,393120,273000,0.0
8863,13,2426460,2525940,99480,0.0
4699,71,3408480,3996240,587760,29349819739.8
6014,13,31680,2525940,2494260,1574245.66168
2629,98,2181180,7319880,5138700,5426992.94354
3621,188,76500,4327560,4251060,1924825.8692
3690,116,117660,786600,668940,1457188.00641
7731,13,1586400,2525940,939540,564718.279663
3893,71,2800980,3996240,1195260,2810381.67059
3391,155,11580,3225180,3213600,1219281.64264
3595,116,47760,786600,738840,704947.991638
25,111,46800,3974400,3927600,2636081.80994
1501,146,1351020,6670800,5319780,4635317.72455
5629,146,4852800,6670800,1818000,18992051472.8
1160,76,1095840,7552500,6456660,7328946.73541
6421,155,2451660,3225180,773520,886711.716431
5395,146,4708680,6670800,1962120,1764120.21521
938,62,13920,3674460,3660540,5791130.79413
3256,161,597300,1955580,1358280,815169.496033
7367,167,276600,534900,258300,404274.087219
5661,57,137760,2756640,2618880,2931549.78998
3167,23,904920,1894920,990000,1978288.33038
3370,173,600060,3215700,2615640,1762561.78992
8577,159,2476980,2480580,3600,0.0
2783,98,2306040,7319880,5013840,4890873.3175
4578,47,0,31200,31200,1443657.11432
3052,201,53040,1645440,1592400,2745003.56177
5457,24,17340,1547520,1530180,2096436.13403
6390,218,1922100,1974480,52380,0.0
1604,104,592500,935100,342600,1904962746.68
7692,220,1788840,2714040,925200,1503686.47571
6174,63,4024620,6232860,2208240,29901808.9086
263,138,251280,1785600,1534320,2174197.43408
5570,142,4575780,7299960,2724180,0.0
111,120,105240,576000,470760,2421850.79889
7514,176,1201740,1462860,261120,11081.9017944
5832,102,3198240,3198240,0,83029.2600098
4336,168,4140,438000,433860,1413724.12036
2869,67,2600340,3120480,520140,30642.2492065
3461,137,78120,243720,165600,460535.095154
641,100,449640,919500,469860,1841701.04584
49,146,3180,6670800,6667620,3588086.7821
6622,13,616920,2525940,1909020,1977066.51752
7554,188,3343200,4327560,984360,170975.78772
5300,134,3203400,3656580,453180,705966.285583
3140,156,1028100,2639280,1611180,1369108.71442
7130,213,2601360,3206820,605460,0.0
8020,63,5483340,6232860,749520,0.0
506,60,373020,7401300,7028280,932100.549988
1100,106,1023180,1023180,0,333935.77771
67,146,39600,6670800,6631200,5003775.78033
7401,27,118260,402780,284520,1142273.27747
8567,139,84360,273900,189540,0.0
5671,193,79800,187200,107400,0.0
1140,104,266520,935100,668580,3426897.66064
2253,77,950700,3257040,2306340,3094766.20477
7980,25,1333860,1951380,617520,0.0
5179,20,0,39660,39660,1413732.21942
6710,174,663360,1300440,637080,603091.536743
2854,108,1373460,3191940,1818480,0.0
7348,178,31740,904200,872460,250100.069946
4898,107,1873200,4991760,3118560,3880616.54138
7152,213,2609340,3206820,597480,867572.604858
4295,63,2468100,6232860,3764760,0.0
6539,61,5671200,6225300,554100,9874050257.94
2823,108,1361340,3191940,1830600,1626870.2287
3237,192,298200,4648740,4350540,4314072.5769
6165,131,4611060,6825900,2214840,2076592.86029
4164,153,1413360,1618560,205200,488930.804626
4666,186,271620,3636240,3364620,3503354.68695
7139,220,1297440,2714040,1416600,1968029.18555
7113,167,134220,534900,400680,52657.3001099
5607,159,0,2480580,2480580,1412390.04126
7823,131,5966700,6825900,859200,1052385.94562
1980,56,1296000,6361440,5065440,4429312.87714
6687,204,681900,2567700,1885800,1846675.04486
387,128,346140,346200,60,0.0
6768,46,1869420,2027040,157620,439095.46637
7169,14,68400,1327560,1259160,2320921755.38
2088,102,121980,3198240,3076260,3383506.78625
7237,14,121680,1327560,1205880,0.0
2824,0,205380,1560960,1355580,2264019.69177
642,124,543720,754200,210480,0.0
1169,105,1083660,1314480,230820,67047.6262207
8447,196,2944080,3281700,337620,1457774.27472
8042,183,285000,445560,160560,0.0
4509,71,3191760,3996240,804480,0.0
8257,3,841980,1055580,213600,0.0
3439,155,26700,3225180,3198480,2562976.27515
5507,24,47940,1547520,1499580,2668394.03406
3037,114,145380,1201080,1055700,2993690.01886
4835,142,4003080,7299960,3296880,12744110749.4
2589,130,1179900,3083940,1904040,552163.717896
70,68,111600,262800,151200,3006635.80835
7908,220,1914420,2714040,799620,241747.603394
6842,5,441540,748200,306660,0.0
1328,72,599160,2385960,1786800,3210674.78693
4862,168,434400,438000,3600,389231.766907
3853,116,358200,786600,428400,682675.039673
3912,71,2821680,3996240,1174560,0.0
2181,94,201000,534480,333480,630205.85321
4483,199,742260,975720,233460,195393.052734
2397,156,281280,2639280,2358000,2027845.4024
7192,219,2383320,3797940,1414620,1991160.77124
3048,192,13980,4648740,4634760,4018688.3797
3449,96,1310940,2123400,812460,815658.618469
2831,63,1229280,6232860,5003580,0.0
8051,211,38340,87180,48840,0.0
2499,102,549840,3198240,2648400,2834740.69604
6107,162,2727960,4836120,2108160,2114764.36829
5517,10,0,979740,979740,2641998.10571
3036,162,116100,4836120,4720020,4677607.58276
5320,63,3184920,6232860,3047940,2273744.66235
6903,18,569340,1779540,1210200,1705595.82111
1161,72,454260,2385960,1931700,15346033220.6
7384,178,61800,904200,842400,0.0
3454,114,563100,1201080,637980,1674211.98029
701,124,603000,754200,151200,905657.398376
4854,110,4233600,5579400,1345800,1452054.02362
456,106,430440,1023180,592740,2319845.11145
3296,92,613680,613860,180,0.0
2731,135,1920540,5649480,3728940,3757359.70563
8769,13,2365560,2525940,160380,1373518.02399
2646,156,533160,2639280,2106120,1630486.5069
8763,25,1951380,1951380,0,1397735.2052
3869,198,541440,708660,167220,0.0
4909,90,89280,1532940,1443660,1359611.33124
5975,10,267000,979740,712740,907854.82373
9030,206,2020140,2086740,66600,321880.346375
157,110,90900,5579400,5488500,4775682.96234
5948,204,12420,2567700,2555280,2162922.29199
7595,27,379140,402780,23640,19271.4415894
1623,110,1425420,5579400,4153980,3031687.81903
202,128,178740,346200,167460,0.0
8347,224,260880,648060,387180,0.0
4467,186,16800,3636240,3619440,1361512.4281
4373,215,1445460,1851720,406260,1167155.76654
144,106,45660,1023180,977520,1826650047.13
94,111,119820,3974400,3854580,4318139.67993
6176,210,889860,1118160,228300,235810.582214
4339,203,1351500,1897500,546000,4039556506.95
5281,214,8460,341760,333300,0.0
3364,130,1866780,3083940,1217160,654298.536682
8617,37,493200,736020,242820,314728.345459
2921,84,2467980,3714840,1246860,2059244.42413
8923,219,3737340,3797940,60600,458788.971375
2805,114,13080,1201080,1188000,2085444.31494
1321,140,1110600,1300140,189540,1099006.04004
7283,204,1187700,2567700,1380000,1058610.37311
8765,13,2362680,2525940,163260,765123.329895
7946,185,441420,441420,0,48740.0666504
1044,131,190980,6825900,6634920,3719471.03699
1340,117,115560,1144740,1029180,3641806.75452
622,88,73800,555360,481560,1963974.08704
6005,13,22260,2525940,2503680,1224468.09357
5962,204,20280,2567700,2547420,2874959.97211
967,144,245400,1807260,1561860,2431999.46454
1165,72,459840,2385960,1926120,943430.090942
6678,57,946740,2756640,1809900,0.0
515,91,278940,1030200,751260,738316.967407
1958,98,1593660,7319880,5726220,4980111.26605
6712,75,5134320,6135000,1000680,1003758.04028
7862,185,397440,441420,43980,103395.742126
7890,28,32400,493260,460860,522484.693542
1419,113,12180,3646740,3634560,3543668.26477
4826,156,2354280,2639280,285000,0.0
2897,161,197520,1955580,1758060,1692578.71057
8971,160,1515960,1564260,48300,0.0
591,127,20520,599940,579420,1102976.46277
679,83,86400,1818000,1731600,1301331.64227
1918,134,507120,3656580,3149460,2885363.8988
5383,196,418560,3281700,2863140,1639674.41571
328,141,124500,7406100,7281600,5123896.92676
5149,131,3666420,6825900,3159480,2739817.22516
8738,220,2575800,2714040,138240,178436.416809
4253,163,185820,548880,363060,749357.99939
544,84,395160,3714840,3319680,4859463.13623
7168,135,5573280,5649480,76200,0.0
6263,63,4095060,6232860,2137800,201767907.999
4944,125,3792060,3969060,177000,15494363366.4
8028,209,748800,1091400,342600,1273009.67358
9061,76,7550700,7552500,1800,92997.5668335
7788,63,5342940,6232860,889920,146790988.292
6894,18,558000,1779540,1221540,1445160.52911
5990,154,86400,115500,29100,1739567.48846
3899,141,3416580,7406100,3989520,3951652.00977
5421,63,3398940,6232860,2833920,3502418.47614
1081,88,555360,555360,0,1366194.97046
606,82,68040,2195880,2127840,2507583.00562
1440,63,0,6232860,6232860,3721314.22516
6970,48,59040,156420,97380,1329194.41895
41,51,0,280800,280800,1165532.78149
2893,130,1381560,3083940,1702380,0.0
3340,23,1027320,1894920,867600,8011813221.47
4269,73,1303500,1303500,0,0.0
5753,89,642900,1736340,1093440,251114.760681
7838,196,2429820,3281700,851880,650263.340393
6455,155,2475600,3225180,749580,780668.295715
3182,192,245160,4648740,4403580,4402573.66327
1061,86,225180,3519180,3294000,3556431.39484
7156,167,156420,534900,378480,0.0
1722,135,1106880,5649480,4542600,1344452.95612
6520,10,813480,979740,166260,192171.140259
4839,169,101400,2190660,2089260,1910423.81848
231,51,166200,280800,114600,564861.751892
8264,13,1962600,2525940,563340,21062562453.5
1594,142,1194360,7299960,6105600,5080411.18018
3028,162,103500,4836120,4732620,4229828.76379
158,79,4500,4151700,4147200,2733264.1441
5503,102,2999400,3198240,198840,0.0
1948,98,1589160,7319880,5730720,5546781.9129
2807,92,160860,613860,453000,2064382758.22
8532,40,27120,163800,136680,905677.969238
1348,67,1292580,3120480,1827900,3919963.12744
3129,130,1694880,3083940,1389060,1739158.31647
2488,98,2098560,7319880,5221320,1738721815.11
7492,189,52260,308460,256200,1279664.06818
739,56,123060,6361440,6238380,4161822.81622
6309,172,54360,1443960,1389600,1749674.34692
8030,220,1994100,2714040,719940,1169983.14551
210,141,26100,7406100,7380000,4712062.82953
3496,86,2319780,3519180,1199400,2464031.29388
1371,112,225420,1303440,1078020,670839.35437
5073,156,2493420,2639280,145860,10359938489.6
8568,40,53580,163800,110220,687866.72522
5592,217,523620,557700,34080,0.0
7715,178,416940,904200,487260,0.0
7745,186,2776200,3636240,860040,0.0
5015,217,33660,557700,524040,1941934.56604
1674,146,1473060,6670800,5197740,5954731.69849
1822,66,1760460,4817700,3057240,3607912.91357
5469,210,283620,1118160,834540,88950.1130981
8817,160,1432380,1564260,131880,204175.818909
8934,196,3223620,3281700,58080,0.0
8488,14,1187520,1327560,140040,283285.898743
255,99,3600,28560,24960,1759019.81049
404,141,194400,7406100,7211700,7927473.06781
4520,213,418380,3206820,2788440,3101305.26678
135,146,86460,6670800,6584340,5008211.67963
1735,79,1559700,4151700,2592000,2881850.59094
8510,57,2513460,2756640,243180,14751392078.6
5292,113,3184260,3646740,462480,667036.681824
7685,15,939540,1822860,883320,0.0
6122,63,3990720,6232860,2242140,0.0
3483,148,1786860,1938900,152040,733870.879211
4391,156,1982100,2639280,657180,1460195.25568
1946,98,1588980,7319880,5730900,5755173.73993
5145,131,3662700,6825900,3163200,3227375.1134
6728,13,683940,2525940,1842000,1996824.54932
7525,64,5788440,6845160,1056720,2151715.96545
3876,203,1059420,1897500,838080,12741627293.2
8609,63,5995740,6232860,237120,292570639.612
7919,170,20580,665160,644580,76924.6160278
7564,27,349020,402780,53760,456846.643921
2325,156,190080,2639280,2449200,3693618.09393
8207,13,1891560,2525940,634380,638852.00354
3194,130,1733160,3083940,1350780,1410195.21301
3412,137,65160,243720,178560,645065.826416
7622,15,886800,1822860,936060,675757.42627
4501,96,2123400,2123400,0,604200.715393
5641,177,1626660,1713060,86400,63656.8116455
6111,220,492060,2714040,2221980,1457967.88354
6821,13,883680,2525940,1642260,1811529.06519
1441,113,28920,3646740,3617820,5384222.60913
1859,138,1782000,1785600,3600,0.0
4268,73,1300800,1303500,2700,0.0
2582,143,430260,1898460,1468200,1113640.67084
450,150,527400,626340,98940,168935.966248
1103,77,0,3257040,3257040,3619244.7403
1873,111,1835220,3974400,2139180,2228399.97015
8220,196,2677320,3281700,604380,0.0
7218,61,6225300,6225300,0,74504.3757935
5077,98,4155300,7319880,3164580,3504514.7193
5549,63,3473340,6232860,2759520,2223560.36346
8966,206,1986480,2086740,100260,30282.6190186
4608,199,957840,975720,17880,0.0
8338,208,1561140,1620480,59340,0.0
3865,98,3307500,7319880,4012380,0.0
1682,98,1270980,7319880,6048900,6468850.84802
5245,20,39660,39660,0,3207092584.14
602,56,35160,6361440,6326280,2109224.34375
7021,213,2529060,3206820,677760,1035346.80164
4784,98,3997380,7319880,3322500,3460490.01672
3767,73,856320,1303500,447180,0.0
4986,213,803040,3206820,2403780,14708432151.5
8405,13,2147160,2525940,378780,0.0
8026,26,1488720,2036760,548040,534652.585266
454,52,382260,608400,226140,0.0
2218,82,1478580,2195880,717300,1247570.48938
1054,72,341160,2385960,2044800,6284097638.16
4837,90,47700,1532940,1485240,1421620.97662
8642,188,4193760,4327560,133800,0.0
5155,19,46080,608940,562860,0.0
6565,46,1724160,2027040,302880,15632846479.1
7290,164,41040,123600,82560,0.0
7711,141,6486000,7406100,920100,1368606.91187
3665,203,783720,1897500,1113780,4949355432.4
8174,197,622020,626580,4560,653659.025208
6119,89,1039080,1736340,697260,1533409.80347
863,131,7620,6825900,6818280,2735519.47559
2261,117,888180,1144740,256560,402919.647095
1628,123,13980,3545820,3531840,2556108.11334
4656,168,313680,438000,124320,891417.296936
55,109,10800,274500,263700,2243476.39471
4554,156,2074200,2639280,565080,293860.207642
5370,146,4673100,6670800,1997700,2255247.96002
771,76,656760,7552500,6895740,6989072.39496
1477,113,45300,3646740,3601440,4190113.15393
1904,115,643260,954000,310740,1616212.22076
8943,13,2459400,2525940,66540,0.0
4887,213,749580,3206820,2457240,2520677.64087
7138,5,622620,748200,125580,3975.56347656
5967,155,1967100,3225180,1258080,1180137.1214
731,53,353040,582540,229500,184264.311279
3112,96,1086600,2123400,1036800,1169787.185
7815,31,1374660,1374660,0,818230.239136
4643,141,3997200,7406100,3408900,3456848.5459
7702,176,1454340,1462860,8520,319164.524597
5367,216,226380,496500,270120,314867.970154
2198,142,1737960,7299960,5562000,6078734.07611
5849,89,697860,1736340,1038480,1404616.24841
2549,83,1814400,1818000,3600,0.0
8061,209,768600,1091400,322800,1213136.46808
6774,191,1651020,1811280,160260,0.0
90,111,115860,3974400,3858540,2730044.22119
1031,86,90660,3519180,3428520,2676585.58569
1277,122,379140,861720,482580,424607.770264
1172,112,80340,1303440,1223100,889377.066467
1617,61,1507920,6225300,4717380,0.0
2014,126,960,496560,495600,1934330.41479
3188,142,2692980,7299960,4606980,4771577.45404
1553,134,101820,3656580,3554760,3945243.07599
836,66,777120,4817700,4040580,0.0
2638,1,1153080,1447140,294060,0.0
1300,132,13440,1658640,1645200,2135936.6759
5758,220,100440,2714040,2613600,2838333.4151
3946,71,2848560,3996240,1147680,1544797.97473
7690,76,6591540,7552500,960960,9755596387.99
1119,112,41880,1303440,1261560,1571025.96509
958,72,161460,2385960,2224500,3251691.5556
7558,75,5913060,6135000,221940,70226.5895386
1092,131,339840,6825900,6486060,3155794.67749
8662,64,6781920,6845160,63240,151777.782654
8306,22,428820,810360,381540,534818.556091
2518,108,1136940,3191940,2055000,1269866.2572
4291,63,2465520,6232860,3767340,3011042.63708
6029,13,43020,2525940,2482920,1555623.59833
1453,60,1204800,7401300,6196500,4903103.81714
3239,130,1779480,3083940,1304460,1671369.28461
8077,211,61800,87180,25380,0.0
5900,196,721320,3281700,2560380,5931839482.16
1458,130,139740,3083940,2944200,2362743.5871
6906,222,217800,1113000,895200,132352.737915
3133,192,219240,4648740,4429500,5203685.4259
6932,4,1177800,1326000,148200,0.0
8375,207,192840,272580,79740,0.0
3916,60,3426000,7401300,3975300,3925885.6178
7665,183,41460,445560,404100,0.0
1832,135,1171800,5649480,4477680,3573968.77802
5926,4,176880,1326000,1149120,111247.55896
303,79,136320,4151700,4015380,5349665.88782
5099,196,109560,3281700,3172140,2115174.19836
2047,133,607800,6181200,5573400,5306963.28296
4640,131,3388500,6825900,3437400,3048157.33319
3205,142,2706720,7299960,4593240,3908087.0788
8915,58,914940,992100,77160,522241.677002
8778,13,2366640,2525940,159300,0.0
5307,196,222360,3281700,3059340,2109459.97687
6781,204,844140,2567700,1723560,1956227.71802
5122,187,267600,2496960,2229360,794692.709534
8008,18,1393140,1779540,386400,1808649.65118
2147,145,577200,586680,9480,0.0
3512,86,2331180,3519180,1188000,1087612.76257
7036,160,41520,1564260,1522740,1031073.47607
1365,132,61020,1658640,1597620,1892267.29761
5843,63,3645540,6232860,2587320,0.0
6382,220,674760,2714040,2039280,2277056.95984
7006,204,1027320,2567700,1540380,1435889.94678
3834,98,3286980,7319880,4032900,4267201.04089
7063,31,747180,1374660,627480,718664.61615
2545,78,1814400,1818900,4500,0.0
4328,203,1347900,1897500,549600,11114439387.6
6986,151,3425820,3643800,217980,0.0
4852,74,2976000,2979600,3600,2537973.55444
6226,162,2835660,4836120,2000460,1685212.34912
2020,83,1325640,1818000,492360,581111.490417
1951,83,1270440,1818000,547560,1399778.21924
164,146,125700,6670800,6545100,5878017.47858
3960,114,1057140,1201080,143940,498851.673828
7572,15,853500,1822860,969360,0.0
8501,40,2880,163800,160920,308782.169922
3308,173,544800,3215700,2670900,2843992.12286
8406,43,4500,4500,0,158032.359497
5591,57,82560,2756640,2674080,2693023.78137
5711,10,133560,979740,846180,1774236.94727
4514,151,1332240,3643800,2311560,1753909.32843
7846,6,51840,133560,81720,1656766.58594
8103,37,32460,736020,703560,1326708.36926
4055,184,673200,1800900,1127700,703036.360046
2424,83,1753200,1818000,64800,0.0
4418,135,3312840,5649480,2336640,2209226.36121
8638,40,89760,163800,74040,917801.952393
7566,167,534900,534900,0,0.0
455,79,382320,4151700,3769380,3299918.40735
4024,135,3073380,5649480,2576100,1063481979.13
3959,123,2161620,3545820,1384200,22473736862.1
6402,18,97740,1779540,1681800,1489659.15625
2795,79,2423700,4151700,1728000,1700434.01691
5781,63,3614940,6232860,2617920,13074590237.8
6255,131,4680300,6825900,2145600,1939657.19574
9013,131,6798300,6825900,27600,0.0
471,79,393600,4151700,3758100,2137739.64728
6051,204,104700,2567700,2463000,3058538.22437
7987,196,2516100,3281700,765600,53443.2480469
5866,169,845820,2190660,1344840,1716168.08917
6952,5,515820,748200,232380,283918.225647
5455,196,463920,3281700,2817780,2767047.68036
630,56,41880,6361440,6319560,4480706.1568
4294,131,3059040,6825900,3766860,3821785.22717
8857,37,632460,736020,103560,0.0
736,118,59760,459900,400140,1899778323.06
5589,217,523200,557700,34500,28030.8494873
3860,98,3297360,7319880,4022520,21007599874.5
6482,196,1284900,3281700,1996800,0.0
3852,184,537960,1800900,1262940,1565631.71014
849,142,502080,7299960,6797880,7659099.06628
807,75,103080,6135000,6031920,5280262.69312
6348,220,665400,2714040,2048640,2132936.92969
884,118,156180,459900,303720,1112906.42926
3520,86,2332980,3519180,1186200,1148110.37415
1927,134,511980,3656580,3144600,2140849.96436
5382,49,3942900,3991980,49080,0.0
2577,158,79320,2044680,1965360,2845710.66724
3689,116,114720,786600,671880,1652613.63477
5154,69,2016300,2073180,56880,195058.617065
6100,155,2221800,3225180,1003380,1156292.88239
3389,71,2339640,3996240,1656600,294135.431091
1567,63,92520,6232860,6140340,5463797.01611
8160,63,5563740,6232860,669120,0.0
6980,31,701400,1374660,673260,0.0
7454,8,24060,615060,591000,0.0
425,142,239340,7299960,7060620,5446659.29529
7093,167,129780,534900,405120,823772.847412
8558,139,82080,273900,191820,0.0
405,79,220080,4151700,3931620,5491954.99475
6905,188,2831160,4327560,1496400,1782627.83807
3151,73,429480,1303500,874020,1433144.11157
4404,215,1457520,1851720,394200,0.0
6578,63,4304040,6232860,1928820,5181357.78595
1048,86,105780,3519180,3413400,2970704.1861
539,76,505080,7552500,7047420,5467952.10364
7922,15,1091820,1822860,731040,75167.6762085
5153,157,39000,1993260,1954260,272238.620056
5954,10,251160,979740,728580,796627.366089
5212,216,0,496500,496500,2082826.45844
2431,108,1098240,3191940,2093700,2099628.25067
8731,162,4829760,4836120,6360,146053.748535
7042,195,117420,393120,275700,0.0
834,121,244440,856140,611700,749328.425537
8157,196,2612220,3281700,669480,0.0
5219,213,939480,3206820,2267340,2857066.85461
1274,108,10020,3191940,3181920,3977413.77539
8526,159,2442780,2480580,37800,0.0
590,56,28800,6361440,6332640,1793013.63025
8115,28,175620,493260,317640,797667.755676
7476,174,1273260,1300440,27180,0.0
6839,213,2422560,3206820,784260,7594697126.55
3785,141,3217500,7406100,4188600,0.0
6601,151,3043920,3643800,599880,308394.45343
1204,117,14280,1144740,1130460,1435280.61713
7995,172,1390920,1443960,53040,100356.975769
3928,114,1029180,1201080,171900,885668.613953
1376,130,81540,3083940,3002400,4570126.1925
118,76,57360,7552500,7495140,4662239.90295
1676,135,926100,5649480,4723380,2888700.56189
8465,188,4085160,4327560,242400,807978.408752
3546,147,1317000,1479360,162360,273168.80542
610,140,430620,1300140,869520,1903234.77045
1622,134,153300,3656580,3503280,2781606.43158
6871,13,908520,2525940,1617420,0.0
7607,98,6321780,7319880,998100,248540.790039
1197,77,66000,3257040,3191040,1397323.16803
6044,204,89340,2567700,2478360,3104359.07599
1497,33,74400,78900,4500,393161.255615
3316,130,1815180,3083940,1268760,1189806.23291
5971,57,290100,2756640,2466540,0.0
7658,220,1745640,2714040,968400,69216.2598267
1581,119,0,2742780,2742780,857474.18811
8720,188,4243560,4327560,84000,128526.247925
3536,165,738960,1262880,523920,0.0
163,111,193800,3974400,3780600,3896666.36725
0,68,0,262800,262800,1018973.15186
8416,14,1153980,1327560,173580,0.0
6999,204,1024560,2567700,1543140,1428054.72668
6213,213,1881720,3206820,1325100,0.0
3850,114,975240,1201080,225840,140033.971497
453,76,468120,7552500,7084380,5962699.19073
4084,116,518400,786600,268200,296889.693481
4508,213,412440,3206820,2794380,3265563.40527
2569,158,78120,2044680,1966560,2113328.42938
8883,221,934800,934800,0,839552.264771
1931,72,1143720,2385960,1242240,1504539.46674
3107,158,572280,2044680,1472400,1719609.80737
1176,105,1096260,1314480,218220,241298.471191
6398,18,94740,1779540,1684800,1131970.31232
2023,86,1041180,3519180,2478000,2277658.36707
3019,158,368880,2044680,1675800,1790677.06329
6870,13,908400,2525940,1617540,750497.754517
702,124,603000,754200,151200,1061491.82208
5213,196,173160,3281700,3108540,2332136.84399
8954,22,810360,810360,0,2982435.2923
8332,152,3416340,3766500,350160,0.0
5303,134,3206400,3656580,450180,588541.175171
7193,15,486900,1822860,1335960,0.0
6103,204,282360,2567700,2285340,3081022.24249
3975,60,3462900,7401300,3938400,4609172.51514
6196,76,5356800,7552500,2195700,0.0
1384,33,6240,78900,72660,797006.105225
7522,167,395340,534900,139560,0.0
1379,49,536400,3991980,3455580,3961462.65698
796,144,99240,1807260,1708020,2073910.73218
1395,133,19920,6181200,6161280,3948359.99884
7689,186,2747400,3636240,888840,27174621141.9
9075,21,470460,470460,0,0.0
1736,79,1559700,4151700,2592000,2823450.38696
7826,131,5968500,6825900,857400,1492596.76654
1680,146,1482000,6670800,5188800,5866494.91046
6517,26,261840,2036760,1774920,0.0
6257,151,2820180,3643800,823620,0.0
6834,2,1706220,2555640,849420,0.0
6890,151,3367320,3643800,276480,0.0
4440,168,54060,438000,383940,986830.156433
5301,134,3203400,3656580,453180,225197.200989
1135,76,1087200,7552500,6465300,6968846.42358
3050,192,14400,4648740,4634340,4075123.74268
1518,132,154500,1658640,1504140,1626977.2179
1462,148,0,1938900,1938900,1890546.44879
8225,14,899400,1327560,428160,0.0
7874,179,188760,345960,157200,197938.422485
1285,108,14220,3191940,3177720,3332817.07166
5114,187,265440,2496960,2231520,1273413.8819
3034,173,210900,3215700,3004800,2895639.13513
7923,209,686040,1091400,405360,1696338.48407
5339,152,812460,3766500,2954040,2295593.10553
1111,87,1034460,1090800,56340,261014.318115
8415,220,2388840,2714040,325200,497489.282043
3277,135,2442000,5649480,3207480,2888255.88147
1845,115,590580,954000,363420,890545.271057
5510,142,4538760,7299960,2761200,0.0
7854,42,103680,953340,849660,1676008.13055
3837,203,1031820,1897500,865680,152873.420898
5396,98,4500180,7319880,2819700,2907363.91119
4654,142,3894960,7299960,3405000,4821093.77197
5201,177,1215600,1713060,497460,587256.143982
4134,23,1677660,1894920,217260,253755.677185
4745,156,2315760,2639280,323520,0.0
685,83,90000,1818000,1728000,3191785.7829
7589,25,1073940,1951380,877440,420676.179199
6714,146,5716800,6670800,954000,1325555.7558
5190,98,4212180,7319880,3107700,2961096.65717
8743,160,1388280,1564260,175980,309734.379456
3668,147,1398720,1479360,80640,0.0
5789,134,3656580,3656580,0,662098.701538
3159,156,1039140,2639280,1600140,1945646.98553
6278,31,110040,1374660,1264620,1624335.47479
2040,72,1213740,2385960,1172220,1107005.9248
8697,131,6647340,6825900,178560,6508517738.35
7308,167,242640,534900,292260,0.0
3891,116,384420,786600,402180,792846.844055
1335,76,1244280,7552500,6308220,6689237.47467
434,87,424200,1090800,666600,1748097.23761
1407,77,210840,3257040,3046200,3743377.15198
232,51,168420,280800,112380,323456.75061
640,75,0,6135000,6135000,2673050.17749
4001,71,2876400,3996240,1119840,861999.05896
5991,76,5036400,7552500,2516100,2505635.87335
517,111,575520,3974400,3398880,3705282.95276
2793,79,2419200,4151700,1732500,0.0
5639,146,4856400,6670800,1814400,2139269.1181
2364,156,245340,2639280,2393940,2778692.00092
4893,2,48960,2555640,2506680,1234617.46472
1977,86,1003860,3519180,2515320,2337670.53503
7051,213,2553180,3206820,653640,0.0
8408,133,5922900,6181200,258300,0.0
632,150,621180,626340,5160,0.0
8525,192,4590840,4648740,57900,422427.010132
6570,208,42840,1620480,1577640,2630521.44525
2478,142,2076360,7299960,5223600,0.0
1452,79,1234800,4151700,2916900,2875027.62372
3004,108,1463940,3191940,1728000,1632242.3725
6392,31,176520,1374660,1198140,1433841.50092
4305,219,42960,3797940,3754980,1933433.0072
3476,203,643320,1897500,1254180,828595.879028
4921,90,93420,1532940,1439520,1977581.19897
8598,42,706800,953340,246540,0.0
3292,192,318240,4648740,4330500,3344550.25085
8063,26,1510860,2036760,525900,318888.534058
4168,107,1303020,4991760,3688740,3732135.54388
3801,151,868740,3643800,2775060,2659049.32178
7445,197,20400,626580,606180,1809264.78888
7216,3,22740,1055580,1032840,1098707.20258
5284,113,3181860,3646740,464880,409704.283997
4686,151,1539300,3643800,2104500,1712673.75287
8356,30,398400,604800,206400,646289.568237
4797,186,358800,3636240,3277440,3984520.06067
3989,141,3475200,7406100,3930900,3901536.26477
2625,123,961380,3545820,2584440,2539334.91736
8762,219,3644940,3797940,153000,0.0
7331,133,4949520,6181200,1231680,1204651.09949
4108,0,1330860,1560960,230100,1045335.85327
5255,63,3141300,6232860,3091560,3523076.63525
1745,63,355200,6232860,5877660,5893007.68591
6561,64,5036700,6845160,1808460,1467745.6615
5582,177,1587900,1713060,125160,0.0
5924,196,728100,3281700,2553600,2982178.5777
3083,141,2602260,7406100,4803840,4414471.58179
2678,156,560220,2639280,2079060,1784927.77698
4408,141,3732240,7406100,3673860,4190639.44482
7455,220,1479240,2714040,1234800,1090619.87457
7241,3,44100,1055580,1011480,1150973.36957
2901,141,2455620,7406100,4950480,4535871.63715
2928,156,733620,2639280,1905660,2704507.1972
2159,77,868440,3257040,2388600,1890914.28888
3659,199,99000,975720,876720,1769433.3988
8633,42,725340,953340,228000,0.0
8376,37,333540,736020,402480,2109035.80499
5623,213,1337040,3206820,1869780,2587299.64227
4292,219,33840,3797940,3764100,2393832.14172
2672,215,23100,1851720,1828620,289987.273499
2316,156,188640,2639280,2450640,2543086.85223
1074,88,551760,555360,3600,1409149.85126
7937,30,0,604800,604800,1064707.36304
3628,66,3282600,4817700,1535100,1580891.74896
2684,123,1005900,3545820,2539920,2231998.86456
3170,67,2944140,3120480,176340,0.0
3450,203,626880,1897500,1270620,1705757.12817
5796,19,583800,608940,25140,0.0
6619,191,1543320,1811280,267960,0.0
5270,131,3740100,6825900,3085800,2800196.40472
9044,63,6232140,6232860,720,62523362.0791
4079,107,1268160,4991760,3723600,3995947.91418
6236,31,81180,1374660,1293480,922441.626709
5844,131,4236900,6825900,2589000,3194776.73315
7129,48,153840,156420,2580,880507.113281
3562,116,31800,786600,754800,1047799.42633
4112,0,1332840,1560960,228120,910448.137146
5904,63,3671640,6232860,2561220,153702191.189
1912,77,707340,3257040,2549700,2885898.90485
2072,63,558540,6232860,5674320,5494486.81525
2409,94,500400,534480,34080,847246.775513
6137,220,507900,2714040,2206140,2073236.66656
217,146,157440,6670800,6513360,7219842.58691
261,141,85500,7406100,7320600,4310945.0849
371,76,284460,7552500,7268040,8315822.58691
4478,135,3341700,5649480,2307780,2297998.664
5161,217,108120,557700,449580,1406969.54077
1704,119,100620,2742780,2642160,3128692.63641
3506,184,179400,1800900,1621500,1399996.03247
8473,133,5973540,6181200,207660,304324.026917
1388,77,200220,3257040,3056820,4198297.13086
8862,204,2459940,2567700,107760,0.0
2165,94,195060,534480,339420,721292.210205
4885,161,1870080,1955580,85500,859288.335022
6383,151,2896920,3643800,746880,670800.955139
7611,27,387000,402780,15780,0.0
4723,131,3432300,6825900,3393600,3173708.80731
3385,114,539760,1201080,661320,1130388.14471
2350,66,2159340,4817700,2658360,2575187.21332
7762,58,68280,992100,923820,0.0
4892,169,137100,2190660,2053560,1992613.53632
1584,134,136260,3656580,3520320,2063332.53992
183,100,0,919500,919500,1954976.67822
5054,146,4359360,6670800,2311440,16608382947.1
3755,203,861900,1897500,1035600,209286.163879
322,76,232080,7552500,7320420,6785062.0827
4927,202,166740,166740,0,0.0
7204,61,6220800,6225300,4500,1836448239.14
513,91,278880,1030200,751320,1061117.16913
812,76,679260,7552500,6873240,7509515.56781
994,87,799140,1090800,291660,746681.834045
8522,30,513900,604800,90900,0.0
2652,69,18660,2073180,2054520,2584541.05402
3582,203,720900,1897500,1176600,1064038210.03
3674,203,791100,1897500,1106400,627792835.546
7909,28,39300,493260,453960,457591.043396
8333,3,1006920,1055580,48660,0.0
3262,142,2750100,7299960,4549860,0.0
6982,31,701580,1374660,673080,230499.342407
1124,86,273960,3519180,3245220,2597190.26501
5227,54,220080,1314000,1093920,682792.287231
7650,189,259860,308460,48600,1263347.1955
4530,201,1293240,1645440,352200,0.0
7307,164,49500,123600,74100,0.0
1689,110,1493640,5579400,4085760,3604472.20306
4217,135,3186900,5649480,2462580,2429263.5415
196,120,179940,576000,396060,2011815.16052
6908,204,970140,2567700,1597560,1000707.40857
6791,191,1780920,1811280,30360,235237.105652
4047,213,133020,3206820,3073800,4501518.31799
8723,188,4244760,4327560,82800,0.0
2493,135,1770300,5649480,3879180,4175109.3736
1767,138,1724220,1785600,61380,0.0
1580,79,1321500,4151700,2830200,0.0
6773,46,1871400,2027040,155640,0.0
4489,23,1891320,1894920,3600,0.0
549,83,0,1818000,1818000,3892009.7475
1207,12,46500,850020,803520,511013.856689
1905,115,643260,954000,310740,1592144.78986
330,141,124620,7406100,7281480,5741724.55811
6470,54,1314000,1314000,0,183051.885071
4077,213,158040,3206820,3048780,3910494.83417
3971,166,1650300,1666080,15780,190343.091614
1027,83,375600,1818000,1442400,1498315.81671
8311,26,1805160,2036760,231600,367573.394287
1655,142,1226760,7299960,6073200,7142481.31464
3386,203,603960,1897500,1293540,1354236.02881
3030,107,268200,4991760,4723560,6186871.69061
4929,98,4074480,7319880,3245400,3240449.37152
4764,168,383280,438000,54720,99850.855835
920,72,108360,2385960,2277600,2509820.81012
8639,160,1328700,1564260,235560,0.0
8855,57,2720700,2756640,35940,2602943010.21
6479,75,4967160,6135000,1167840,2158333.55017
3617,66,3261600,4817700,1556100,2022758.26019
6261,63,4093140,6232860,2139720,401359403.502
5344,142,4303980,7299960,2995980,4145343.35846
5299,210,25680,1118160,1092480,952332.144226
2215,143,31800,1898460,1866660,1536642.36627
8442,14,1163520,1327560,164040,540403.843689
1402,130,92820,3083940,2991120,3138111.31396
4904,196,0,3281700,3281700,1094996.30878
5648,89,592980,1736340,1143360,1274158.45923
8139,197,608220,626580,18360,880772.35022
5513,152,1050660,3766500,2715840,2917557.0639
4871,215,1851720,1851720,0,0.0
5697,196,627300,3281700,2654400,1851723.33911
4468,186,16860,3636240,3619380,2015171.54376
1638,79,1351860,4151700,2799840,0.0
5922,4,172560,1326000,1153440,1757503.28485
8924,206,1962660,2086740,124080,1141344.07147
2004,86,1035180,3519180,2484000,1158230.22845
894,110,739320,5579400,4840080,3656065.78662
5819,17,17400,626460,609060,1651973.27405
6633,32,166920,1205580,1038660,421900.066162
2852,158,268080,2044680,1776600,2468223.71985
715,118,53820,459900,406080,4463088.86676
6967,157,1654500,1993260,338760,498801.578796
3510,184,180000,1800900,1620900,1428801.46442
5296,134,3198420,3656580,458160,753860.968567
5806,76,4930020,7552500,2622480,0.0
5375,49,3938400,3991980,53580,1486164.16205
58,150,59400,626340,566940,2284017.75287
5726,103,4636200,4719960,83760,0.0
1600,82,927000,2195880,1268880,1822091.31555
6583,188,2485560,4327560,1842000,1461494.4472
1130,76,1083000,7552500,6469500,305824774.678
3452,23,1083900,1894920,811020,781863.520081
6417,210,1053720,1118160,64440,196568.230774
6053,76,5097600,7552500,2454900,9463885942.33
5237,125,3957960,3969060,11100,0.0
6866,188,2802660,4327560,1524900,2410436.91431
6804,213,2405700,3206820,801120,0.0
8952,219,3746340,3797940,51600,0.0
5625,159,26160,2480580,2454420,1717052.71631
5183,135,3877200,5649480,1772280,1652566.57013
1158,104,273180,935100,661920,5919173.50604
7647,183,23040,445560,422520,37867.1849365
533,141,391320,7406100,7014780,6764989.86255
6125,196,1043700,3281700,2238000,2498017.34259
535,103,244620,4719960,4475340,1956324.89386
1818,63,389100,6232860,5843760,5198839.17755
2698,98,2244780,7319880,5075100,4046115.28204
7950,220,1940940,2714040,773100,1047936.05646
7171,162,3561300,4836120,1274820,569590924.694
4646,156,2251860,2639280,387420,680109.589417
4109,143,1732320,1898460,166140,1503606.28094
5018,86,3515580,3519180,3600,22204211458.2
1746,63,355260,6232860,5877600,6347162.66675
3900,141,3416880,7406100,3989220,4069882.96948
7380,213,2750700,3206820,456120,2647019767.35
8912,152,3766500,3766500,0,0.0
6357,25,33420,1951380,1917960,3346519.6463
7631,222,790200,1113000,322800,0.0
7569,205,460800,460800,0,0.0
1897,101,81660,655020,573360,1089618.05499
3571,203,715440,1897500,1182060,993479.431213
2206,117,825360,1144740,319380,56943.7307129
6457,110,5528100,5579400,51300,5351713101.41
212,128,191460,346200,154740,376128.36908
3068,201,78240,1645440,1567200,2301311.99023
7699,15,954780,1822860,868080,2108339.03827
2447,101,597420,655020,57600,0.0
4713,213,651600,3206820,2555220,2848492.21039
170,146,126900,6670800,6543900,6114166.16211
3671,79,3155700,4151700,996000,3056107.35413
9040,13,2514720,2525940,11220,134508.63446
2877,96,791400,2123400,1332000,2062646.19897
2516,153,38100,1618560,1580460,3170032.74994
5256,113,3169560,3646740,477180,1247115.94775
7920,170,20700,665160,644460,0.0
675,93,546600,1242300,695700,974889.058044
5506,57,27660,2756640,2728980,3189550.39362
8054,178,621600,904200,282600,581375.710999
2227,63,664260,6232860,5568600,0.0
6232,220,581520,2714040,2132520,0.0
532,88,16200,555360,539160,2154423.35327
7425,178,78000,904200,826200,204260.470703
4424,141,3736740,7406100,3669360,3335963.22809
240,111,242280,3974400,3732120,4617988.84595
7814,219,2937420,3797940,860520,1204109.55359
7913,179,203880,345960,142080,2102899656.0
5938,218,1437420,1974480,537060,0.0
4804,90,31200,1532940,1501740,1387501.68079
3508,199,0,975720,975720,2954282.36487
5003,69,1933860,2073180,139320,0.0
3011,67,2682960,3120480,437520,845801.343994
8794,196,3139740,3281700,141960,0.0
7426,174,1226340,1300440,74100,0.0
5942,76,4998960,7552500,2553540,23003079067.5
4715,69,1774860,2073180,298320,0.0
6198,210,911760,1118160,206400,0.0
2296,126,197460,496560,299100,1342197.03827
4470,133,2614980,6181200,3566220,4118212.87866
229,146,161940,6670800,6508860,8452177.38635
8047,178,618900,904200,285300,1089596.70166
2845,215,160800,1851720,1690920,34478.8040771
2084,61,1958760,6225300,4266540,0.0
8615,63,6001140,6232860,231720,195131430.883
2960,108,1442940,3191940,1749000,1974293.86621
4916,125,3778560,3969060,190500,370192.401062
1878,115,630000,954000,324000,1140266.28558
6201,76,5360400,7552500,2192100,8594251234.71
1461,1,87780,1447140,1359360,1056865.45984
6379,151,2895660,3643800,748140,234899.861816
2815,123,1119180,3545820,2426640,3008447.06061
5046,71,3624300,3996240,371940,8075285506.82
2298,83,1519200,1818000,298800,0.0
1073,118,456300,459900,3600,194763.932007
4914,142,4047060,7299960,3252900,3555550.63763
8163,13,1849260,2525940,676680,1861935.37103
6579,131,4895460,6825900,1930440,1126646.09369
1670,1,220020,1447140,1227120,1788580.35315
5700,4,74760,1326000,1251240,63971.3526001
5916,57,256680,2756640,2499960,0.0
6718,10,945720,979740,34020,545778.353088
4758,86,3373140,3519180,146040,299987.545471
6685,61,5759700,6225300,465600,283848.906799
2599,103,2106060,4719960,2613900,2174818.55066
6754,32,260760,1205580,944820,346835.012329
4743,142,3955680,7299960,3344280,2927305.8175
5500,142,4535160,7299960,2764800,0.0
6408,31,187680,1374660,1186980,1038079.39484
5752,220,99660,2714040,2614380,2211508.02423
7488,15,693240,1822860,1129620,828737.474365
1241,131,450900,6825900,6375000,5713611.39117
5535,10,20460,979740,959280,1719299.6557
8215,11,1616040,1777560,161520,0.0
7888,22,31500,810360,778860,1487519.73566
993,66,895860,4817700,3921840,2966142.89478
6790,191,1777320,1811280,33960,0.0
2656,63,1084020,6232860,5148840,0.0
8842,76,7430400,7552500,122100,0.0
388,128,346200,346200,0,0.0
5981,13,9960,2525940,2515980,1761569.56531
6924,18,595140,1779540,1184400,1010771.4646
6900,167,11040,534900,523860,1626831.21881
6494,155,2506200,3225180,718980,871847.797668
3778,98,3128580,7319880,4191300,4885336.20227
292,91,0,1030200,1030200,2556202.96033
6306,31,134820,1374660,1239840,1064707.60706
1386,77,200040,3257040,3057000,4695316.41656
8086,76,6829200,7552500,723300,2819165108.78
3344,67,3069900,3120480,50580,0.0
8403,28,493260,493260,0,779950.481445
1784,98,1481040,7319880,5838840,6009269.12042
3918,114,1024680,1201080,176400,812626.325989
5100,157,24240,1993260,1969020,1940001.51715
924,105,729720,1314480,584760,2388500.76569
3563,147,1326660,1479360,152700,0.0
4472,156,2008320,2639280,630960,1172565.72278
5740,57,171780,2756640,2584860,3085499.6756
3732,203,833100,1897500,1064400,0.0
6974,222,258540,1113000,854460,0.0
205,68,219000,262800,43800,2482268.03705
760,124,625800,754200,128400,70119.8026123
997,76,835620,7552500,6716880,6827369.99066
6035,220,266400,2714040,2447640,2596847.07257
2119,66,1965600,4817700,2852100,3305912.80585
5988,220,233520,2714040,2480520,2999696.16437
2836,215,155760,1851720,1695960,784467.7677
2574,156,500880,2639280,2138400,1219154.20593
2416,66,2312100,4817700,2505600,2560419.54089
8880,196,3197760,3281700,83940,0.0
1226,12,57000,850020,793020,427769.313171
6680,18,281460,1779540,1498080,401141.523438
569,135,9000,5649480,5640480,2872247.64099
6456,31,223620,1374660,1151040,1272454.88
2975,108,1450140,3191940,1741800,1654845.61438
5086,156,2501580,2639280,137700,10360508587.4
5076,180,1104000,3322080,2218080,2302211.18591
247,65,172800,7544400,7371600,5171173.8703
7451,188,3148980,4327560,1178580,1409523.20959
5072,98,4152480,7319880,3167400,3526108.52521
2644,135,1856940,5649480,3792540,5905363.30377
7202,213,2639580,3206820,567240,82830.0387573
4917,130,3083940,3083940,0,0.0
5788,63,3618540,6232860,2614320,5860670211.5
7033,167,82680,534900,452220,5684.95849609
406,53,24120,582540,558420,3165522.89484
6193,63,4046940,6232860,2185920,0.0
4864,215,1848120,1851720,3600,0.0
7997,7,40380,40380,0,1545068.23285
4972,90,118500,1532940,1414440,0.0
1983,72,1172760,2385960,1213200,1950845.84924
2753,98,2278740,7319880,5041140,2717257170.66
5810,89,670920,1736340,1065420,1549356.67889
3390,114,542220,1201080,658860,0.0
5470,196,471300,3281700,2810400,2559831.43048
3948,116,433800,786600,352800,0.0
2660,133,1146540,6181200,5034660,6335867.56342
3075,151,124380,3643800,3519420,2358103.5448
929,144,192240,1807260,1615020,2664271.72321
5332,146,4532220,6670800,2138580,2605687.38757
96,149,88140,223140,135000,2137552.62634
8976,160,1521060,1564260,43200,6816480044.82
194,100,4560,919500,914940,2658276.3988
8636,64,6760380,6845160,84780,378710.47644
4502,153,1618560,1618560,0,657918.136047
1055,131,278700,6825900,6547200,4470208.98755
8359,30,398460,604800,206340,761036.142639
2825,69,163680,2073180,1909500,843593.268982
3313,114,477660,1201080,723420,384725.881897
7869,15,1063020,1822860,759840,291076.929443
7636,219,2794680,3797940,1003260,1192268.96735
1373,146,1275360,6670800,5395440,4800835.41321
6554,208,28440,1620480,1592040,788597.276611
8151,224,0,648060,648060,704421.198486
4102,131,2940720,6825900,3885180,2961032.08948
981,105,798720,1314480,515760,860125.791077
5208,146,4445820,6670800,2224980,1395930.6123
4589,182,849660,915060,65400,0.0
3955,123,2160420,3545820,1385400,509712.60321
8873,29,21360,57540,36180,0.0
1065,112,0,1303440,1303440,3615545.39111
3427,137,69180,243720,174540,30727.3756714
8072,222,1081800,1113000,31200,0.0
5524,76,4776000,7552500,2776500,2676653.94696
3704,148,1938900,1938900,0,0.0
5476,213,1243500,3206820,1963320,2893833.60803
4762,215,1794600,1851720,57120,0.0
4906,142,4042980,7299960,3256980,0.0
4832,156,2357460,2639280,281820,1170801.95648
5956,204,18780,2567700,2548920,2931795.83582
8783,37,575280,736020,160740,0.0
7770,58,80100,992100,912000,0.0
7646,63,5228340,6232860,1004520,635979129.388
177,141,6000,7406100,7400100,3138521.78363
2125,63,614160,6232860,5618700,5721758.92938
1966,111,1882560,3974400,2091840,2655008.78259
6247,11,80820,1777560,1696740,1824188.06854
7037,195,115200,393120,277920,0.0
1349,67,1292820,3120480,1827660,4234239.60358
1583,135,875220,5649480,4774260,1148844.71222
4845,156,2368920,2639280,270360,1522613.36798
178,120,171600,576000,404400,1715213.70837
4017,184,646800,1800900,1154100,1359676.16125
1942,96,18060,2123400,2105340,1463037.08099
2966,173,169020,3215700,3046680,2583151.92487
4829,169,91860,2190660,2098800,1788950.44214
5567,214,337260,341760,4500,0.0
392,53,17100,582540,565440,881001.203125
7493,220,1529640,2714040,1184400,247455.859741
762,76,652800,7552500,6899700,6722325.62549
4133,198,708660,708660,0,0.0
2150,96,163800,2123400,1959600,636884.291992
2452,94,534480,534480,0,400599.71344
7203,61,6220800,6225300,4500,1835576083.75
2748,73,11100,1303500,1292400,2046299.20966
3111,130,1671660,3083940,1412280,0.0
2724,200,29040,59160,30120,785026.895691
7754,31,1319580,1374660,55080,0.0
4091,151,1074960,3643800,2568840,2525575.02039
5429,49,3987540,3991980,4440,495543418.913
2995,67,2672700,3120480,447780,307646.721802
6463,188,2399160,4327560,1928400,2093179.32593
9016,131,6799200,6825900,26700,0.0
5221,156,2579700,2639280,59580,130843.545044
6492,63,4244820,6232860,1988040,110374654.186
1071,78,518400,1818900,1300500,75258.5491943
4939,146,4290300,6670800,2380500,3318858.61395
7939,63,5429340,6232860,803520,0.0
2668,69,31860,2073180,2041320,1807212.30139
7357,5,744600,748200,3600,0.0
7499,27,198720,402780,204060,0.0
7971,196,2506260,3281700,775440,762334.277344
43,51,3000,280800,277800,654833.853699
953,66,863940,4817700,3953760,4177274.52795
2868,173,108360,3215700,3107340,3511575.6087
5355,142,4322340,7299960,2977620,3796840.81873
2902,173,117600,3215700,3098100,4026127.4408
808,83,158400,1818000,1659600,2544211.84918
960,131,84780,6825900,6741120,4730620.32458
3930,218,0,1974480,1974480,1599313.6322
6210,176,225180,1462860,1237680,904262.426697
3986,130,2403540,3083940,680400,0.0
2875,171,312600,435600,123000,415530.334229
6595,75,5053560,6135000,1081440,1129304.53931
1029,83,376200,1818000,1441800,1530301.57953
6042,210,633600,1118160,484560,917158.388306
1234,117,30120,1144740,1114620,3024024.17596
7751,219,2882340,3797940,915600,140275.950989
1243,138,1225200,1785600,560400,15061500665.6
2285,134,757920,3656580,2898660,2135358.16486
1964,113,511860,3646740,3134880,3462316667.89
7930,15,1100820,1822860,722040,0.0
895,106,699840,1023180,323340,109451.453308
8586,159,2480580,2480580,0,0.0
2360,135,1568220,5649480,4081260,4095081.3653
6092,220,453060,2714040,2260980,2975862.08795
6575,26,303720,2036760,1733040,1330635.89948
1377,133,14400,6181200,6166800,2380028.13019
5084,71,3636600,3996240,359640,0.0
4828,2,2880,2555640,2552760,1913426.95447
2008,126,0,496560,496560,1275784.85504
6049,63,3776400,6232860,2456460,0.0
6268,172,24480,1443960,1419480,1168127.2926
1429,121,825900,856140,30240,0.0
6034,57,342720,2756640,2413920,0.0
651,84,459780,3714840,3255060,3203814.85248
3402,137,61080,243720,182640,287831.223206
8419,37,373980,736020,362040,851800.252441
916,142,532380,7299960,6767580,6475145.26788
2818,63,1222740,6232860,5010120,0.0
6530,10,823920,979740,155820,0.0
2821,0,204840,1560960,1356120,2832154.01184
3267,162,420660,4836120,4415460,3733056.99255
5610,193,23400,187200,163800,0.0
5564,113,3509460,3646740,137280,567871.742859
290,120,264900,576000,311100,679954.052795
5170,125,3920160,3969060,48900,575958.062012
2494,156,445980,2639280,2193300,2379256.8183
5117,156,2518320,2639280,120960,14361992789.9
8449,224,335580,648060,312480,0.0
2736,110,2461080,5579400,3118320,3021398.04877
6860,61,6018060,6225300,207240,842226.300842
999,86,37680,3519180,3481500,2922522.92853
574,127,16440,599940,583500,1729430.8645
105,76,46200,7552500,7506300,5529811.54926
467,103,217500,4719960,4502460,2171006.60248
377,79,201660,4151700,3950040,5059326.19922
859,84,606420,3714840,3108420,2846095.26874
5979,63,3716160,6232860,2516700,27775500.1105
2223,112,932760,1303440,370680,333777.897888
492,141,374400,7406100,7031700,6451231.85217
5483,102,2989980,3198240,208260,867868.358276
1273,117,50460,1144740,1094280,2153753.29248
8722,221,851400,934800,83400,613458.536621
1548,132,172440,1658640,1486200,3591122.28839
7521,185,41400,441420,400020,2108424.84735
2809,63,1220940,6232860,5011920,0.0
4213,73,1256400,1303500,47100,0.0
8392,220,2363940,2714040,350100,145951.976746
5004,69,1933860,2073180,139320,0.0
4050,116,493200,786600,293400,298622.764038
8462,133,5962920,6181200,218280,365790.826599
273,87,164100,1090800,926700,1074555.86169
9001,42,924360,953340,28980,135103.393799
4548,213,434040,3206820,2772780,2630551.94574
2612,92,0,613860,613860,0.0
1982,63,504540,6232860,5728320,6660907.03363
8588,14,1255560,1327560,72000,37151.6404419
200,149,173040,223140,50100,0.0
4550,156,2072820,2639280,566460,1131815.56128
7876,170,0,665160,665160,365858.40918
8485,212,129420,204240,74820,0.0
1947,98,1588980,7319880,5730900,5485696.91425
7379,16,13200,117000,103800,0.0
1456,63,11400,6232860,6221460,3949753.90424
1599,122,606480,861720,255240,0.0
1808,104,872100,935100,63000,0.0
5285,103,4204620,4719960,515340,0.0
3275,23,976500,1894920,918420,247069.523438
8476,139,24600,273900,249300,528056.20166
3698,199,119340,975720,856380,1576285.60071
7292,3,67560,1055580,988020,728345.983276
3351,23,1031820,1894920,863100,15591271288.0
2765,165,70500,1262880,1192380,705379.006958
1834,133,456420,6181200,5724780,5772023.07422
8140,190,14880,705600,690720,0.0
7383,178,61800,904200,842400,0.0
5137,98,4180380,7319880,3139500,4585033.2771
1734,63,336240,6232860,5896620,6173137.55591
1634,135,904440,5649480,4745040,2499889.82379
6087,13,118680,2525940,2407260,2232100.59827
2152,133,684360,6181200,5496840,5285177.65472
4127,165,1262880,1262880,0,287353.712402
3667,148,1917240,1938900,21660,0.0
1033,62,136860,3674460,3537600,3565747.24036
3281,166,1048260,1666080,617820,541114.272949
1765,122,861720,861720,0,0.0
4915,142,4047060,7299960,3252900,2696834.25372
8274,14,1010460,1327560,317100,257379.175781
2199,82,1468680,2195880,727200,0.0
3010,67,2682900,3120480,437580,655299.461914
234,124,124200,754200,630000,1945142.29401
5920,76,4984140,7552500,2568360,2905346.27655
3709,203,808800,1897500,1088700,21596440116.3
6572,32,128880,1205580,1076700,80802.5895386
7427,164,123540,123600,60,0.0
349,51,277200,280800,3600,0.0
4876,168,438000,438000,0,824.002258301
8440,30,461640,604800,143160,1493779.93188
6777,46,1873860,2027040,153180,88375.3961182
2005,63,529740,6232860,5703120,4790264.18665
8583,30,552240,604800,52560,1211.34899902
4750,151,1594680,3643800,2049120,1994585.72858
957,80,338580,338580,0,746857.943665
1891,133,507240,6181200,5673960,5590773.16534
7947,63,5432940,6232860,799920,0.0
6097,174,232860,1300440,1067580,1314995.77539
8438,30,461100,604800,143700,976506.438599
7041,195,117360,393120,275760,0.0
2176,101,263400,655020,391620,0.0
2813,165,123480,1262880,1139400,1960516.62933
2835,158,262320,2044680,1782360,2651564.01355
6616,204,649740,2567700,1917960,1761893.35504
4067,184,676800,1800900,1124100,718720.23114
8808,76,7413120,7552500,139380,0.0
7810,22,0,810360,810360,270780.903564
5739,216,465780,496500,30720,125144.158569
5902,57,255060,2756640,2501580,9761428332.82
7755,58,65940,992100,926160,0.0
3332,130,1828800,3083940,1255140,483272.782227
8307,208,1546260,1620480,74220,32007.3205566
2600,123,952320,3545820,2593500,2402443.61194
2864,141,2443920,7406100,4962180,4280526.78577
1796,63,377940,6232860,5854920,4617134.79456
2258,75,1452660,6135000,4682340,7172207223.15
6990,146,6022800,6670800,648000,830444.648254
7184,14,81120,1327560,1246440,0.0
1610,132,220740,1658640,1437900,2713893.88025
2899,114,48120,1201080,1152960,2227836.84363
2217,84,1845360,3714840,1869480,1819859.89899
4484,186,34080,3636240,3602160,1022740.13489
4406,152,137760,3766500,3628740,1149194.15399
7725,178,423060,904200,481140,392783.036133
3518,71,2416620,3996240,1579620,1543945.27246
6256,204,409080,2567700,2158620,2678400.81439
8903,190,615480,705600,90120,0.0
1491,110,1331400,5579400,4248000,3504514.56952
8062,159,2006880,2480580,473700,0.0
1011,66,937080,4817700,3880620,4124525.3855
125,106,18000,1023180,1005180,0.0
6227,162,2835720,4836120,2000400,1954334.63843
7485,27,185460,402780,217320,2612707.39362
3968,71,2857200,3996240,1139040,1272505.9577
4152,114,1164180,1201080,36900,0.0
4732,187,62100,2496960,2434860,740438.616821
2332,23,64380,1894920,1830540,2192387411.75
6403,151,2909040,3643800,734760,955870.363342
5083,146,4369680,6670800,2301120,18445338070.6
5865,196,706860,3281700,2574840,2667235.38257
6521,10,813600,979740,166140,557691.332642
6895,195,34920,393120,358200,959568.851746
1134,76,1087200,7552500,6465300,6412616.0589
6606,5,155340,748200,592860,0.0
1409,1,44580,1447140,1402560,0.0
6150,131,4603320,6825900,2222580,2405074.91504
748,80,181920,338580,156660,983039.466858
9041,131,6822300,6825900,3600,0.0
1502,12,235500,850020,614520,60835.3825073
6916,222,222300,1113000,890700,44809.4098511
3251,77,1896660,3257040,1360380,1235195.8501
1729,79,1555200,4151700,2596500,1777739.08508
3892,213,25680,3206820,3181140,2778399.34393
2957,135,2083920,5649480,3565560,4012650.22998
8237,63,5633340,6232860,599520,237833005.394
6166,98,5131800,7319880,2188080,6510822560.63
2986,132,1430400,1658640,228240,970664.864136
5192,157,64680,1993260,1928580,1165408.67981
7068,209,4500,1091400,1086900,619908.971436
4882,161,1870080,1955580,85500,0.0
4136,153,1401480,1618560,217080,1753342.12146
2195,63,644340,6232860,5588520,4934675.89111
5350,177,1315440,1713060,397620,481528.546997
9067,76,7552500,7552500,0,26137.8673706
2186,1,716880,1447140,730260,1178654.1156
6731,75,5159760,6135000,975240,1334186.02771
17,149,0,223140,223140,1688476.25183
7739,219,2875140,3797940,922800,1515227.29797
1481,146,1341840,6670800,5328960,5921877.38153
6555,208,28440,1620480,1592040,2020320.23083
6759,75,5178000,6135000,957000,923874.860107
1128,121,611700,856140,244440,0.0
7224,61,6225300,6225300,0,1543569.50159
2970,162,74400,4836120,4761720,2939819.42908
7382,195,328200,393120,64920,0.0
5057,156,2488260,2639280,151020,0.0
7299,219,2444940,3797940,1353000,1723920.11829
5516,213,1261740,3206820,1945080,0.0
8728,188,4245960,4327560,81600,0.0
4332,84,3684300,3714840,30540,0.0
948,76,794460,7552500,6758040,6741923.25342
6670,4,856860,1326000,469140,418742.655762
5786,177,1709460,1713060,3600,69478.1529541
3032,130,1473480,3083940,1610460,1547924.00616
5061,157,0,1993260,1993260,1371209.67694
1686,133,244080,6181200,5937120,4482740.63281
4645,133,2859600,6181200,3321600,3722032.53363
1466,33,64680,78900,14220,407281.360718
3222,77,1872060,3257040,1384980,2101775.01263
3711,203,813900,1897500,1083600,1006191.54401
2740,73,0,1303500,1303500,2318374.13739
529,91,283440,1030200,746760,1628876.55109
3309,192,331980,4648740,4316760,4253908.56714
6089,204,239340,2567700,2328360,2865459.42889
4117,218,108840,1974480,1865640,1805255.78033
9073,37,736020,736020,0,0.0
1256,61,1266180,6225300,4959120,0.0
3007,130,1458360,3083940,1625580,1872651.62
4417,0,1514820,1560960,46140,0.0
793,84,545100,3714840,3169740,2551788.25702
968,118,229500,459900,230400,1550919.02594
407,76,367200,7552500,7185300,8377979.32336
2156,94,188280,534480,346200,882457.705444
7211,213,2640480,3206820,566340,1639819.66772
5577,213,1304760,3206820,1902060,1670989.11865
5654,220,60480,2714040,2653560,2393016.95526
6239,11,76020,1777560,1701540,2530899.59113
1448,133,70620,6181200,6110580,4782438.7326
2075,108,695340,3191940,2496600,3183149.271
6274,63,4104120,6232860,2128740,448642660.213
7209,162,3587460,4836120,1248660,1604269.07544
8885,219,3717540,3797940,80400,136631.57605
944,80,313200,338580,25380,214467.551208
7531,16,117000,117000,0,279267.844177
221,84,26520,3714840,3688320,4583291.61176
7103,213,2585880,3206820,620940,1211898.23737
6631,75,5079180,6135000,1055820,1192809.96729
8970,42,914700,953340,38640,3408450698.5
4403,215,1457460,1851720,394260,425062.096497
87,149,77940,223140,145200,1729978.86127
2632,161,16320,1955580,1939260,0.0
1733,98,1448280,7319880,5871600,6507537.66357
7847,209,644880,1091400,446520,638726.989197
2797,171,271260,435600,164340,1325568.07129
4849,103,3973320,4719960,746640,819113.701721
7861,13,1673760,2525940,852180,1336933.0697
6672,31,364500,1374660,1010160,450507.707703
93,149,83520,223140,139620,1969620.71039
1173,122,310320,861720,551400,855782.499268
3006,130,1458360,3083940,1625580,1531995.78943
6817,204,913920,2567700,1653780,1438239.84875
6254,63,4088880,6232860,2143980,600804199.413
811,106,637560,1023180,385620,639526.189636
2378,166,183600,1666080,1482480,1985647.86804
3957,79,3487500,4151700,664200,1788208.37561
7969,2,2555640,2555640,0,26877.4651489
8253,220,2153340,2714040,560700,387686.352905
6279,18,22800,1779540,1756740,1182540.94525
7248,213,2668680,3206820,538140,0.0
4092,107,1270620,4991760,3721140,3484839.48486
2908,142,2353500,7299960,4946460,5325862.63623
6115,220,493800,2714040,2220240,2587378.86212
8277,14,1017720,1327560,309840,817029.517883
1095,127,534540,599940,65400,111993.863892
1506,105,1314420,1314480,60,355876.682983
6661,46,1783380,2027040,243660,523038.659851
4878,156,2380080,2639280,259200,473067.085144
7311,24,1485300,1547520,62220,39759.4313965
6195,63,4046940,6232860,2185920,0.0
2853,158,268740,2044680,1775940,2132887.22485
1928,63,473940,6232860,5758920,5196785.47754
933,66,824340,4817700,3993360,4633280.23987
2174,94,198600,534480,335880,1146908.50226
7925,7,0,40380,40380,1532426.92291
7966,209,716220,1091400,375180,2031463.39313
7289,15,544080,1822860,1278780,1447083.1828
4113,163,95640,548880,453240,962582.640137
1089,72,406980,2385960,1978980,3526551.83844
1880,111,1836060,3974400,2138340,1983293.90735
395,53,19620,582540,562920,1319334.47388
2042,144,1292040,1807260,515220,492743.277771
4973,135,3759180,5649480,1890300,1383069.66925
1263,122,374700,861720,487020,1325883.41711
6221,146,5396340,6670800,1274460,1508217.90308
6084,204,151980,2567700,2415720,3279649.84167
3594,199,48000,975720,927720,1756668.12701
361,142,66300,7299960,7233660,4695924.77606
6380,141,5365380,7406100,2040720,0.0
8153,13,1844760,2525940,681180,0.0
5449,214,267900,341760,73860,1355607.07605
5944,76,4999500,7552500,2553000,30441745505.9
6562,32,117660,1205580,1087920,364230.075134
3261,130,1784820,3083940,1299120,0.0
1602,123,0,3545820,3545820,3064228.82703
1944,94,40380,534480,494100,1721737.91284
2134,134,654600,3656580,3001980,2291058.12915
8805,13,2388000,2525940,137940,12741132479.0
673,87,567660,1090800,523140,986823.378601
5335,63,3208080,6232860,3024780,9002607061.01
4533,107,1534200,4991760,3457560,2914832.68781
2781,171,254460,435600,181140,1445158.27765
6730,5,242700,748200,505500,309686.568665
1463,146,1338000,6670800,5332800,4821721.91034
821,127,164340,599940,435600,276445.537354
8676,37,526560,736020,209460,0.0
5000,71,3585720,3996240,410520,20448667580.9
6936,204,998580,2567700,1569120,1209896.65204
8495,40,0,163800,163800,904346.272095
1920,96,11460,2123400,2111940,1507901.33057
8866,196,3192900,3281700,88800,0.0
1496,140,1207680,1300140,92460,559485.553589
6874,151,3353580,3643800,290220,0.0
763,142,436140,7299960,6863820,6322277.96918
5552,169,664260,2190660,1526400,796923.530212
5105,103,4113300,4719960,606660,3644350528.53
6674,204,678780,2567700,1888920,1785573.07977
5067,213,852900,3206820,2353920,1011170.76715
5973,10,263820,979740,715920,852201.01062
1681,76,1468800,7552500,6083700,6429059.1806
8746,162,4834680,4836120,1440,0.0
4729,213,674940,3206820,2531880,2764621.09216
862,76,724860,7552500,6827640,6369420.88629
2688,96,651000,2123400,1472400,532948.658142
6353,196,1209300,3281700,2072400,1955578.90704
