,id,elapsed_time,total_time,remaining_time,XG_2000,RF_50,LM_pred,Lasso
5523,76,4772400,7552500,2780100,2785475.5,2732690.4,2470826.97076,2766906.8363
113,76,56100,7552500,7496400,7500346.5,6643939.2,5678371.06122,4189109.08627
5932,204,0,2567700,2567700,1347053.875,1523223.6,2190984.73621,1465914.98806
5616,220,20400,2714040,2693640,1855584.375,1986759.6,1588129.4696,2014014.68715
4190,203,1248900,1897500,648600,646588.5625,641980.8,0.0,581513.735018
3116,141,2744100,7406100,4662000,4690200.5,4656403.2,4562888.02979,4824724.74053
7743,98,6421080,7319880,898800,903842.0,871257.6,1137708.77679,1217895.26333
8393,196,2907780,3281700,373920,380952.375,373941.6,400993.2724,596674.993065
5314,156,2635680,2639280,3600,3155.84667969,11756.4,686106.194092,-206481.756137
6486,63,4244220,6232860,1988640,2084794.375,2083771.2,219171791.613,2299138.07632
2305,98,1845180,7319880,5474700,5526258.5,5426875.2,7073640.94147,5322435.01272
5305,214,24420,341760,317340,224409.3125,433228.8,81513.0880127,278226.29985
1924,83,1263420,1818000,554580,560357.125,764606.4,390071.523254,671953.539258
7052,151,3467400,3643800,176400,172386.296875,192259.2,271147.545227,-73126.1737215
4759,131,3459900,6825900,3366000,3347880.5,3359071.2,3624435.47284,3277633.29207
4432,63,2540880,6232860,3691980,3654102.0,3684488.4,0.0,3804823.57254
6798,75,5332500,6135000,802500,804273.25,812738.4,479632.960022,896081.679762
7568,75,5916660,6135000,218340,509843.25,772534.8,376054.62738,-94511.1364778
5104,103,4112820,4719960,607140,611486.875,613995.6,6718268446.24,779849.989379
8017,22,112980,810360,697380,673656.1875,628665.6,0.0,867.33435026
1184,129,1184400,1188000,3600,0.0,702184.8,0.0,-1309153.40178
2752,156,619440,2639280,2019840,1960137.125,2009638.8,1996410.94128,1514420.34974
5425,63,3401940,6232860,2830920,2816475.75,2825137.2,3616028.6568,2939648.66752
5917,220,180060,2714040,2533980,2309512.0,2448810.0,1854966.37256,2562838.9271
4167,163,117840,548880,431040,1078014.25,544734.0,0.0,332420.415202
115,146,70560,6670800,6600240,6554480.5,6431665.2,5387938.68274,4638556.21952
8899,58,907560,992100,84540,83816.4765625,84128.4,98414.9945068,-266077.705408
1291,66,1261200,4817700,3556500,3555764.25,3551959.2,3116969.93378,3435851.91929
7500,13,1308240,2525940,1217700,1079704.875,1211625.6,338437.07312,788310.313031
7932,220,1936440,2714040,777600,770258.375,775760.4,857252.530884,794609.898061
3093,130,1540380,3083940,1543560,1554621.5,1525340.4,1088144.13153,1908335.25425
7625,63,5218140,6232860,1014720,1076826.625,982934.4,0.0,916030.640077
1564,110,1391040,5579400,4188360,4179242.5,4189041.6,3830677.84967,3705594.95532
1295,66,1269600,4817700,3548100,3553247.75,3551858.4,3265613.98676,3432254.67375
3817,182,242580,915060,672480,656554.6875,856213.2,0.0,-185292.492334
4014,203,1147080,1897500,750420,742408.125,814509.6,0.0,809812.776942
660,84,464940,3714840,3249900,3186312.0,3173199.6,4289633.36554,3381238.90173
6473,218,1974480,1974480,0,7498.94628906,89719.2,0.0,-240400.433552
2979,67,2667840,3120480,452640,594306.9375,436582.8,885407.557434,881106.3069
4356,107,1441800,4991760,3549960,3561999.25,3551194.8,3401248.94891,3449750.65301
4442,156,1998000,2639280,641280,644108.125,636624.0,1053231.7652,736973.85342
3743,73,847500,1303500,456000,499961.0625,545034.0,562261.075684,1022294.08378
20,67,300,3120480,3120180,3221509.5,3029977.2,0.0,2386880.65868
4474,135,3333660,5649480,2315820,2406819.25,2269099.2,2380779.48108,2263477.12367
8269,196,2768520,3281700,513180,502783.0625,503600.4,0.0,471435.088904
4539,151,1342740,3643800,2301060,2403222.75,2301477.6,2640729.77222,2717811.55932
1050,118,329820,459900,130080,477225.90625,339003.6,472211.181152,408985.573081
6299,146,5444400,6670800,1226400,1374871.25,1258155.6,0.0,1485618.76547
869,110,727680,5579400,4851720,4739588.0,4701386.4,3466537.26019,3036190.20776
2959,114,99480,1201080,1101600,853162.75,1084729.2,1999979.9566,1522729.04712
3069,72,2061960,2385960,324000,946207.0625,509228.4,1593686.22198,1126479.21908
4107,0,1330860,1560960,230100,311043.96875,238321.2,1304470.77802,1076954.83771
7931,15,1100820,1822860,722040,713815.4375,730162.8,383955.534851,723930.115189
1201,77,73320,3257040,3183720,3121024.0,3186487.2,1290575.65881,1983845.0894
313,91,14460,1030200,1015740,1172153.25,1775034.0,2776924.13708,3020054.03673
7885,42,113880,953340,839460,675166.3125,618016.8,1836576.02826,1270141.64171
4297,213,284520,3206820,2922300,2951387.75,2918422.8,3619049.94348,3719960.68005
3788,130,2147460,3083940,936480,906668.625,939411.6,18600744924.6,1094767.00262
1250,140,1051320,1300140,248820,240604.4375,236470.8,448710.21167,855805.048436
8477,139,24600,273900,249300,159472.875,230167.2,497682.765015,385657.467233
2193,101,272460,655020,382560,417661.625,489890.4,537719.887268,165153.942315
8450,224,335580,648060,312480,290040.84375,278708.4,0.0,-218182.525579
7001,204,1026180,2567700,1541520,1539131.875,1542543.6,1481496.58746,1550021.97584
5771,134,3652980,3656580,3600,273219.9375,565854.0,149002.461853,-228542.119838
1651,97,292800,294600,1800,516502.28125,737805.6,2383159.0509,2498096.62216
8458,37,393000,736020,343020,346802.125,337774.8,894739.959534,779449.18231
4877,130,3055140,3083940,28800,13241.4667969,95251.2,0.0,-98097.9349032
5090,19,16740,608940,592200,711380.4375,1137680.4,518031.836487,274965.046674
8426,65,7193040,7544400,351360,338583.90625,342576.0,172694.465698,184954.547593
2509,153,34080,1618560,1584480,1916718.125,1685089.2,863994.455811,1659034.37307
3077,142,2489160,7299960,4810800,4854390.5,4800378.0,4631418.01245,4990373.66036
7585,131,5790300,6825900,1035600,1071079.5,1043378.4,1260876.73291,1081420.59827
2324,63,737280,6232860,5495580,5497234.0,5485725.6,0.0,5376354.39789
3066,141,2591760,7406100,4814340,4834664.0,4822771.2,5176381.11005,5071284.61852
696,84,511380,3714840,3203460,3276687.5,3228854.4,3166865.44177,3582800.27459
6852,187,1814940,2496960,682020,627375.625,685584.0,606338.458557,41638.438798
4234,213,247140,3206820,2959680,2913685.5,2961915.6,3633580.99445,3640775.69407
9021,37,715500,736020,20520,59733.234375,23241.6,0.0,366827.027311
3636,71,2502720,3996240,1493520,1546277.875,1488379.2,1991268.7876,1464750.59906
5848,123,3544020,3545820,1800,90533.0234375,461060.4,0.0,297201.654039
6882,5,465900,748200,282300,315834.25,253278.0,279930.837952,453770.459269
8667,30,604800,604800,0,0.0,20726.4,0.0,-336027.202978
8875,224,586860,648060,61200,0.0,52615.2,0.0,-5980.94132957
8355,14,1099320,1327560,228240,440198.90625,198806.4,0.0,175766.030299
2105,77,827040,3257040,2430000,2396013.5,2376890.4,2822346.94763,2590907.87047
922,131,35340,6825900,6790560,6650967.5,6430611.6,5063068.3797,4264688.82248
3264,107,582180,4991760,4409580,4386305.5,4278766.8,4501664.95923,4237932.48285
8554,196,3020100,3281700,261600,262357.84375,263188.8,0.0,116916.806225
3921,60,3429600,7401300,3971700,2763657.0,3442933.2,4361748.60266,4009214.60629
8391,37,348120,736020,387900,396543.0625,362509.2,2333457.8092,2928934.50239
588,106,506220,1023180,516960,510001.625,502249.2,3313452518.47,465663.160931
213,146,156420,6670800,6514380,6522085.0,6522717.6,5778487.8277,5242848.90808
1998,63,527820,6232860,5705040,5782614.0,5714563.2,5874801.71289,5857300.91115
5808,4,118140,1326000,1207860,1239438.375,1200188.4,763514.75238,659012.953715
2189,166,24600,1666080,1641480,1439359.0,1575019.2,1500179.89398,1115352.55036
5075,62,3592860,3674460,81600,121808.3125,200494.8,0.0,699593.120181
3232,192,287700,4648740,4361040,4439643.5,4356891.6,4565598.36139,3953158.16098
5735,4,84720,1326000,1241280,1445294.375,1225580.4,266135.892395,386378.641478
3703,203,807900,1897500,1089600,1098021.375,1089208.8,19296725501.4,1320816.68347
5459,24,17940,1547520,1529580,1419223.75,1599058.8,2677318.34338,2170862.91813
2956,135,2083860,5649480,3565620,3112414.5,3051955.2,4504180.48462,3567105.54813
8491,65,7226040,7544400,318360,213073.3125,262480.8,408522.187988,216100.051078
6277,63,4104360,6232860,2128500,2143150.75,2131084.8,224903364.846,2184802.91544
6104,155,2226300,3225180,998880,983870.875,985902.0,296521.347046,645450.461706
5899,196,721320,3281700,2560380,2532900.0,2533316.4,5932316495.57,2260403.23051
5939,220,194100,2714040,2519940,2406697.75,2447096.4,2354713.59857,1783274.24475
2839,203,90780,1897500,1806720,1907100.75,1610361.6,1168415.91479,1439077.47973
2517,142,2094360,7299960,5205600,5193175.5,5193493.2,0.0,4906041.67701
2485,143,366300,1898460,1532160,1494897.0,1530606.0,1289096.5423,1098784.04171
5574,10,40800,979740,938940,1521637.375,1096222.8,1227445.61169,1390461.99891
6596,131,4905060,6825900,1920840,1918745.875,1888050.0,0.0,2102798.28845
2455,101,599220,655020,55800,307763.9375,369846.0,0.0,-527081.383658
6955,204,1002960,2567700,1564740,1562553.0,1563718.8,1231602.05493,1564522.74911
8578,64,6729900,6845160,115260,160785.390625,130450.8,638834.580383,57377.9386217
6346,63,4157520,6232860,2075340,2083799.875,2082033.6,64097929.9284,2225798.98086
891,144,174840,1807260,1632420,1617054.125,1552748.4,1668872.17847,1781228.6495
8892,13,2436420,2525940,89520,66553.578125,89191.2,30438356424.6,130460.942089
3772,147,1479360,1479360,0,46708.28125,140035.2,395848.361084,145880.549486
7968,2,2555580,2555640,60,135979.59375,199214.4,24126.6790161,-157583.046442
2166,112,908100,1303440,395340,394518.9375,368496.0,643182.392517,484477.438182
3706,203,808200,1897500,1089300,1090835.125,1088382.0,18648700821.3,1320688.21042
3254,130,1782480,3083940,1301460,1331071.25,1304238.0,939774.136597,1258288.56789
8377,14,1115040,1327560,212520,253813.859375,210490.8,0.0,358992.174111
3775,188,192360,4327560,4135200,4012613.0,3786000.0,3105177.70923,2587455.78078
2131,77,859440,3257040,2397600,2362415.25,2367502.8,2112717.38849,2392343.77527
6094,63,3954060,6232860,2278800,2265981.5,2350382.4,2365731.14191,2596596.46135
4731,187,62040,2496960,2434920,2081629.0,2009894.4,725140.260559,903103.595211
3707,182,26700,915060,888360,968092.75,890696.4,141924.782288,448237.662841
8940,219,3742560,3797940,55380,60014.9375,59830.8,340883.057922,298145.183637
4119,218,109020,1974480,1865460,1611937.5,1237923.6,1521671.61786,1000173.1686
8853,13,2421420,2525940,104520,113647.757812,103616.4,0.0,35841.6072364
5809,4,118200,1326000,1207800,1308608.0,1193508.0,790487.166809,663177.953775
5388,214,234840,341760,106920,87760.53125,302017.2,715162.875,395711.66131
5986,204,44700,2567700,2523000,2285140.25,2485622.4,3093490.12567,2630062.24449
7415,8,0,615060,615060,614985.875,641587.2,383066.228943,575237.576185
942,83,258120,1818000,1559880,1742983.875,1621423.2,2538763.10803,2311482.10503
1374,103,1002120,4719960,3717840,3717801.25,3725040.0,3412289.11792,3578006.66895
1238,131,450480,6825900,6375420,6371374.0,6364405.2,5411302.38208,4984315.16692
7031,157,1684200,1993260,309060,289983.09375,312645.6,0.0,149863.774414
7855,13,1671840,2525940,854100,823274.5625,836064.0,274711.620667,733952.434664
4212,119,2310780,2742780,432000,464224.0625,368456.4,354158.124695,666645.083993
6998,222,268800,1113000,844200,763999.8125,652990.8,0.0,-448115.117
281,51,222000,280800,58800,24893.5019531,233649.6,0.0,-345152.323453
3357,130,1855380,3083940,1228560,1226865.25,1226911.2,1330733.3172,1243647.50296
295,65,214200,7544400,7330200,6319242.5,7035865.2,8120596.94556,7188588.92641
3283,148,1653900,1938900,285000,302899.09375,295909.2,524497.429199,457539.457268
1102,61,1152480,6225300,5072820,5695426.5,4992810.0,4695208.94989,5201105.29389
1192,87,1090800,1090800,0,0.0,96820.8,0.0,-600134.357915
1008,66,926460,4817700,3891240,3900307.0,3803264.4,3925511.06866,3921959.55952
2866,158,277800,2044680,1766880,1783743.0,1797988.8,1023793.35248,1963115.75089
2751,130,1294200,3083940,1789740,1756828.75,1747688.4,790675.598572,1597354.81505
3941,155,519000,3225180,2706180,2584538.0,2415613.2,2010344.10748,1980060.29782
2188,12,850020,850020,0,11092.21875,21093.6,194328.874023,428732.425595
7606,188,3386820,4327560,940740,989641.375,960099.6,389513.741577,863842.650352
1139,104,266460,935100,668640,2129815.25,1300336.8,6659466.96436,4782160.99545
1524,132,157380,1658640,1501260,1590452.5,1369422.0,2398216.36902,2333560.21852
8776,64,6833100,6845160,12060,39867.9648438,25138.8,134693.187073,-189654.392179
550,120,572400,576000,3600,0.0,479631.6,2610128.72827,1968099.52598
5748,213,1405140,3206820,1801680,1793936.125,1795184.4,0.0,1690722.45304
829,83,177300,1818000,1640700,1640981.375,1630064.4,2351489.51306,2491640.67667
3919,166,1614600,1666080,51480,34989.9140625,114151.2,1330079.32489,372658.17401
5371,214,204420,341760,137340,177925.375,194346.0,16554794660.7,1618261.0094
2483,70,1690920,3064200,1373280,1416059.375,1832823.6,1107610.34546,1086970.56146
5169,98,4208580,7319880,3111300,3209770.5,2994028.8,3302341.08582,2950948.47922
4940,2,68340,2555640,2487300,2412584.0,2310229.2,1497904.82733,1417879.5427
4945,103,4020060,4719960,699900,640750.375,664153.2,555116.39917,851993.227703
6233,220,581580,2714040,2132460,2293348.75,2013094.8,0.0,2012837.7924
2472,143,360120,1898460,1538340,1497608.875,1345294.8,1020106.87115,699843.143273
8043,211,34560,87180,52620,0.0,178651.2,590788.583496,421236.039487
5162,217,108180,557700,449520,488676.0625,443071.2,1735705.97516,1237144.08678
5189,20,3600,39660,36060,38026.2578125,143554.8,905823.053345,1115437.15516
3979,114,1062600,1201080,138480,149753.953125,151912.8,667044.740417,354549.968659
6820,5,431580,748200,316620,329127.65625,389109.6,0.0,-327188.610178
5736,4,84720,1326000,1241280,1472059.375,1215261.6,837666.035339,642466.454491
6770,13,722280,2525940,1803660,1802180.375,1773057.6,1881298.88812,1784922.03775
6564,61,5686200,6225300,539100,619348.8125,550724.4,0.0,813707.930564
6943,31,686520,1374660,688140,689475.3125,711380.4,888889.958374,741358.764496
4847,2,20880,2555640,2534760,1938808.125,1589682.0,1462887.83429,700652.689732
5839,213,1459260,3206820,1747560,1751488.125,1761100.8,2093954.52399,1789870.7006
4207,135,3182400,5649480,2467080,2460702.0,2482114.8,2192841.2359,2339480.00358
6704,204,698760,2567700,1868940,1862736.25,1863760.8,2163588.4054,1944754.41565
790,75,95280,6135000,6039720,6056393.0,5969556.0,4870868.17957,4290069.01836
1212,77,83580,3257040,3173460,2293485.5,3211990.8,2137832.5047,1666415.11457
6693,204,689100,2567700,1878600,1873570.125,1877512.8,1945213.03571,2025827.31654
6516,110,5567400,5579400,12000,16744.9257812,233821.2,0.0,235412.481777
1976,133,557340,6181200,5623860,5621202.0,5611747.2,5894879.48688,5280484.21464
8739,162,4831620,4836120,4500,20112.1445312,174055.2,476625.127014,-316254.896796
5826,220,147660,2714040,2566380,2605230.75,2400937.2,3169504.25568,2979626.41651
2375,156,252600,2639280,2386680,2652105.75,2780860.8,3182132.81927,3283241.67906
5378,71,3945600,3996240,50640,91107.234375,113860.8,2652289941.71,452511.580772
3813,119,2052480,2742780,690300,683142.1875,653790.0,1413030.71979,1349116.08826
8916,219,3731400,3797940,66540,43888.75,67701.6,91255.7024536,178828.345604
6533,32,102240,1205580,1103340,1066309.25,934794.0,878423.720276,919204.239271
5663,193,74340,187200,112860,1007837.8125,1236384.0,0.0,-78054.7854073
1470,138,1379340,1785600,406260,379142.59375,390400.8,616162.172119,591132.886121
368,124,257400,754200,496800,478553.40625,466434.0,2676015410.23,166423.460302
6238,63,4076400,6232860,2156460,2216726.5,2157338.4,2894405359.39,2309602.09491
4612,142,3876600,7299960,3423360,3381517.75,3375616.8,2826121.19568,3415514.84058
3685,203,794160,1897500,1103340,1175600.25,1102497.6,1577751.84155,1324401.22684
6926,167,38100,534900,496800,694212.0,554191.2,0.0,903418.483578
8908,37,651840,736020,84180,46972.0625,198872.4,0.0,327454.265895
1357,138,1309620,1785600,475980,475185.96875,476107.2,914997.061584,760779.453645
8146,13,1843020,2525940,682920,682072.6875,678980.4,167298.998901,780694.721931
8936,29,51180,57540,6360,0.0,28072.8,0.0,18184.5219114
7222,205,116100,460800,344700,444979.84375,439471.2,0.0,348269.629161
146,76,86400,7552500,7466100,7453603.5,7466244.0,8053928.19983,7472194.41926
8499,159,2421180,2480580,59400,31991.4179688,83558.4,0.0,-1155456.31769
486,141,372000,7406100,7034100,7020411.5,7032811.2,6668074.56183,6267339.40629
5959,56,4492800,6361440,1868640,1872796.0,1780129.2,2619288.11963,2164229.49059
1190,127,599940,599940,0,1587.53894043,13498.8,0.0,-182958.395246
1041,88,422340,555360,133020,84740.359375,404098.8,845566.898682,1620646.12831
3165,98,2701380,7319880,4618500,4621566.0,4631119.2,4982703.31622,4774730.3459
198,138,180000,1785600,1605600,1531489.875,1529235.6,2825548.95013,2714177.87818
1218,122,347820,861720,513900,739626.9375,688930.8,325940.307495,740997.815813
1881,98,1555740,7319880,5764140,5788195.0,5704141.2,5976093.12628,5915456.92697
2202,101,274740,655020,380280,435316.25,477315.6,0.0,64762.7468812
4663,215,1729320,1851720,122400,203572.953125,286099.2,0.0,-550075.007006
1820,111,1781880,3974400,2192520,2218663.25,2189776.8,2823403.25427,2148777.03471
6826,18,518700,1779540,1260840,1210417.75,1270988.4,1648328.18109,1312687.1755
7141,205,77760,460800,383040,576579.5625,535567.2,0.0,108237.298698
8173,197,621960,626580,4620,139629.765625,102116.4,780783.064758,1079014.05585
4083,131,2935500,6825900,3890400,3896131.0,3881763.6,3425895.38922,3527206.01732
5412,177,1488720,1713060,224340,323161.40625,352124.4,435171.313232,809446.510679
8227,37,118800,736020,617220,613427.5625,620613.6,1545758.47601,1503658.56956
6343,63,4156140,6232860,2076720,2077602.0,2085848.4,126900758.754,2150536.12441
5241,103,4186020,4719960,533940,547199.0625,535941.6,14034960293.6,563318.362375
4934,156,2416920,2639280,222360,232371.21875,208695.6,519266.656677,351528.410243
9055,76,7548780,7552500,3720,4072.92236328,2955.6,33143779550.0,151033.622753
203,149,177540,223140,45600,48669.296875,48523.2,0.0,212728.81702
6414,54,1277460,1314000,36540,18661.2109375,75016.8,0.0,-420657.539986
3238,184,5760,1800900,1795140,1725808.5,1663260.0,1004166.4209,1199005.49889
8492,133,5978040,6181200,203160,239703.375,233358.0,78653.3797607,2155.54208656
6949,89,1731840,1736340,4500,66035.09375,58100.4,204647.16925,419621.610911
2789,173,55680,3215700,3160020,3155059.5,3063135.6,2982342.49835,3101913.18703
7439,75,5704320,6135000,430680,362480.28125,325819.2,699518.339844,409389.761346
6161,155,2279160,3225180,946020,884325.6875,988156.8,1056803.7356,302314.733785
1646,12,338640,850020,511380,524869.0625,582405.6,658612.032532,1384674.02025
309,65,225600,7544400,7318800,6237593.5,6716625.6,7978997.35248,7285315.85532
521,150,555180,626340,71160,86092.6015625,134790.0,0.0,-735874.028239
1392,110,1267320,5579400,4312080,4456904.0,4292070.0,2571631.36279,3223510.24781
1253,131,459180,6825900,6366720,6229518.5,6091962.0,6243539.05231,5187823.54417
7962,7,26160,40380,14220,643262.9375,472963.2,691317.75238,638910.289784
7187,188,2990220,4327560,1337340,1342805.5,1337218.8,1495060.42792,1412306.94298
3418,166,1143000,1666080,523080,471024.84375,568876.8,7297.27026367,317565.964547
451,150,527400,626340,98940,206152.734375,456204.0,0.0,205312.756306
8950,29,54900,57540,2640,0.0,81105.6,0.0,-105545.941794
2770,165,73440,1262880,1189440,1133638.875,1186088.4,2190949323.39,1122142.34119
5908,4,170400,1326000,1155600,1133834.125,1139290.8,1368719.99994,1010810.87166
2639,107,2940,4991760,4988820,4263509.0,4546412.4,4109633.00311,5008429.23585
367,76,284400,7552500,7268100,7252674.5,7268605.2,9342820.84308,7751618.15387
3820,151,899220,3643800,2744580,2834912.75,2751517.2,2895035.04053,2596262.67159
4351,131,3107760,6825900,3718140,3756795.0,3717867.6,3584366.82013,3766887.10925
5731,134,3624600,3656580,31980,32729.2949219,353257.2,95538.9333496,95403.8587828
5644,76,4842900,7552500,2709600,2705581.5,2652783.6,3735240.76385,3069434.70092
8014,26,1481880,2036760,554880,654574.3125,543648.0,523756.116516,572773.950217
3503,188,3480,4327560,4324080,2721268.75,3171157.2,2432043.24353,1980803.30322
396,141,193140,7406100,7212960,7191987.0,7210032.0,5679810.50806,5578077.89349
1585,63,99060,6232860,6133800,5826919.5,6027349.2,3865462.50891,4055156.152
8736,40,148620,163800,15180,0.0,16170.0,518393.655212,966756.28083
8129,196,2600700,3281700,681000,703661.1875,681660.0,0.0,145958.250011
8559,220,2478060,2714040,235980,232341.625,235095.6,992639.675171,316395.164852
983,75,259560,6135000,5875440,5764138.0,5897194.8,5248427.3363,4525135.96446
498,60,370140,7401300,7031160,6845168.5,6006426.0,3111752.58612,4274034.17463
6935,195,72300,393120,320820,442744.4375,410306.4,1197969.09259,654957.901437
2246,156,156720,2639280,2482560,2827194.25,2477295.6,3071577.75873,3168586.29808
3139,142,2667540,7299960,4632420,4653831.0,4639474.8,4262487.10474,4700901.06242
4456,168,59820,438000,378180,319735.21875,616222.8,1464615.24402,1111434.88818
2273,75,1458060,6135000,4676940,3715488.5,4268136.0,3216229.96094,3445837.48772
4711,156,2289120,2639280,350160,349234.15625,352035.6,0.0,260753.005828
1762,1,432720,1447140,1014420,1004241.375,976788.0,1289581.76788,1715130.33067
3371,203,596160,1897500,1301340,1327712.125,1270545.6,812732.230469,1256919.47379
7360,167,272100,534900,262800,211611.421875,253560.0,0.0,22725.0133506
9009,63,6206940,6232860,25920,33247.1328125,22447.2,125145573.568,76439.2370692
1544,133,119100,6181200,6062100,6066392.0,5884353.6,4398349.57477,4279393.8149
6646,10,898920,979740,80820,280517.5625,140110.8,395046.303528,-277518.20532
2674,133,1165500,6181200,5015700,5009113.0,5028204.0,6462195.96564,4932780.92057
940,83,255600,1818000,1562400,1497544.25,1520696.4,2228882.33295,2234547.72774
7644,186,2694000,3636240,942240,895184.125,873507.6,3705266592.04,288076.954007
8935,57,2756640,2756640,0,0.0,103654.8,0.0,250591.658346
1825,98,1503360,7319880,5816520,5812930.0,5814658.8,5621781.19025,5596762.48889
3815,116,324900,786600,461700,363500.15625,482259.6,300146.85968,792853.588659
3201,156,1062600,2639280,1576680,1577002.375,1580316.0,1459933.6062,1472317.97716
5430,49,3988800,3991980,3180,0.0,120961.2,0.0,284734.353453
4628,191,2460,1811280,1808820,1817456.875,1787016.0,2568405.88995,1234857.10701
7663,183,38040,445560,407520,532748.4375,523160.4,0.0,-477646.609862
5958,63,3701340,6232860,2531520,2528137.75,2529568.8,7697116.59869,2644961.49992
6072,13,96960,2525940,2428980,2259183.5,2352937.2,1415569.60315,1153876.77444
4724,141,4039200,7406100,3366900,3369349.75,3356451.6,2619657.1803,3083433.29954
1710,98,1316580,7319880,6003300,5986359.0,5962219.2,6176861.39941,6273336.76843
3260,130,1784820,3083940,1299120,1305092.625,1301247.6,1127176.46509,1607041.20883
7549,172,971220,1443960,472740,419506.09375,297004.8,0.0,-716901.314497
175,60,0,7401300,7401300,3199440.5,4163788.8,3067092.30817,3061501.34645
331,79,149820,4151700,4001880,4036704.0,3999669.6,5082928.41388,4429873.19829
2304,126,202560,496560,294000,296498.9375,434445.6,627246.749878,915556.341373
3523,71,2421780,3996240,1574460,1490573.75,1506423.6,1663107.82867,995193.644815
8599,212,204240,204240,0,20660.9414062,59436.0,0.0,7345.72479721
2717,165,36720,1262880,1226160,1295787.875,1075203.6,608322.580017,901619.262038
7220,61,6225300,6225300,0,303.965270996,35481.6,1835438542.83,1866.65302533
2415,94,504000,534480,30480,237669.578125,70126.8,984866.872498,769190.2743
6065,204,120480,2567700,2447220,2445361.25,2441871.6,3024681.77643,3146867.36789
1987,56,1299600,6361440,5061840,5130243.0,5062488.0,4968400.55103,4355365.38376
1420,113,12240,3646740,3634500,5407192.5,4825473.6,4275670.25232,3727822.04443
1064,131,314400,6825900,6511500,6518291.5,6464998.8,5015670.03204,4476767.02326
4436,0,1521240,1560960,39720,32429.9863281,62031.6,0.0,46021.9943893
4653,74,2854140,2979600,125460,637944.125,267256.8,3438844.21814,2939705.09777
3726,73,820200,1303500,483300,539342.0625,669860.4,2502151.86676,827129.593025
246,120,226800,576000,349200,353774.28125,368194.8,955542.16333,1637495.63174
4690,158,1846140,2044680,198540,145366.0,173270.4,353528.91394,505284.637747
5029,86,3519180,3519180,0,180613.1875,173599.2,7645697803.58,14372.5829806
143,109,96900,274500,177600,0.0,285942.0,104837.061951,501937.455978
1570,1,170880,1447140,1276260,1272892.0,1326831.6,2171123.23767,2381379.16404
24,68,50400,262800,212400,588265.5625,537428.4,1499854.15021,2106553.50546
6735,204,735660,2567700,1832040,1842282.25,1841137.2,2182400.16473,1905509.36569
8180,224,14640,648060,633420,338575.84375,439436.4,0.0,237060.26532
500,79,401400,4151700,3750300,3489948.5,2837359.2,2362415.01147,3185068.10786
8446,30,463920,604800,140880,213416.015625,120451.2,848896.989746,184982.89233
6833,2,1706160,2555640,849480,769342.5625,786348.0,0.0,-151729.748169
5862,76,4964220,7552500,2588280,2588285.0,2587413.6,0.0,2664970.31478
5680,142,4656420,7299960,2643540,2642877.75,2643649.2,3916348.15259,2792440.40646
3171,67,2944320,3120480,176160,190998.46875,177150.0,0.0,190427.965871
8991,131,6794700,6825900,31200,0.0,31857.6,115574.321777,13890.651048
3782,188,197940,4327560,4129620,3918392.5,3805284.0,2517862.96985,2184778.30624
4574,135,3521760,5649480,2127720,2126798.5,2106945.6,2440748.76624,2421595.34018
1142,76,1089000,7552500,6463500,6465377.0,6446830.8,6690877.26355,6325288.02141
477,91,267420,1030200,762780,668978.1875,910645.2,1866098.7901,2059425.37254
5279,113,3181500,3646740,465240,429300.375,477843.6,59848.0975952,481406.212427
7080,48,131040,156420,25380,0.0,55066.8,416313.891113,911181.502209
2891,171,317100,435600,118500,23238.7421875,233157.6,668773.586487,980636.362453
7376,213,2750280,3206820,456540,519128.875,430135.2,14698988975.1,-67687.2320423
2002,102,85440,3198240,3112800,3149447.25,3027655.2,2064154.96063,2005022.18733
3202,142,2706540,7299960,4593420,4595125.5,4590870.0,3587893.66547,4481558.43005
6920,151,3388680,3643800,255120,307115.5,273793.2,1204495.43286,512986.863098
7722,76,6605880,7552500,946620,940825.8125,938840.4,13241200601.6,959402.35341
2278,83,1508400,1818000,309600,302697.90625,308004.0,76527.5742798,319991.826952
6384,18,86820,1779540,1692720,1633859.125,1623948.0,1280004.20929,1440642.0445
8939,65,7483800,7544400,60600,0.0,49666.8,447069.428162,208174.789871
4883,180,989280,3322080,2332800,2247355.0,2293003.2,1683167.84064,2227861.39012
577,106,504000,1023180,519180,515210.9375,535648.8,1599038.64246,365908.734056
5445,169,601320,2190660,1589340,1512883.375,1581903.6,1477885.45947,1546562.32184
5265,125,3969060,3969060,0,0.0,77824.8,0.0,-801004.899162
2267,65,2023200,7544400,5521200,5264428.5,4838938.8,5733407.62775,4770755.92073
5282,213,968460,3206820,2238360,2177672.0,2227478.4,1931335.21515,2409109.1377
555,120,576000,576000,0,0.0,480384.0,2916724.43494,2169076.54124
5268,71,3738600,3996240,257640,156740.6875,272356.8,15059540883.7,80291.0174896
4426,96,2081400,2123400,42000,134517.9375,99463.2,0.0,130608.33389
6850,89,1663680,1736340,72660,102675.945312,175202.4,1248225.34869,664627.663958
2377,1,876540,1447140,570600,522750.34375,600492.0,1381275.25903,1234830.93644
9010,13,2491860,2525940,34080,44341.3398438,30793.2,0.0,63224.2220397
6432,151,2922300,3643800,721500,716145.6875,702235.2,1006671.04401,864064.183936
898,118,161400,459900,298500,318310.78125,314908.8,518397.537781,813185.384292
1614,66,1480260,4817700,3337440,3253376.5,3348734.4,4010963.33643,3597743.34848
7212,4,1326000,1326000,0,0.0,23462.4,19679.1268921,41385.1086178
5997,76,5042220,7552500,2510280,2512218.0,2512023.6,2185379.67828,2405127.32282
2053,83,1341780,1818000,476220,477505.03125,473799.6,608090.237244,506089.754706
7472,75,5740260,6135000,394740,346255.0,288600.0,420518.681824,225023.004055
7511,219,2598480,3797940,1199460,1228032.25,1202917.2,1624934.00903,1408589.35663
1020,131,171240,6825900,6654660,6394339.0,6207064.8,3938940.26166,3807826.84706
1075,106,997200,1023180,25980,0.0,35514.0,160897.680481,-74150.1791433
1404,130,94740,3083940,2989200,2990486.0,3030597.6,2001711.48767,3314299.15438
6183,31,38520,1374660,1336140,1336211.375,1359334.8,1312248.24164,845953.69329
1801,79,1604340,4151700,2547360,2560639.25,2523048.0,6733014776.25,2117062.06584
5682,142,4656540,7299960,2643420,2637604.0,2641358.4,12184803220.6,2792389.01724
2949,84,2489820,3714840,1225020,1178811.5,1203861.6,1376580.00409,1571945.39433
686,80,144900,338580,193680,120340.570312,822026.4,1634269.92206,2149331.31969
531,93,443280,1242300,799020,997091.5625,1549912.8,0.0,2738808.19349
1876,63,443160,6232860,5789700,5804636.5,5785047.6,5671276.59503,6049722.96058
2092,119,468960,2742780,2273820,2094710.125,1658971.2,1772900.70538,1909962.09796
4244,135,3215280,5649480,2434200,2433893.0,2435422.8,0.0,2541287.48868
2942,50,4500,35220,30720,25356.4550781,104068.8,42731.7426147,298082.697362
8099,30,111420,604800,493380,429518.9375,451936.8,1523132.271,1100506.26888
6453,155,2475300,3225180,749880,725053.4375,736443.6,659053.654297,844064.094675
4161,163,116040,548880,432840,706187.3125,549115.2,357212.348816,342764.99472
8251,13,1929000,2525940,596940,583910.6875,583471.2,177474.321472,277294.497067
7078,167,124080,534900,410820,466847.9375,458096.4,339567.353882,622977.677316
4485,199,742740,975720,232980,237678.515625,218876.4,0.0,22052.3345001
3771,203,865260,1897500,1032240,1045070.75,1027120.8,0.0,1073096.44892
524,142,279360,7299960,7020600,7390705.0,6957692.4,6375999.42328,5864253.44247
2013,102,86640,3198240,3111600,3260426.0,3002692.8,4603021.4906,3694023.96538
7960,11,1451340,1777560,326220,321419.03125,325058.4,401229.085083,731772.592341
9036,42,946680,953340,6660,54607.5585938,133798.8,265313.877869,371292.114952
3322,198,34500,708660,674160,694100.625,664130.4,688780.793762,1136406.21911
8001,18,1386960,1779540,392580,393759.75,409112.4,22473406711.2,275657.999285
5794,169,808260,2190660,1382400,1273718.75,1324146.0,951202.406067,1454543.30932
8373,212,49860,204240,154380,134165.96875,190669.2,0.0,-343597.274035
4998,71,3585120,3996240,411120,421226.59375,409822.8,0.0,301139.305765
7865,13,1674120,2525940,851820,845717.25,830710.8,982840.571716,850280.199021
7094,167,129840,534900,405060,385307.625,405016.8,0.0,179008.940879
8335,209,1075080,1091400,16320,33958.6484375,20522.4,1249699.96143,848911.782808
6148,26,9840,2036760,2026920,2225818.5,2123640.0,2542322.00128,2003278.8018
3559,137,159540,243720,84180,0.0,218092.8,0.0,-395441.645523
3334,130,1840140,3083940,1243800,1200665.375,1236778.8,296243.375,742758.862528
3807,98,3258180,7319880,4061700,4054319.0,4021159.2,18993833802.4,4168819.8072
8809,160,1422240,1564260,142020,136583.828125,135496.8,337427.36322,317367.508011
5720,57,168780,2756640,2587860,2607456.25,2363100.0,3015644.81726,2468413.12146
4229,107,1355400,4991760,3636360,3687327.75,3619195.2,4351248.69006,3920124.49137
2909,67,2612640,3120480,507840,519196.4375,494322.0,135051.24939,925187.672453
8363,212,42900,204240,161340,378198.21875,234904.8,0.0,-207143.942272
923,76,754920,7552500,6797580,6782925.0,6795618.0,7348467.98364,7038043.0722
4411,71,3123960,3996240,872280,987300.8125,928954.8,0.0,1228526.75537
4657,63,2803020,6232860,3429840,3370777.75,3405394.8,2576908.04193,3451867.38455
1763,56,1149240,6361440,5212200,5132151.0,4255458.0,4607955.12085,4092155.45438
5658,213,1368780,3206820,1838040,1886203.0,1864524.0,1543437.93469,1967059.53161
433,87,423000,1090800,667800,853586.1875,976981.2,1838001.81891,2394768.7116
1343,1,14340,1447140,1432800,2286521.0,2476242.0,0.0,1725016.91349
3963,203,1121640,1897500,775860,781282.75,829288.8,0.0,594873.639121
4890,107,1871880,4991760,3119880,3094094.5,3059354.4,3692898.31805,3269165.90966
5295,113,3188460,3646740,458280,484964.0,377912.4,722372.814331,939248.458999
5556,98,4590180,7319880,2729700,2738660.5,2726822.4,2448279.63892,2763279.93489
5454,169,602880,2190660,1587780,1509603.75,1578002.4,0.0,1457622.61674
6490,172,169200,1443960,1274760,1353033.25,1143104.4,716511.019043,745338.434796
4114,96,1897500,2123400,225900,298561.59375,247962.0,544952.301514,288714.163736
3347,72,2385960,2385960,0,0.0,31560.0,0.0,-60429.6460554
6310,141,5330820,7406100,2075280,1927023.5,2003101.2,8818228374.1,2448997.4005
1577,82,921360,2195880,1274520,1210700.5,1429413.6,722915.666382,1609823.68677
6260,26,93660,2036760,1943100,1969012.25,1954910.4,2604371.75439,2445335.1091
7509,157,1993260,1993260,0,132483.53125,99858.0,574442.541321,-69112.9950821
4299,133,2530500,6181200,3650700,3600127.0,3675242.4,3693479.02246,3849520.03599
5119,141,4264200,7406100,3141900,3141629.25,3142032.0,2903097.17572,3069301.42734
9078,9,18660,18660,0,737493.9375,1397032.8,2452144.93201,1958505.5117
5795,103,4669020,4719960,50940,57344.21875,56031.6,0.0,184479.264301
5492,19,406860,608940,202080,403426.5,439444.8,1555589.84747,695841.227085
4477,199,739020,975720,236700,220959.015625,228280.8,173437.851074,17831.5955339
2777,92,127320,613860,486540,496404.40625,760813.2,1414847712.11,519956.708316
8310,26,1805160,2036760,231600,231023.34375,205530.0,778870.246765,214018.571678
1970,133,551760,6181200,5629440,5627915.0,5522726.4,6038725.81238,5164252.81575
6729,5,242700,748200,505500,559149.3125,561664.8,415176.586792,375847.826473
3128,151,295980,3643800,3347820,3293475.75,2503278.0,1448419.04022,1531744.9244
7965,6,123120,133560,10440,304785.6875,251414.4,1711479.39294,1414944.42232
5167,157,59160,1993260,1934100,1852282.875,1749466.8,860749.652832,834071.667062
6553,64,5032200,6845160,1812960,1794801.5,1706829.6,1799075.13641,1750735.70648
8999,206,1998360,2086740,88380,18718.1601562,73387.2,0.0,33165.2358247
1619,145,68580,586680,518100,524292.0625,822537.6,1361850.73553,1556737.59995
3409,137,64320,243720,179400,180039.359375,278644.8,306245.494995,455802.775405
8867,188,4321560,4327560,6000,69636.453125,30103.2,0.0,19425.4753685
7649,63,5228700,6232860,1004160,988914.5,990560.4,317646977.449,546917.738792
1679,110,1466700,5579400,4112700,4125257.5,4121206.8,3893514.92114,3545990.61656
1235,117,30180,1144740,1114560,1512357.5,1247434.8,3105021.92999,1916177.43638
7623,15,887340,1822860,935520,917507.5,923215.2,1166522.44263,978887.404293
2315,83,1527060,1818000,290940,307985.78125,293944.8,0.0,285038.040579
4899,142,4041360,7299960,3258600,3249220.0,3234886.8,3262614.96094,3278778.10204
9022,36,42960,129360,86400,127842.0,552840.0,929720.59436,1187141.22602
5798,63,3618840,6232860,2614020,2663113.75,2617192.8,0.0,2858915.29514
2832,158,260280,2044680,1784400,2129798.5,2113045.2,1648866.22571,2125437.11626
3012,67,2683020,3120480,437460,344304.625,416857.2,167934.311035,709165.001637
954,144,239400,1807260,1567860,1515958.0,1434564.0,2539655.75238,2202284.80739
5814,63,3638520,6232860,2594340,2587655.75,2610422.4,0.0,2813043.08851
8613,30,570420,604800,34380,87912.8828125,52624.8,548956.636963,-254272.405057
8619,196,3052500,3281700,229200,227871.875,223521.6,0.0,260974.591806
8300,14,1067700,1327560,259860,276340.46875,224151.6,668955.406799,380444.652059
8759,152,3680160,3766500,86340,72420.125,164282.4,0.0,250151.96089
7523,176,1206240,1462860,256620,190939.609375,331099.2,309886.665527,-414833.713622
3598,111,3266400,3974400,708000,688224.8125,701594.4,0.0,389175.988926
2256,108,844140,3191940,2347800,2377835.25,2347929.6,2372327.84747,2629099.04765
1143,83,571380,1818000,1246620,1197223.0,1119583.2,1779319.05328,1281137.59757
902,144,182040,1807260,1625220,1633073.875,1598188.8,1705432.20856,1657730.79184
4027,203,1153500,1897500,744000,731655.375,742120.8,865078.982727,665242.942285
3661,61,3322140,6225300,2903160,2888786.25,2887971.6,3327620.8689,2963503.85291
2230,108,808500,3191940,2383440,2369648.5,2366184.0,2665565.52869,2467190.0074
5446,107,2336520,4991760,2655240,2663607.5,2373103.2,2758555.86005,2673158.65893
8661,63,6030540,6232860,202320,198435.296875,192652.8,97735795.1946,290955.250249
5359,210,94920,1118160,1023240,1217538.375,1093082.4,262864.787598,513017.396131
6297,31,125100,1374660,1249560,1241399.625,1227120.0,1449948.72638,1626593.03084
8716,65,7372800,7544400,171600,127039.609375,81486.0,85674.7922974,42602.0160074
3158,173,445680,3215700,2770020,2782426.5,2768380.8,3131039.53986,2517353.27272
5236,180,1194840,3322080,2127240,2159451.0,2052696.0,1477697.08148,2037027.52142
4737,186,328380,3636240,3307860,3439691.5,3173863.2,3811617.05426,2930502.34365
2943,96,828300,2123400,1295100,1297345.875,1303569.6,1328339.99963,1232812.38552
5232,20,35160,39660,4500,867049.6875,744138.0,3333642965.88,1196614.70359
5827,220,147660,2714040,2566380,2472936.5,2401316.4,2400475.00781,2501995.02054
7019,18,631500,1779540,1148040,1146229.375,1150548.0,1237854.00354,1193912.50515
8192,14,852000,1327560,475560,619881.5625,441806.4,0.0,593929.06352
6066,204,129300,2567700,2438400,2413221.5,2439644.4,3005762.52051,3147088.69021
850,103,459540,4719960,4260420,3761173.75,3814717.2,4914533.34845,3958429.38437
3197,173,465660,3215700,2750040,2746609.5,2750125.2,2095722.21576,2649761.56146
1593,142,1194360,7299960,6105600,6041372.5,6122840.4,4888401.6767,5904038.09154
2733,165,44940,1262880,1217940,1271379.125,1128901.2,0.0,804033.285356
7617,15,884820,1822860,938040,936660.75,904066.8,79466.005249,575991.861177
4577,213,563280,3206820,2643540,2668005.75,2652022.8,3166824.7594,2963826.36211
3540,84,3033540,3714840,681300,686932.0,677611.2,180100.85675,672117.081456
1316,60,1118400,7401300,6282900,5530608.5,5190367.2,5370626.71063,4664098.86466
4796,142,3985980,7299960,3313980,3241890.75,3213459.6,2676902.34308,3286370.50938
905,144,182400,1807260,1624860,1710409.25,1574344.8,1375293.32013,1554212.35216
2457,156,423780,2639280,2215500,2415459.5,2245734.0,2825190.21997,3218723.46422
6830,204,923040,2567700,1644660,1563255.125,1629472.8,2206931.04431,1984487.79106
2495,144,1740300,1807260,66960,78982.6640625,68119.2,0.0,355546.458386
1711,82,1028880,2195880,1167000,1051931.5,1826635.2,1323591.6225,1648278.27154
7744,8,361680,615060,253380,249569.328125,215583.6,0.0,-528151.112827
6609,208,73140,1620480,1547340,1941297.25,1562942.4,2560945.06873,2061371.12015
8150,13,1843320,2525940,682620,671234.5625,680484.0,0.0,917817.470902
1526,122,547200,861720,314520,310309.78125,308614.8,0.0,261587.502866
5422,98,4510980,7319880,2808900,2855766.0,2860467.6,3042171.81641,3028839.07156
8725,37,557220,736020,178800,147342.328125,172257.6,0.0,126119.716942
7043,195,120120,393120,273000,342908.3125,372447.6,0.0,303981.833886
8863,13,2426460,2525940,99480,106768.117188,101485.2,0.0,33683.259907
4699,71,3408480,3996240,587760,588079.3125,589663.2,29349819739.8,617464.555982
6014,13,31680,2525940,2494260,2422908.0,2271942.0,1574245.66168,1074902.63806
2629,98,2181180,7319880,5138700,5143564.0,5141434.8,5426992.94354,5261369.85522
3621,188,76500,4327560,4251060,3731736.5,2595896.4,1924825.8692,1968415.91465
3690,116,117660,786600,668940,768287.5625,771140.4,1457188.00641,1352416.54456
7731,13,1586400,2525940,939540,900235.4375,937244.4,564718.279663,1040382.98041
3893,71,2800980,3996240,1195260,1175477.75,1168059.6,2810381.67059,1071119.13222
3391,155,11580,3225180,3213600,2556255.5,2930523.6,1219281.64264,1581120.31665
3595,116,47760,786600,738840,813109.8125,689967.6,704947.991638,872169.574429
25,111,46800,3974400,3927600,3857550.5,3752766.0,2636081.80994,3205939.36015
1501,146,1351020,6670800,5319780,5285457.0,5317716.0,4635317.72455,4942713.40481
5629,146,4852800,6670800,1818000,1741976.625,1904146.8,18992051472.8,1922193.44796
1160,76,1095840,7552500,6456660,6458599.0,6456860.4,7328946.73541,6231970.10966
6421,155,2451660,3225180,773520,782695.6875,788095.2,886711.716431,423868.101241
5395,146,4708680,6670800,1962120,1960834.625,1965351.6,1764120.21521,1984272.7237
938,62,13920,3674460,3660540,3767829.5,3681781.2,5791130.79413,5202730.45908
3256,161,597300,1955580,1358280,1339745.125,1087035.6,815169.496033,1524435.76596
7367,167,276600,534900,258300,276203.28125,256840.8,404274.087219,172496.85081
5661,57,137760,2756640,2618880,2685582.25,2588054.4,2931549.78998,2519225.24978
3167,23,904920,1894920,990000,971383.875,964704.0,1978288.33038,1261454.46074
3370,173,600060,3215700,2615640,2588383.0,2623693.2,1762561.78992,1678937.32403
8577,159,2476980,2480580,3600,0.0,68065.2,0.0,-1282772.38593
2783,98,2306040,7319880,5013840,4958199.5,4853565.6,4890873.3175,4975445.29353
4578,47,0,31200,31200,144353.671875,586070.4,1443657.11432,1329018.57166
3052,201,53040,1645440,1592400,1596351.5,1680819.6,2745003.56177,2098724.94581
5457,24,17340,1547520,1530180,1756939.375,1799377.2,2096436.13403,1430625.5286
6390,218,1922100,1974480,52380,89362.78125,262166.4,0.0,-561825.441534
1604,104,592500,935100,342600,375025.40625,649365.6,1904962746.68,419533.828524
7692,220,1788840,2714040,925200,902335.1875,932703.6,1503686.47571,711851.31619
6174,63,4024620,6232860,2208240,2205650.0,2207142.0,29901808.9086,2258338.62918
263,138,251280,1785600,1534320,1435736.75,1444791.6,2174197.43408,2293940.03976
5570,142,4575780,7299960,2724180,2682285.5,2645757.6,0.0,2953884.4026
111,120,105240,576000,470760,512076.28125,1138366.8,2421850.79889,1937624.64942
7514,176,1201740,1462860,261120,237288.40625,240139.2,11081.9017944,-425520.422048
5832,102,3198240,3198240,0,0.0,334189.2,83029.2600098,307564.372603
4336,168,4140,438000,433860,2056853.625,1918826.4,1413724.12036,1603405.52476
2869,67,2600340,3120480,520140,473423.34375,523934.4,30642.2492065,788170.865797
3461,137,78120,243720,165600,241421.578125,241524.0,460535.095154,311110.8101
641,100,449640,919500,469860,461297.71875,623175.6,1841701.04584,1570021.91963
49,146,3180,6670800,6667620,7140908.5,6165604.8,3588086.7821,3645981.91055
6622,13,616920,2525940,1909020,1805442.5,1839814.8,1977066.51752,1686317.02317
7554,188,3343200,4327560,984360,1027147.625,1063418.4,170975.78772,762938.965841
5300,134,3203400,3656580,453180,446396.4375,477996.0,705966.285583,306433.078307
3140,156,1028100,2639280,1611180,1534850.5,1628043.6,1369108.71442,1515001.8263
7130,213,2601360,3206820,605460,618959.5625,610809.6,0.0,618456.267135
8020,63,5483340,6232860,749520,735069.3125,740565.6,0.0,769097.303045
506,60,373020,7401300,7028280,6948217.5,5660132.4,932100.549988,4417285.5529
1100,106,1023180,1023180,0,48406.6835938,137359.2,333935.77771,-148878.713169
67,146,39600,6670800,6631200,6299224.5,6331214.4,5003775.78033,4389969.76311
7401,27,118260,402780,284520,417307.71875,312963.6,1142273.27747,1277661.00295
8567,139,84360,273900,189540,198709.6875,141802.8,0.0,-135303.366302
5671,193,79800,187200,107400,894726.25,1319464.8,0.0,-212044.497593
1140,104,266520,935100,668580,708820.5625,1388007.6,3426897.66064,4067687.36656
2253,77,950700,3257040,2306340,2369156.0,2540820.0,3094766.20477,2586870.9749
7980,25,1333860,1951380,617520,617899.75,595180.8,0.0,530684.439879
5179,20,0,39660,39660,0.0,241441.2,1413732.21942,1122347.47222
6710,174,663360,1300440,637080,633526.5,610514.4,603091.536743,266408.960052
2854,108,1373460,3191940,1818480,1815092.75,1802457.6,0.0,1851512.4414
7348,178,31740,904200,872460,862768.4375,878930.4,250100.069946,419819.578609
4898,107,1873200,4991760,3118560,3130481.25,3068578.8,3880616.54138,3156300.82839
7152,213,2609340,3206820,597480,589559.625,596010.0,867572.604858,662643.123502
4295,63,2468100,6232860,3764760,3814138.25,3640990.8,0.0,3812948.73284
6539,61,5671200,6225300,554100,669102.9375,586843.2,9874050257.94,813286.885729
2823,108,1361340,3191940,1830600,1858052.375,1874034.0,1626870.2287,1840915.17012
3237,192,298200,4648740,4350540,4363495.0,4348081.2,4314072.5769,3780129.74052
6165,131,4611060,6825900,2214840,2248515.0,2120144.4,2076592.86029,2167880.04145
4164,153,1413360,1618560,205200,210723.59375,208760.4,488930.804626,1277647.46249
4666,186,271620,3636240,3364620,3491051.25,3256656.0,3503354.68695,2989804.01721
7139,220,1297440,2714040,1416600,1415399.5,1418172.0,1968029.18555,1647121.1526
7113,167,134220,534900,400680,418697.1875,400747.2,52657.3001099,287498.434938
5607,159,0,2480580,2480580,1485989.125,1718638.8,1412390.04126,1395685.2529
7823,131,5966700,6825900,859200,854802.5,857694.0,1052385.94562,1056067.24204
1980,56,1296000,6361440,5065440,4468108.5,4933203.6,4429312.87714,3609375.33843
6687,204,681900,2567700,1885800,1786203.0,1879741.2,1846675.04486,2080435.35263
387,128,346140,346200,60,400824.9375,423331.2,0.0,-479476.962317
6768,46,1869420,2027040,157620,164911.078125,197834.4,439095.46637,-21084.8960634
7169,14,68400,1327560,1259160,1245504.5,1171311.6,2320921755.38,1136858.54764
2088,102,121980,3198240,3076260,3086929.75,3102114.0,3383506.78625,3174209.51349
7237,14,121680,1327560,1205880,1203196.5,1117998.0,0.0,1171239.67689
2824,0,205380,1560960,1355580,2583667.25,2673606.0,2264019.69177,2263300.28568
642,124,543720,754200,210480,262597.5625,289380.0,0.0,-1243301.64326
1169,105,1083660,1314480,230820,428415.03125,259453.2,67047.6262207,-329148.42262
8447,196,2944080,3281700,337620,358894.9375,346768.8,1457774.27472,308052.672748
8042,183,285000,445560,160560,45972.2890625,171782.4,0.0,-279431.537657
4509,71,3191760,3996240,804480,821210.9375,798931.2,0.0,985710.828497
8257,3,841980,1055580,213600,284323.28125,134288.4,0.0,-285301.210453
3439,155,26700,3225180,3198480,3048901.0,3109604.4,2562976.27515,3009872.0913
5507,24,47940,1547520,1499580,1420381.0,1460061.6,2668394.03406,2864641.78386
3037,114,145380,1201080,1055700,1070726.75,1373121.6,2993690.01886,2313985.08027
4835,142,4003080,7299960,3296880,3296174.5,3298257.6,12744110749.4,3241112.13731
2589,130,1179900,3083940,1904040,2324963.0,1785802.8,552163.717896,1534543.70708
70,68,111600,262800,151200,394452.59375,531254.4,3006635.80835,2650210.37939
7908,220,1914420,2714040,799620,846773.875,803167.2,241747.603394,438172.197942
6842,5,441540,748200,306660,308206.875,327344.4,0.0,278190.480722
1328,72,599160,2385960,1786800,1669809.5,1681498.8,3210674.78693,2418323.952
4862,168,434400,438000,3600,3025.30175781,47798.4,389231.766907,512622.654681
3853,116,358200,786600,428400,380776.5625,444326.4,682675.039673,739173.329473
3912,71,2821680,3996240,1174560,1277606.375,1238931.6,0.0,1394772.86806
2181,94,201000,534480,333480,330534.34375,420043.2,630205.85321,1519991.89793
4483,199,742260,975720,233460,241022.578125,223010.4,195393.052734,22257.8913886
2397,156,281280,2639280,2358000,2232738.0,2415439.2,2027845.4024,3099445.8114
7192,219,2383320,3797940,1414620,1379590.125,1403136.0,1991160.77124,1561165.38893
3048,192,13980,4648740,4634760,4751439.0,4593036.0,4018688.3797,3639095.97889
3449,96,1310940,2123400,812460,777827.75,826717.2,815658.618469,871991.480273
2831,63,1229280,6232860,5003580,5031856.0,5009125.2,0.0,4834067.20159
8051,211,38340,87180,48840,273031.96875,236629.2,0.0,161428.616177
2499,102,549840,3198240,2648400,2669319.0,2239380.0,2834740.69604,2495438.61784
6107,162,2727960,4836120,2108160,2060329.75,2138900.4,2114764.36829,2535937.39616
5517,10,0,979740,979740,1676529.625,1444539.6,2641998.10571,1754128.47774
3036,162,116100,4836120,4720020,4666197.0,4700530.8,4677607.58276,3959636.90869
5320,63,3184920,6232860,3047940,3000713.5,3077239.2,2273744.66235,2960424.65777
6903,18,569340,1779540,1210200,1207846.375,1192536.0,1705595.82111,1278269.99685
1161,72,454260,2385960,1931700,1922661.25,1804590.0,15346033220.6,2454391.4696
7384,178,61800,904200,842400,743192.0625,851935.2,0.0,-443039.277483
3454,114,563100,1201080,637980,561030.625,627571.2,1674211.98029,765193.044928
701,124,603000,754200,151200,204992.296875,265873.2,905657.398376,754749.339657
4854,110,4233600,5579400,1345800,1273441.375,1309434.0,1452054.02362,1475628.62851
456,106,430440,1023180,592740,390468.1875,1450749.6,2319845.11145,976850.558565
3296,92,613680,613860,180,10506.5742188,246819.6,0.0,152386.129407
2731,135,1920540,5649480,3728940,3581629.5,3679476.0,3757359.70563,3567493.56996
8769,13,2365560,2525940,160380,343181.8125,279942.0,1373518.02399,307129.195815
2646,156,533160,2639280,2106120,1991713.375,2146116.0,1630486.5069,1842407.85954
8763,25,1951380,1951380,0,1258922.875,170973.6,1397735.2052,1231630.02316
3869,198,541440,708660,167220,122029.492188,195902.4,0.0,30015.1172352
4909,90,89280,1532940,1443660,1418382.625,1392727.2,1359611.33124,1165668.67413
5975,10,267000,979740,712740,660690.9375,708488.4,907854.82373,464027.168517
9030,206,2020140,2086740,66600,20675.9277344,70294.8,321880.346375,441479.769638
157,110,90900,5579400,5488500,5571525.0,4966185.6,4775682.96234,4135349.12282
5948,204,12420,2567700,2555280,1732958.625,2227478.4,2162922.29199,1530388.89687
7595,27,379140,402780,23640,20531.078125,28392.0,19271.4415894,430781.296294
1623,110,1425420,5579400,4153980,4119679.0,4155642.0,3031687.81903,3160781.55985
202,128,178740,346200,167460,165087.8125,357772.8,0.0,247070.369051
8347,224,260880,648060,387180,472678.90625,317068.8,0.0,-333764.291692
4467,186,16800,3636240,3619440,3769527.5,3044121.6,1361512.4281,1395410.06248
4373,215,1445460,1851720,406260,433235.40625,373383.6,1167155.76654,4378.87644784
144,106,45660,1023180,977520,1050565.25,1084101.6,1826650047.13,1757625.23968
94,111,119820,3974400,3854580,3632358.25,3873708.0,4318139.67993,3835595.39445
6176,210,889860,1118160,228300,251536.359375,241742.4,235810.582214,-56487.7991604
4339,203,1351500,1897500,546000,378183.21875,511485.6,4039556506.95,380744.688185
5281,214,8460,341760,333300,639958.6875,863048.4,0.0,-460848.107241
3364,130,1866780,3083940,1217160,1213569.625,1222148.4,654298.536682,890048.280396
8617,37,493200,736020,242820,217537.40625,239792.4,314728.345459,390072.263825
2921,84,2467980,3714840,1246860,1234155.125,1199510.4,2059244.42413,1829364.04494
8923,219,3737340,3797940,60600,31352.1484375,67093.2,458788.971375,158284.11872
2805,114,13080,1201080,1188000,1184809.625,1374421.2,2085444.31494,1908071.24483
1321,140,1110600,1300140,189540,202288.46875,303499.2,1099006.04004,1192730.44765
7283,204,1187700,2567700,1380000,1190543.75,1177546.8,1058610.37311,1360368.75039
8765,13,2362680,2525940,163260,331616.28125,284793.6,765123.329895,384364.499528
7946,185,441420,441420,0,0.0,44523.6,48740.0666504,-68439.4800451
1044,131,190980,6825900,6634920,6759449.0,6437629.2,3719471.03699,4026380.77647
1340,117,115560,1144740,1029180,959877.375,1164438.0,3641806.75452,2252392.39416
622,88,73800,555360,481560,754208.6875,2272406.4,1963974.08704,1899430.40789
6005,13,22260,2525940,2503680,2185176.0,2095419.6,1224468.09357,980117.287454
5962,204,20280,2567700,2547420,2260976.25,2500338.0,2874959.97211,2787215.97818
967,144,245400,1807260,1561860,1165083.375,1455978.0,2431999.46454,2060553.69078
1165,72,459840,2385960,1926120,1763060.375,1852098.0,943430.090942,1693893.55269
6678,57,946740,2756640,1809900,1907386.75,1875702.0,0.0,1712324.1486
515,91,278940,1030200,751260,749121.8125,739358.4,738316.967407,1293470.05707
1958,98,1593660,7319880,5726220,5650923.0,5510744.4,4980111.26605,5199110.25769
6712,75,5134320,6135000,1000680,998724.625,971214.0,1003758.04028,994114.399086
7862,185,397440,441420,43980,38887.9453125,49471.2,103395.742126,-9031.81420063
7890,28,32400,493260,460860,491744.59375,465064.8,522484.693542,1072344.15972
1419,113,12180,3646740,3634560,4635468.5,4119903.6,3543668.26477,2968603.80227
4826,156,2354280,2639280,285000,287429.5,283353.6,0.0,295988.997873
2897,161,197520,1955580,1758060,1759058.125,1701111.6,1692578.71057,1960771.85169
8971,160,1515960,1564260,48300,65316.6484375,45248.4,0.0,66673.6309456
591,127,20520,599940,579420,568857.9375,623900.4,1102976.46277,1636483.33871
679,83,86400,1818000,1731600,2065686.375,1426378.8,1301331.64227,1893454.73744
1918,134,507120,3656580,3149460,3074696.75,3108626.4,2885363.8988,2327132.351
5383,196,418560,3281700,2863140,2864769.0,2774306.4,1639674.41571,2133658.32532
328,141,124500,7406100,7281600,7230524.5,6980726.4,5123896.92676,5255186.68066
5149,131,3666420,6825900,3159480,3040228.0,3166030.8,2739817.22516,3025193.06078
8738,220,2575800,2714040,138240,131387.546875,130002.0,178436.416809,101324.118373
4253,163,185820,548880,363060,410162.375,366279.6,749357.99939,495709.882006
544,84,395160,3714840,3319680,3579913.25,3257442.0,4859463.13623,4561951.77654
7168,135,5573280,5649480,76200,72346.96875,84624.0,0.0,364558.341635
6263,63,4095060,6232860,2137800,2135552.5,2135846.4,201767907.999,2240064.16295
4944,125,3792060,3969060,177000,336616.03125,202693.2,15494363366.4,746644.141487
8028,209,748800,1091400,342600,325478.0,312451.2,1273009.67358,1460219.65902
9061,76,7550700,7552500,1800,0.0,1632.0,92997.5668335,122835.585509
7788,63,5342940,6232860,889920,884023.3125,888294.0,146790988.292,839662.11881
6894,18,558000,1779540,1221540,1242598.5,1202743.2,1445160.52911,1043218.81111
5990,154,86400,115500,29100,419070.25,599791.2,1739567.48846,1992874.68703
3899,141,3416580,7406100,3989520,3985381.0,3990388.8,3951652.00977,3894073.41091
5421,63,3398940,6232860,2833920,2810773.0,2831868.0,3502418.47614,2984989.29822
1081,88,555360,555360,0,27752.7714844,418849.2,1366194.97046,1515272.66949
606,82,68040,2195880,2127840,2126414.0,2145904.8,2507583.00562,2000478.74411
1440,63,0,6232860,6232860,5599762.0,5229250.8,3721314.22516,3382606.05794
6970,48,59040,156420,97380,108880.875,100654.8,1329194.41895,854621.460055
41,51,0,280800,280800,312475.53125,858297.6,1165532.78149,1447884.49816
2893,130,1381560,3083940,1702380,1717939.0,1692171.6,0.0,2479305.73478
3340,23,1027320,1894920,867600,864872.4375,857404.8,8011813221.47,533808.53516
4269,73,1303500,1303500,0,263427.25,289675.2,0.0,-251402.858925
5753,89,642900,1736340,1093440,918756.75,582355.2,251114.760681,470276.949133
7838,196,2429820,3281700,851880,814240.6875,847441.2,650263.340393,899978.891087
6455,155,2475600,3225180,749580,720921.5,745192.8,780668.295715,995921.192442
3182,192,245160,4648740,4403580,4347962.0,4504125.6,4402573.66327,4145069.59246
1061,86,225180,3519180,3294000,3096947.5,3308001.6,3556431.39484,3422306.86696
7156,167,156420,534900,378480,367236.125,379105.2,0.0,193675.900437
1722,135,1106880,5649480,4542600,4067230.25,3277782.0,1344452.95612,1556923.73804
6520,10,813480,979740,166260,153359.65625,171418.8,192171.140259,-64639.7738671
4839,169,101400,2190660,2089260,1930644.125,2060174.4,1910423.81848,2023256.40756
231,51,166200,280800,114600,862556.4375,622083.6,564861.751892,1114979.18609
8264,13,1962600,2525940,563340,545405.6875,540061.2,21062562453.5,382705.316893
1594,142,1194360,7299960,6105600,6030207.5,6130888.8,5080411.18018,5848761.71445
3028,162,103500,4836120,4732620,4677318.5,4735920.0,4229828.76379,3941597.39333
158,79,4500,4151700,4147200,4144450.5,3334242.0,2733264.1441,2877086.22207
5503,102,2999400,3198240,198840,180334.90625,373850.4,0.0,627047.546638
1948,98,1589160,7319880,5730720,5638368.5,5483746.8,5546781.9129,5489195.07591
2807,92,160860,613860,453000,386133.75,738308.4,2064382758.22,256777.656097
8532,40,27120,163800,136680,143071.421875,143605.2,905677.969238,1065313.43844
1348,67,1292580,3120480,1827900,1651880.25,1870300.8,3919963.12744,2970183.66163
3129,130,1694880,3083940,1389060,1321290.875,1424449.2,1739158.31647,1697799.18466
2488,98,2098560,7319880,5221320,5221940.5,5244109.2,1738721815.11,5156118.35477
7492,189,52260,308460,256200,465661.8125,337215.6,1279664.06818,1062925.09361
739,56,123060,6361440,6238380,5648151.0,3773065.2,4161822.81622,3664893.18462
6309,172,54360,1443960,1389600,1305685.5,1368108.0,1749674.34692,1191525.71244
8030,220,1994100,2714040,719940,718622.0625,717585.6,1169983.14551,553706.455112
210,141,26100,7406100,7380000,5829049.5,4189045.2,4712062.82953,4647001.38194
3496,86,2319780,3519180,1199400,1234471.625,1196058.0,2464031.29388,1786768.60577
1371,112,225420,1303440,1078020,884205.9375,1211808.0,670839.35437,1216479.34479
5073,156,2493420,2639280,145860,122428.5,133240.8,10359938489.6,-54379.6560117
8568,40,53580,163800,110220,130052.867188,139348.8,687866.72522,984153.129703
5592,217,523620,557700,34080,109432.617188,33244.8,0.0,431207.354129
7715,178,416940,904200,487260,244792.234375,258762.0,0.0,69095.5245328
7745,186,2776200,3636240,860040,886118.9375,895314.0,0.0,1296517.21916
5015,217,33660,557700,524040,615295.3125,514963.2,1941934.56604,2554629.33731
1674,146,1473060,6670800,5197740,5198133.0,5208776.4,5954731.69849,5636500.32269
1822,66,1760460,4817700,3057240,3082995.5,3005014.8,3607912.91357,3295815.61295
5469,210,283620,1118160,834540,951019.5625,888241.2,88950.1130981,240542.416546
8817,160,1432380,1564260,131880,120842.984375,134028.0,204175.818909,302834.057512
8934,196,3223620,3281700,58080,74871.125,55746.0,0.0,114191.801704
8488,14,1187520,1327560,140040,109120.976562,132788.4,283285.898743,185821.632626
255,99,3600,28560,24960,0.0,1316041.2,1759019.81049,2513161.57751
404,141,194400,7406100,7211700,7045245.0,7186339.2,7927473.06781,6016278.01199
4520,213,418380,3206820,2788440,2781335.75,2789536.8,3101305.26678,3558189.29365
135,146,86460,6670800,6584340,6477104.0,6533115.6,5008211.67963,4753475.1081
1735,79,1559700,4151700,2592000,2592322.0,2595738.0,2881850.59094,2620293.35083
8510,57,2513460,2756640,243180,251592.484375,278026.8,14751392078.6,138608.558905
5292,113,3184260,3646740,462480,426066.0,395030.4,667036.681824,484612.988317
7685,15,939540,1822860,883320,875370.875,879642.0,0.0,651156.047346
6122,63,3990720,6232860,2242140,2249861.0,2248905.6,0.0,2374875.17723
3483,148,1786860,1938900,152040,156787.234375,151845.6,733870.879211,217313.610024
4391,156,1982100,2639280,657180,665114.625,603367.2,1460195.25568,537139.115008
1946,98,1588980,7319880,5730900,5646395.5,5493154.8,5755173.73993,5597994.04569
5145,131,3662700,6825900,3163200,3169339.25,3170871.6,3227375.1134,3121932.94115
6728,13,683940,2525940,1842000,1825407.0,1798371.6,1996824.54932,1679152.55431
7525,64,5788440,6845160,1056720,1090655.125,964642.8,2151715.96545,1203745.71722
3876,203,1059420,1897500,838080,841440.0,832546.8,12741627293.2,814059.298318
8609,63,5995740,6232860,237120,243680.03125,242133.6,292570639.612,400322.780359
7919,170,20580,665160,644580,300321.3125,349244.4,76924.6160278,243484.430015
7564,27,349020,402780,53760,37648.3359375,70936.8,456846.643921,338947.581216
2325,156,190080,2639280,2449200,3101557.5,2447910.0,3693618.09393,3637343.90145
8207,13,1891560,2525940,634380,627060.6875,638056.8,638852.00354,324422.685144
3194,130,1733160,3083940,1350780,1359672.625,1359212.4,1410195.21301,1485703.37247
3412,137,65160,243720,178560,172809.0625,278192.4,645065.826416,317135.780535
7622,15,886800,1822860,936060,932429.5625,924289.2,675757.42627,757810.859103
4501,96,2123400,2123400,0,990.71661377,3396.0,604200.715393,320199.664302
5641,177,1626660,1713060,86400,43314.109375,209389.2,63656.8116455,-132390.693717
6111,220,492060,2714040,2221980,2174049.0,2243080.8,1457967.88354,2294017.5801
6821,13,883680,2525940,1642260,1619102.375,1647979.2,1811529.06519,1675913.2463
1441,113,28920,3646740,3617820,6107407.5,5822816.4,5384222.60913,4706389.31673
1859,138,1782000,1785600,3600,664.188598633,19328.4,0.0,-159259.66171
4268,73,1300800,1303500,2700,308318.78125,281838.0,0.0,133184.391527
2582,143,430260,1898460,1468200,1435896.375,1386213.6,1113640.67084,935556.009963
450,150,527400,626340,98940,87750.5703125,453153.6,168935.966248,9695.73387278
1103,77,0,3257040,3257040,3558753.5,3183943.2,3619244.7403,2555947.08219
1873,111,1835220,3974400,2139180,2180868.25,2224180.8,2228399.97015,2066531.08883
8220,196,2677320,3281700,604380,619158.8125,605742.0,0.0,170586.399336
7218,61,6225300,6225300,0,259.893188477,34851.6,74504.3757935,1866.65302533
5077,98,4155300,7319880,3164580,3125990.75,3033788.4,3504514.7193,2946869.77455
5549,63,3473340,6232860,2759520,2751530.25,2757986.4,2223560.36346,2701472.42319
8966,206,1986480,2086740,100260,0.0,100734.0,30282.6190186,196507.630198
4608,199,957840,975720,17880,114496.476562,71377.2,0.0,-166061.197303
8338,208,1561140,1620480,59340,41779.1054688,48972.0,0.0,45325.18536
3865,98,3307500,7319880,4012380,4059455.5,3898449.6,0.0,3954420.23923
1682,98,1270980,7319880,6048900,6075045.0,5888307.6,6468850.84802,6726408.46897
5245,20,39660,39660,0,990134.25,637659.6,3207092584.14,1207128.81941
602,56,35160,6361440,6326280,2806911.25,2577914.4,2109224.34375,2359801.7382
7021,213,2529060,3206820,677760,660423.75,661434.0,1035346.80164,555568.14774
4784,98,3997380,7319880,3322500,3226414.75,3099442.8,3460490.01672,3415021.75263
3767,73,856320,1303500,447180,441654.34375,456795.6,0.0,578964.542823
4986,213,803040,3206820,2403780,2311146.75,2403457.2,14708432151.5,2746385.46269
8405,13,2147160,2525940,378780,374094.625,364166.4,0.0,363733.790906
8026,26,1488720,2036760,548040,510205.3125,561133.2,534652.585266,448098.064305
454,52,382260,608400,226140,206066.703125,780895.2,0.0,506680.146981
2218,82,1478580,2195880,717300,772118.25,758858.4,1247570.48938,532029.642802
1054,72,341160,2385960,2044800,2107608.0,1901386.8,6284097638.16,2386727.74953
4837,90,47700,1532940,1485240,1394921.625,1358907.6,1421620.97662,969156.17037
8642,188,4193760,4327560,133800,126179.53125,155990.4,0.0,41588.7421426
5155,19,46080,608940,562860,660920.9375,779842.8,0.0,-78901.1779112
6565,46,1724160,2027040,302880,319179.09375,332124.0,15632846479.1,445847.233133
7290,164,41040,123600,82560,188387.953125,319287.6,0.0,-312964.375878
7711,141,6486000,7406100,920100,914844.125,919680.0,1368606.91187,843080.512776
3665,203,783720,1897500,1113780,1107465.5,1115773.2,4949355432.4,26171.6762778
8174,197,622020,626580,4560,61816.6601562,96423.6,653659.025208,887846.108837
6119,89,1039080,1736340,697260,693598.1875,829106.4,1533409.80347,930209.899951
863,131,7620,6825900,6818280,6472740.5,5651326.8,2735519.47559,2533127.69358
2261,117,888180,1144740,256560,344620.03125,194263.2,402919.647095,702487.303118
1628,123,13980,3545820,3531840,3203630.5,3617434.8,2556108.11334,2338343.8035
4656,168,313680,438000,124320,199061.84375,468223.2,891417.296936,306663.172144
55,109,10800,274500,263700,256640.734375,736912.8,2243476.39471,1715875.99324
4554,156,2074200,2639280,565080,567682.625,559885.2,293860.207642,596675.246703
5370,146,4673100,6670800,1997700,2036411.125,2065966.8,2255247.96002,1987942.26464
771,76,656760,7552500,6895740,6879912.5,6897124.8,6989072.39496,6622204.20191
1477,113,45300,3646740,3601440,5464184.0,5532630.0,4190113.15393,3653405.916
1904,115,643260,954000,310740,454253.75,540163.2,1616212.22076,1684405.30355
8943,13,2459400,2525940,66540,69535.5390625,71953.2,0.0,92726.3789764
4887,213,749580,3206820,2457240,2447486.75,2450629.2,2520677.64087,2716704.8358
7138,5,622620,748200,125580,106436.742188,116305.2,3975.56347656,-35752.8361048
5967,155,1967100,3225180,1258080,1210350.75,1165425.6,1180137.1214,625484.320566
731,53,353040,582540,229500,310715.53125,221978.4,184264.311279,851723.790037
3112,96,1086600,2123400,1036800,1058772.625,1183375.2,1169787.185,1133875.9709
7815,31,1374660,1374660,0,46415.5976562,51458.4,818230.239136,290650.210718
4643,141,3997200,7406100,3408900,3352177.0,3397519.2,3456848.5459,3264872.27092
7702,176,1454340,1462860,8520,48622.4960938,95013.6,319164.524597,-609391.27261
5367,216,226380,496500,270120,299410.75,543547.2,314867.970154,481278.415208
2198,142,1737960,7299960,5562000,5532478.5,5567143.2,6078734.07611,5258279.20031
5849,89,697860,1736340,1038480,885402.5,718219.2,1404616.24841,1069806.91566
2549,83,1814400,1818000,3600,298.22756958,9712.8,0.0,-35683.9241049
8061,209,768600,1091400,322800,339565.21875,293138.4,1213136.46808,1405632.0678
6774,191,1651020,1811280,160260,147303.609375,178407.6,0.0,176440.359034
90,111,115860,3974400,3858540,3606572.25,3896947.2,2730044.22119,3070639.66926
1031,86,90660,3519180,3428520,3450008.25,3428479.2,2676585.58569,3160180.41446
1277,122,379140,861720,482580,517575.4375,605150.4,424607.770264,782148.221825
1172,112,80340,1303440,1223100,1213837.25,1142221.2,889377.066467,1431006.82535
1617,61,1507920,6225300,4717380,4759291.5,4777143.6,0.0,4766361.3159
2014,126,960,496560,495600,577727.6875,802212.0,1934330.41479,1937979.8378
3188,142,2692980,7299960,4606980,4597500.5,4652420.4,4771577.45404,4557052.7709
1553,134,101820,3656580,3554760,3391426.75,3474592.8,3945243.07599,3987114.05083
836,66,777120,4817700,4040580,4111379.75,3994192.8,0.0,3809307.18334
2638,1,1153080,1447140,294060,145895.0,396960.0,0.0,179004.834145
1300,132,13440,1658640,1645200,1653355.125,1621084.8,2135936.6759,2194132.38027
5758,220,100440,2714040,2613600,2398581.25,2514621.6,2838333.4151,2125267.21456
3946,71,2848560,3996240,1147680,1121178.875,1157756.4,1544797.97473,1472443.42078
7690,76,6591540,7552500,960960,954683.6875,948758.4,9755596387.99,503475.342308
1119,112,41880,1303440,1261560,1421702.0,1310080.8,1571025.96509,1581831.24043
958,72,161460,2385960,2224500,2332051.5,2042320.8,3251691.5556,2439877.36643
7558,75,5913060,6135000,221940,516299.9375,780649.2,70226.5895386,-33272.3806921
1092,131,339840,6825900,6486060,6116441.5,6364119.6,3155794.67749,3845240.21674
8662,64,6781920,6845160,63240,57396.6015625,62616.0,151777.782654,130955.574708
8306,22,428820,810360,381540,342047.8125,327398.4,534818.556091,804208.477319
2518,108,1136940,3191940,2055000,2023791.25,2049163.2,1269866.2572,1708699.70047
4291,63,2465520,6232860,3767340,3798759.5,3641037.6,3011042.63708,3814053.60112
6029,13,43020,2525940,2482920,2335983.5,2077707.6,1555623.59833,1068010.04193
1453,60,1204800,7401300,6196500,6138259.0,5693756.4,4903103.81714,4883799.14222
3239,130,1779480,3083940,1304460,1351288.625,1326788.4,1671369.28461,1494144.14041
8077,211,61800,87180,25380,44353.8710938,74059.2,0.0,-110380.442497
5900,196,721320,3281700,2560380,2532900.0,2535988.8,5931839482.16,2260403.23051
1458,130,139740,3083940,2944200,2950845.0,2813208.0,2362743.5871,2875905.1663
6906,222,217800,1113000,895200,901881.4375,888470.4,132352.737915,294071.437412
3133,192,219240,4648740,4429500,4411518.5,4429564.8,5203685.4259,4784466.69141
6932,4,1177800,1326000,148200,152919.875,148980.0,0.0,94235.6749283
8375,207,192840,272580,79740,133240.15625,203905.2,0.0,-2217.96093802
3916,60,3426000,7401300,3975300,2780421.75,3441975.6,3925885.6178,3524683.94804
7665,183,41460,445560,404100,553753.5,494908.8,0.0,-479111.202693
1832,135,1171800,5649480,4477680,4027803.0,3775452.0,3573968.77802,2910806.62031
5926,4,176880,1326000,1149120,1157840.75,1146844.8,111247.55896,945308.919468
303,79,136320,4151700,4015380,3652199.5,3998763.6,5349665.88782,4564367.73684
5099,196,109560,3281700,3172140,3175561.25,2922082.8,2115174.19836,1383229.75959
2047,133,607800,6181200,5573400,5607034.5,5565500.4,5306963.28296,4870409.32009
4640,131,3388500,6825900,3437400,3366322.75,3430172.4,3048157.33319,3314657.8116
3205,142,2706720,7299960,4593240,4597459.5,4586259.6,3908087.0788,4495804.83934
8915,58,914940,992100,77160,54516.546875,72627.6,522241.677002,19155.8659773
8778,13,2366640,2525940,159300,176091.5,282321.6,0.0,-292542.476375
5307,196,222360,3281700,3059340,3105223.25,2757415.2,2109459.97687,1861870.63128
6781,204,844140,2567700,1723560,1785141.5,1709259.6,1956227.71802,1782998.46213
5122,187,267600,2496960,2229360,1545151.75,1670848.8,794692.709534,864591.118883
8008,18,1393140,1779540,386400,402939.59375,375934.8,1808649.65118,401466.813017
2147,145,577200,586680,9480,87688.6015625,96639.6,0.0,-440702.130178
3512,86,2331180,3519180,1188000,1137888.0,1169863.2,1087612.76257,1169747.30246
7036,160,41520,1564260,1522740,1163174.625,1340834.4,1031073.47607,1592142.43574
1365,132,61020,1658640,1597620,1818781.125,1113926.4,1892267.29761,1972081.68753
5843,63,3645540,6232860,2587320,2651792.25,2597319.6,0.0,2625694.96564
6382,220,674760,2714040,2039280,2018194.625,2061142.8,2277056.95984,1933864.94883
7006,204,1027320,2567700,1540380,1468341.5,1529797.2,1435889.94678,1356685.16889
3834,98,3286980,7319880,4032900,4019751.5,4020825.6,4267201.04089,4238344.6313
7063,31,747180,1374660,627480,572787.0,630496.8,718664.61615,520446.768305
2545,78,1814400,1818900,4500,10088.5712891,447476.4,0.0,74365.7859846
4328,203,1347900,1897500,549600,416008.15625,511628.4,11114439387.6,203541.539271
6986,151,3425820,3643800,217980,206884.90625,214131.6,0.0,266721.172148
4852,74,2976000,2979600,3600,0.0,47919.6,2537973.55444,2305332.13382
6226,162,2835660,4836120,2000460,1974003.125,1966251.6,1685212.34912,2214721.5435
2020,83,1325640,1818000,492360,453479.9375,500364.0,581111.490417,580616.160094
1951,83,1270440,1818000,547560,547263.625,541765.2,1399778.21924,509636.983107
164,146,125700,6670800,6545100,6482026.0,6404085.6,5878017.47858,5228101.31187
3960,114,1057140,1201080,143940,202511.4375,296409.6,498851.673828,469004.074457
7572,15,853500,1822860,969360,930245.5625,800920.8,0.0,563292.670671
8501,40,2880,163800,160920,859574.5,189132.0,308782.169922,489247.10842
3308,173,544800,3215700,2670900,2663445.0,2662764.0,2843992.12286,2130179.07945
8406,43,4500,4500,0,59908.75,138746.4,158032.359497,416353.199256
5591,57,82560,2756640,2674080,2710196.75,2610328.8,2693023.78137,2448420.61263
5711,10,133560,979740,846180,1015311.3125,1250151.6,1774236.94727,1170402.00558
4514,151,1332240,3643800,2311560,2333473.75,2250134.4,1753909.32843,2277808.65668
7846,6,51840,133560,81720,396121.34375,467694.0,1656766.58594,1689725.49229
8103,37,32460,736020,703560,571498.875,632016.0,1326708.36926,999344.968959
4055,184,673200,1800900,1127700,1117563.75,1041364.8,703036.360046,831612.540275
2424,83,1753200,1818000,64800,181356.453125,265015.2,0.0,-109046.650525
4418,135,3312840,5649480,2336640,2391571.0,2275500.0,2209226.36121,2336572.96443
8638,40,89760,163800,74040,125037.296875,113226.0,917801.952393,1394255.36834
7566,167,534900,534900,0,14702.4472656,163996.8,0.0,-471536.918168
455,79,382320,4151700,3769380,3730079.25,3725433.6,3299918.40735,3954148.37864
4024,135,3073380,5649480,2576100,2584346.25,2577328.8,1063481979.13,2814881.29279
3959,123,2161620,3545820,1384200,1404860.875,1320807.6,22473736862.1,1285452.00819
6402,18,97740,1779540,1681800,1603233.0,1462465.2,1489659.15625,1511833.44629
2795,79,2423700,4151700,1728000,1337209.125,1670852.4,1700434.01691,1660583.25437
5781,63,3614940,6232860,2617920,2644533.75,2618784.0,13074590237.8,2526043.04854
6255,131,4680300,6825900,2145600,2196284.25,2017382.4,1939657.19574,2250354.05518
9013,131,6798300,6825900,27600,30973.8613281,19796.4,0.0,13282.3772483
471,79,393600,4151700,3758100,3484555.25,3317707.2,2137739.64728,3789642.51489
6051,204,104700,2567700,2463000,2513687.5,2443538.4,3058538.22437,3106653.18996
7987,196,2516100,3281700,765600,739333.25,760177.2,53443.2480469,569278.494456
5866,169,845820,2190660,1344840,1340149.375,1346836.8,1716168.08917,1246667.94291
6952,5,515820,748200,232380,258995.53125,247833.6,283918.225647,314072.921491
5455,196,463920,3281700,2817780,2487435.0,2592036.0,2767047.68036,2038844.03136
630,56,41880,6361440,6319560,4820252.5,2816054.4,4480706.1568,3849565.55315
4294,131,3059040,6825900,3766860,3773741.5,3762720.0,3821785.22717,3727657.10297
8857,37,632460,736020,103560,117083.039062,125877.6,0.0,-54174.56941
736,118,59760,459900,400140,264953.8125,593554.8,1899778323.06,166217.597632
5589,217,523200,557700,34500,38499.7109375,32710.8,28030.8494873,349369.133352
3860,98,3297360,7319880,4022520,4052455.0,3970236.0,21007599874.5,4046293.0706
6482,196,1284900,3281700,1996800,1990538.375,1997640.0,0.0,2318305.49379
3852,184,537960,1800900,1262940,1266936.375,1119092.4,1565631.71014,1092931.29806
849,142,502080,7299960,6797880,6752831.5,6805645.2,7659099.06628,6632726.96989
807,75,103080,6135000,6031920,5759009.0,5883991.2,5280262.69312,4535465.3022
6348,220,665400,2714040,2048640,2053681.75,1987897.2,2132936.92969,2049269.63638
884,118,156180,459900,303720,348218.75,298124.4,1112906.42926,498193.755305
3520,86,2332980,3519180,1186200,1155379.75,1164643.2,1148110.37415,1587063.36255
1927,134,511980,3656580,3144600,3138729.5,3111907.2,2140849.96436,2339741.47544
5382,49,3942900,3991980,49080,41842.5703125,104614.8,0.0,115053.959472
2577,158,79320,2044680,1965360,1994999.75,1971786.0,2845710.66724,2690295.90355
3689,116,114720,786600,671880,796360.6875,776012.4,1652613.63477,1414771.90831
5154,69,2016300,2073180,56880,188813.65625,95376.0,195058.617065,-199754.825001
6100,155,2221800,3225180,1003380,1003286.75,1001737.2,1156292.88239,934460.765279
3389,71,2339640,3996240,1656600,1240107.375,1195150.8,294135.431091,-50762.7221899
1567,63,92520,6232860,6140340,6022066.5,6050444.4,5463797.01611,5057321.5257
8160,63,5563740,6232860,669120,670817.5625,661341.6,0.0,746282.583762
6980,31,701400,1374660,673260,691226.6875,669848.4,0.0,720686.589813
7454,8,24060,615060,591000,586197.1875,609090.0,0.0,5606.86679547
425,142,239340,7299960,7060620,7020245.0,7067113.2,5446659.29529,5550272.54926
7093,167,129780,534900,405120,400770.21875,405460.8,823772.847412,393344.873855
8558,139,82080,273900,191820,164635.421875,142402.8,0.0,-333384.173217
405,79,220080,4151700,3931620,3912904.25,3804378.0,5491954.99475,4873303.64466
6905,188,2831160,4327560,1496400,1535867.625,1544787.6,1782627.83807,1632400.70878
3151,73,429480,1303500,874020,807664.75,896247.6,1433144.11157,1010297.44652
4404,215,1457520,1851720,394200,323835.25,310909.2,0.0,-290473.667573
6578,63,4304040,6232860,1928820,1923801.125,1879126.8,5181357.78595,1937101.41956
1048,86,105780,3519180,3413400,3323577.25,3303958.8,2970704.1861,2987614.55041
539,76,505080,7552500,7047420,7060915.5,6778134.0,5467952.10364,6430731.6096
7922,15,1091820,1822860,731040,742007.125,742615.2,75167.6762085,755003.885445
5153,157,39000,1993260,1954260,1551012.25,1770852.0,272238.620056,728388.530375
5954,10,251160,979740,728580,812816.625,819273.6,796627.366089,532259.181497
5212,216,0,496500,496500,1126229.875,857719.2,2082826.45844,1723932.75641
2431,108,1098240,3191940,2093700,1971536.5,2068897.2,2099628.25067,2515516.75183
8731,162,4829760,4836120,6360,28491.5566406,189936.0,146053.748535,-43739.1259664
7042,195,117420,393120,275700,337056.3125,381562.8,0.0,305138.091384
834,121,244440,856140,611700,606548.5625,617942.4,749328.425537,689599.255156
8157,196,2612220,3281700,669480,668083.125,664245.6,0.0,920023.179936
5219,213,939480,3206820,2267340,2249404.25,2252485.2,2857066.85461,2384673.73771
1274,108,10020,3191940,3181920,3896217.5,3044400.0,3977413.77539,3953794.77493
8526,159,2442780,2480580,37800,22968.3671875,68914.8,0.0,-1156269.26778
590,56,28800,6361440,6332640,2346214.75,2245141.2,1793013.63025,2488818.56715
8115,28,175620,493260,317640,262074.734375,293053.2,797667.755676,495368.804776
7476,174,1273260,1300440,27180,0.0,58696.8,0.0,-449817.223175
6839,213,2422560,3206820,784260,740164.125,717794.4,7594697126.55,983301.523646
3785,141,3217500,7406100,4188600,4187139.5,4184512.8,0.0,4309669.20886
6601,151,3043920,3643800,599880,595936.875,598575.6,308394.45343,691614.461331
1204,117,14280,1144740,1130460,1224187.25,1066585.2,1435280.61713,1871025.65752
7995,172,1390920,1443960,53040,100617.5,104362.8,100356.975769,-299484.142755
3928,114,1029180,1201080,171900,204253.265625,206718.0,885668.613953,513353.561559
1376,130,81540,3083940,3002400,3273775.75,3047199.6,4570126.1925,3246019.93207
118,76,57360,7552500,7495140,6678579.0,5610315.6,4662239.90295,4188569.49943
1676,135,926100,5649480,4723380,4661832.5,3512086.8,2888700.56189,2493728.12114
8465,188,4085160,4327560,242400,250368.25,243568.8,807978.408752,548968.145819
3546,147,1317000,1479360,162360,215280.90625,226580.4,273168.80542,67602.9623612
610,140,430620,1300140,869520,903189.75,876091.2,1903234.77045,2245635.54006
1622,134,153300,3656580,3503280,3497650.75,3517113.6,2781606.43158,2680511.25301
6871,13,908520,2525940,1617420,1616595.25,1607132.4,0.0,1645420.53362
7607,98,6321780,7319880,998100,981634.875,1014465.6,248540.790039,1145629.61449
1197,77,66000,3257040,3191040,3137274.0,3186057.6,1397323.16803,1949938.34313
6044,204,89340,2567700,2478360,2455044.0,2411139.6,3104359.07599,3185210.80019
1497,33,74400,78900,4500,25970.3789062,310237.2,393161.255615,618693.688393
3316,130,1815180,3083940,1268760,1258331.125,1269222.0,1189806.23291,1096761.46656
5971,57,290100,2756640,2466540,2428771.5,2463321.6,0.0,2620053.12107
7658,220,1745640,2714040,968400,975534.0625,985290.0,69216.2598267,576567.402946
1581,119,0,2742780,2742780,1659494.0,1640139.6,857474.18811,1989174.40475
8720,188,4243560,4327560,84000,82614.1953125,76161.6,128526.247925,-15603.5418573
3536,165,738960,1262880,523920,609807.125,584788.8,0.0,-281480.359534
163,111,193800,3974400,3780600,3791710.5,3777076.8,3896666.36725,3713962.35237
0,68,0,262800,262800,1526501.125,744228.0,1018973.15186,1355930.98177
8416,14,1153980,1327560,173580,166144.640625,150189.6,0.0,121038.033508
6999,204,1024560,2567700,1543140,1499009.0,1546038.0,1428054.72668,1541340.38103
6213,213,1881720,3206820,1325100,1489192.375,1489858.8,0.0,1479943.98512
3850,114,975240,1201080,225840,244968.328125,231118.8,140033.971497,626387.844483
453,76,468120,7552500,7084380,7152387.0,7085563.2,5962699.19073,7368837.99373
4084,116,518400,786600,268200,279056.84375,255798.0,296889.693481,115094.280689
4508,213,412440,3206820,2794380,2827935.75,2801079.6,3265563.40527,3510767.7893
2569,158,78120,2044680,1966560,2087567.75,1977639.6,2113328.42938,2913919.56022
8883,221,934800,934800,0,16206.3730469,139017.6,839552.264771,404843.069093
1931,72,1143720,2385960,1242240,1294169.25,1360556.4,1504539.46674,1545974.17144
3107,158,572280,2044680,1472400,1389131.625,1357282.8,1719609.80737,1785680.97535
1176,105,1096260,1314480,218220,207774.96875,238844.4,241298.471191,-240385.96461
6398,18,94740,1779540,1684800,1665376.0,1520540.4,1131970.31232,1384759.27572
2023,86,1041180,3519180,2478000,2484081.25,2454979.2,2277658.36707,2278959.48666
3019,158,368880,2044680,1675800,1718406.625,1721532.0,1790677.06329,2378577.85211
6870,13,908400,2525940,1617540,1615872.875,1609960.8,750497.754517,1627180.03515
702,124,603000,754200,151200,201739.078125,238705.2,1061491.82208,754749.339657
5213,196,173160,3281700,3108540,2702030.5,2204850.0,2332136.84399,1748730.70438
8954,22,810360,810360,0,1162532.5,1013391.6,2982435.2923,3293684.41322
8332,152,3416340,3766500,350160,356490.875,336458.4,0.0,211243.97193
5303,134,3206400,3656580,450180,445964.90625,463568.4,588541.175171,305148.347753
7193,15,486900,1822860,1335960,1307187.875,1329517.2,0.0,2450.83473308
6103,204,282360,2567700,2285340,2309088.75,2295388.8,3081022.24249,2957389.61383
3975,60,3462900,7401300,3938400,3632805.5,3337395.6,4609172.51514,3740559.34883
6196,76,5356800,7552500,2195700,2057158.0,2224803.6,0.0,2052480.87231
1384,33,6240,78900,72660,206288.78125,488400.0,797006.105225,1167573.84952
7522,167,395340,534900,139560,95630.390625,170383.2,0.0,194550.220621
1379,49,536400,3991980,3455580,2814676.75,2252972.4,3961462.65698,3188616.10739
796,144,99240,1807260,1708020,1726122.25,1666788.0,2073910.73218,1929598.22183
1395,133,19920,6181200,6161280,5627175.5,5747445.6,3948359.99884,3699109.86245
7689,186,2747400,3636240,888840,889640.0625,897409.2,27174621141.9,390955.431329
9075,21,470460,470460,0,0.0,89746.8,0.0,-329849.83323
1736,79,1559700,4151700,2592000,2601625.5,2590345.2,2823450.38696,2647055.28082
7826,131,5968500,6825900,857400,855604.6875,858291.6,1492596.76654,1055296.4037
1680,146,1482000,6670800,5188800,5197925.5,5207335.2,5866494.91046,5600386.84209
6517,26,261840,2036760,1774920,1756335.625,1781857.2,0.0,2121475.12445
6257,151,2820180,3643800,823620,860153.3125,790516.8,0.0,947612.980401
6834,2,1706220,2555640,849420,799414.0625,759902.4,0.0,-146529.004067
6890,151,3367320,3643800,276480,273149.96875,291453.6,0.0,308904.46365
4440,168,54060,438000,383940,376938.1875,565869.6,986830.156433,934286.841903
5301,134,3203400,3656580,453180,446396.4375,478939.2,225197.200989,306433.078307
1135,76,1087200,7552500,6465300,6468692.5,6473850.0,6968846.42358,6187242.31217
3050,192,14400,4648740,4634340,4826063.5,4458650.4,4075123.74268,3682028.03337
1518,132,154500,1658640,1504140,1550138.25,1410543.6,1626977.2179,1711661.90447
1462,148,0,1938900,1938900,1523076.5,1612866.0,1890546.44879,2366283.16242
8225,14,899400,1327560,428160,438941.71875,409863.6,0.0,-680127.421805
7874,179,188760,345960,157200,160911.25,176463.6,197938.422485,1222634.93522
1285,108,14220,3191940,3177720,3270191.0,3073186.8,3332817.07166,3449737.40282
5114,187,265440,2496960,2231520,1611297.75,1699762.8,1273413.8819,989001.973246
3034,173,210900,3215700,3004800,3003314.25,2997280.8,2895639.13513,2514889.30479
7923,209,686040,1091400,405360,373323.4375,315332.4,1696338.48407,1425669.999
5339,152,812460,3766500,2954040,2317939.75,2347154.4,2295593.10553,1690735.28355
1111,87,1034460,1090800,56340,56233.5898438,139364.4,261014.318115,21462.9510979
8415,220,2388840,2714040,325200,312448.90625,323035.2,497489.282043,128765.481219
3277,135,2442000,5649480,3207480,3102318.25,2972427.6,2888255.88147,2900093.70794
1845,115,590580,954000,363420,771752.4375,1082052.0,890545.271057,1442328.24473
5510,142,4538760,7299960,2761200,2678717.75,2705131.2,0.0,2724408.89088
7854,42,103680,953340,849660,455572.90625,593449.2,1676008.13055,1345423.67227
3837,203,1031820,1897500,865680,869070.8125,883124.4,152873.420898,983337.987694
5396,98,4500180,7319880,2819700,2836754.0,2920734.0,2907363.91119,2970044.8963
4654,142,3894960,7299960,3405000,3388721.0,3340422.0,4821093.77197,3448990.07762
5201,177,1215600,1713060,497460,393463.78125,517762.8,587256.143982,340445.691343
4134,23,1677660,1894920,217260,295492.3125,191985.6,253755.677185,103065.254855
4745,156,2315760,2639280,323520,336179.6875,321518.4,0.0,397407.8525
685,83,90000,1818000,1728000,2012094.625,1539776.4,3191785.7829,2598847.19402
7589,25,1073940,1951380,877440,866363.6875,879604.8,420676.179199,773790.502042
6714,146,5716800,6670800,954000,952827.375,965445.6,1325555.7558,991771.792426
5190,98,4212180,7319880,3107700,3207877.75,2983380.0,2961096.65717,2944038.16216
8743,160,1388280,1564260,175980,138571.546875,168025.2,309734.379456,214235.25415
3668,147,1398720,1479360,80640,23515.7070312,98335.2,0.0,-868615.514348
5789,134,3656580,3656580,0,309225.15625,591550.8,662098.701538,134843.034238
3159,156,1039140,2639280,1600140,1591471.5,1646710.8,1945646.98553,1434958.32837
6278,31,110040,1374660,1264620,1149258.5,1166186.4,1624335.47479,1527733.46692
2040,72,1213740,2385960,1172220,1075323.25,1186923.6,1107005.9248,1150251.04662
8697,131,6647340,6825900,178560,168983.4375,247778.4,6508517738.35,228656.809962
7308,167,242640,534900,292260,304464.59375,296852.4,0.0,78530.8656664
3891,116,384420,786600,402180,409967.0625,398757.6,792846.844055,266759.465501
1335,76,1244280,7552500,6308220,6360597.5,6279012.0,6689237.47467,6437867.40136
434,87,424200,1090800,666600,770153.3125,954339.6,1748097.23761,2333501.05095
1407,77,210840,3257040,3046200,2839658.75,3044698.8,3743377.15198,3756051.66601
232,51,168420,280800,112380,670428.9375,590929.2,323456.75061,1060350.49019
640,75,0,6135000,6135000,4777946.5,4767393.6,2673050.17749,2499100.19514
4001,71,2876400,3996240,1119840,1122377.5,1121076.0,861999.05896,971512.282452
5991,76,5036400,7552500,2516100,2518657.75,2513792.4,2505635.87335,2603818.89601
517,111,575520,3974400,3398880,3392382.25,3614203.2,3705282.95276,3601623.41038
2793,79,2419200,4151700,1732500,862186.9375,1691460.0,0.0,-64432.0365199
5639,146,4856400,6670800,1814400,1724265.5,1892376.0,2139269.1181,1891045.80006
2364,156,245340,2639280,2393940,2395334.25,2752074.0,2778692.00092,3258764.72669
4893,2,48960,2555640,2506680,2459975.0,2183070.0,1234617.46472,1127313.12792
1977,86,1003860,3519180,2515320,2526592.25,2490354.0,2337670.53503,2496245.39089
7051,213,2553180,3206820,653640,653459.4375,655106.4,0.0,511608.54603
8408,133,5922900,6181200,258300,260508.21875,291294.0,0.0,-36722.0390828
632,150,621180,626340,5160,16047.2929688,34131.6,0.0,-32820.3069604
8525,192,4590840,4648740,57900,146474.265625,131229.6,422427.010132,276101.330635
6570,208,42840,1620480,1577640,1612244.125,1604031.6,2630521.44525,2512381.67827
2478,142,2076360,7299960,5223600,5176132.0,5288851.2,0.0,4962681.18369
1452,79,1234800,4151700,2916900,2603468.0,2864672.4,2875027.62372,2601361.42603
3004,108,1463940,3191940,1728000,1738707.75,1697952.0,1632242.3725,1913963.56664
6392,31,176520,1374660,1198140,1208984.625,1186248.0,1433841.50092,1139786.02982
4305,219,42960,3797940,3754980,3481100.5,3686476.8,1933433.0072,1845291.10402
3476,203,643320,1897500,1254180,1308388.75,1233550.8,828595.879028,1676018.66524
4921,90,93420,1532940,1439520,1443237.125,1317680.4,1977581.19897,2004001.85286
8598,42,706800,953340,246540,269572.6875,220969.2,0.0,-382167.167697
3292,192,318240,4648740,4330500,4304357.0,4325578.8,3344550.25085,3578773.38881
8063,26,1510860,2036760,525900,554998.3125,509983.2,318888.534058,470945.138825
4168,107,1303020,4991760,3688740,3672442.0,3688714.8,3732135.54388,3372895.15228
3801,151,868740,3643800,2775060,2633413.0,2783002.8,2659049.32178,2013575.63522
7445,197,20400,626580,606180,755742.375,565174.8,1809264.78888,1871519.23895
7216,3,22740,1055580,1032840,1166675.0,1005501.6,1098707.20258,1456010.39128
5284,113,3181860,3646740,464880,548256.0625,451840.8,409704.283997,834069.052061
4686,151,1539300,3643800,2104500,2117600.75,2065884.0,1712673.75287,1922915.58624
8356,30,398400,604800,206400,456469.875,209536.8,646289.568237,116458.308151
4797,186,358800,3636240,3277440,3390813.25,3170515.2,3984520.06067,3088182.83776
3989,141,3475200,7406100,3930900,3943617.25,3941869.2,3901536.26477,4242936.17434
2625,123,961380,3545820,2584440,2583966.5,2576628.0,2539334.91736,2639222.0374
8762,219,3644940,3797940,153000,163200.234375,205560.0,0.0,414663.693457
7331,133,4949520,6181200,1231680,1260714.0,1197684.0,1204651.09949,1556748.0578
4108,0,1330860,1560960,230100,245005.71875,236767.2,1045335.85327,900179.538339
5255,63,3141300,6232860,3091560,3139446.0,3095912.4,3523076.63525,3031243.5334
1745,63,355200,6232860,5877660,5903518.0,5873864.4,5893007.68591,6106985.01116
6561,64,5036700,6845160,1808460,1812940.0,1645636.8,1467745.6615,1613150.87273
5582,177,1587900,1713060,125160,143334.671875,140823.6,0.0,257028.995073
5924,196,728100,3281700,2553600,2548925.0,2534020.8,2982178.5777,2621929.34292
3083,141,2602260,7406100,4803840,4772450.0,4779378.0,4414471.58179,5023518.13794
2678,156,560220,2639280,2079060,2036711.625,2099493.6,1784927.77698,1728151.97395
4408,141,3732240,7406100,3673860,3672781.25,3682368.0,4190639.44482,3678687.5124
7455,220,1479240,2714040,1234800,1191255.0,1200949.2,1090619.87457,1121910.58057
7241,3,44100,1055580,1011480,1009576.25,1008205.2,1150973.36957,1000332.90364
2901,141,2455620,7406100,4950480,4894395.5,4926344.4,4535871.63715,4932798.93827
2928,156,733620,2639280,1905660,1939582.75,1899663.6,2704507.1972,2247061.50302
2159,77,868440,3257040,2388600,2497858.75,2596026.0,1890914.28888,2516798.33602
3659,199,99000,975720,876720,907133.625,932476.8,1769433.3988,2247368.05835
8633,42,725340,953340,228000,226600.671875,219525.6,0.0,147540.612394
8376,37,333540,736020,402480,403786.21875,388540.8,2109035.80499,2835999.02696
5623,213,1337040,3206820,1869780,1905587.375,1870167.6,2587299.64227,1988610.41525
4292,219,33840,3797940,3764100,3715644.0,3645700.8,2393832.14172,1839990.59021
2672,215,23100,1851720,1828620,1300456.125,1270423.2,289987.273499,1084427.0444
2316,156,188640,2639280,2450640,2859006.0,2402194.8,2543086.85223,2729576.46081
1074,88,551760,555360,3600,110633.289062,455390.4,1409149.85126,1514086.60019
7937,30,0,604800,604800,342338.90625,511801.2,1064707.36304,612286.499073
3628,66,3282600,4817700,1535100,1516291.875,1572273.6,1580891.74896,1817464.05945
2684,123,1005900,3545820,2539920,2683589.5,2555380.8,2231998.86456,2320768.55732
3170,67,2944140,3120480,176340,191090.109375,179517.6,0.0,190505.049705
3450,203,626880,1897500,1270620,1363868.0,1248363.6,1705757.12817,2052164.65496
5796,19,583800,608940,25140,29421.9746094,28347.6,0.0,-60384.5285767
6619,191,1543320,1811280,267960,220907.765625,219590.4,0.0,236981.712933
5270,131,3740100,6825900,3085800,3085932.75,3086893.2,2800196.40472,2824817.37518
9044,63,6232140,6232860,720,0.0,59200.8,62523362.0791,127784.548741
4079,107,1268160,4991760,3723600,3695612.25,3740294.4,3995947.91418,3534185.3362
6236,31,81180,1374660,1293480,1267284.375,1291838.4,922441.626709,891623.403534
5844,131,4236900,6825900,2589000,2588834.0,2513020.8,3194776.73315,2736213.9566
7129,48,153840,156420,2580,0.0,44311.2,880507.113281,79264.5003203
3562,116,31800,786600,754800,778212.8125,868892.4,1047799.42633,1529835.84004
4112,0,1332840,1560960,228120,231334.859375,230124.0,910448.137146,828391.408823
5904,63,3671640,6232860,2561220,2558379.75,2562122.4,153702191.189,2543946.96342
1912,77,707340,3257040,2549700,2559485.5,2569786.8,2885898.90485,2905261.86568
2072,63,558540,6232860,5674320,5678196.0,5673872.4,5494486.81525,5412109.05668
2409,94,500400,534480,34080,229682.171875,71503.2,847246.775513,770731.950963
6137,220,507900,2714040,2206140,2332582.25,2237510.4,2073236.66656,2411952.77673
217,146,157440,6670800,6513360,6531081.0,6517059.6,7219842.58691,6074734.05493
261,141,85500,7406100,7320600,6343738.0,6458080.8,4310945.0849,4477161.69394
371,76,284460,7552500,7268040,6951467.0,7016713.2,8315822.58691,7128402.01346
4478,135,3341700,5649480,2307780,2397443.75,2262418.8,2297998.664,2260034.04579
5161,217,108120,557700,449580,530038.5625,438656.4,1406969.54077,1211771.79283
1704,119,100620,2742780,2642160,2671173.0,2538926.4,3128692.63641,2797192.35409
3506,184,179400,1800900,1621500,1712032.5,1573222.8,1399996.03247,1122881.68563
8473,133,5973540,6181200,207660,226208.734375,219535.2,304324.026917,228659.497162
1388,77,200220,3257040,3056820,2859500.25,3020220.0,4198297.13086,3625909.51642
8862,204,2459940,2567700,107760,136262.703125,116820.0,0.0,-61594.2187369
2165,94,195060,534480,339420,355516.625,409472.4,721292.210205,1241001.4495
4885,161,1870080,1955580,85500,243267.421875,76884.0,859288.335022,510369.665046
6383,151,2896920,3643800,746880,732059.0,768232.8,670800.955139,613986.280426
7611,27,387000,402780,15780,77089.7265625,52999.2,0.0,486709.768205
4723,131,3432300,6825900,3393600,3405370.0,3379569.6,3173708.80731,3153603.9839
3385,114,539760,1201080,661320,660840.3125,653106.0,1130388.14471,1252735.88697
2350,66,2159340,4817700,2658360,2588230.25,2687086.8,2575187.21332,2642610.8668
7762,58,68280,992100,923820,863057.9375,864974.4,0.0,-92770.4748279
4892,169,137100,2190660,2053560,1849816.25,2049349.2,1992613.53632,2217053.8452
1584,134,136260,3656580,3520320,3444253.0,3426721.2,2063332.53992,2574094.17288
183,100,0,919500,919500,2474793.25,3114540.0,1954976.67822,2396871.68669
5054,146,4359360,6670800,2311440,2312725.0,2270028.0,16608382947.1,2419706.14647
3755,203,861900,1897500,1035600,1031878.875,1035414.0,209286.163879,1109740.55117
322,76,232080,7552500,7320420,6986906.0,6683491.2,6785062.0827,7609236.68891
4927,202,166740,166740,0,25998.1308594,791488.8,0.0,-104689.871383
7204,61,6220800,6225300,4500,0.0,34398.0,1836448239.14,22606.5054183
513,91,278880,1030200,751320,746677.4375,729738.0,1061117.16913,1336857.83184
812,76,679260,7552500,6873240,6828885.0,6854791.2,7509515.56781,6736887.54109
994,87,799140,1090800,291660,224149.625,312730.8,746681.834045,583732.773512
8522,30,513900,604800,90900,102334.859375,100579.2,0.0,-39938.2254709
2652,69,18660,2073180,2054520,2324723.75,2001015.6,2584541.05402,2275770.49222
3582,203,720900,1897500,1176600,1277519.75,1175635.2,1064038210.03,1752436.97169
3674,203,791100,1897500,1106400,1109984.75,1105252.8,627792835.546,1236269.9694
7909,28,39300,493260,453960,522246.9375,466339.2,457591.043396,984830.941081
8333,3,1006920,1055580,48660,42707.6992188,48274.8,0.0,-307743.668132
3262,142,2750100,7299960,4549860,4603660.5,4486448.4,0.0,4524084.76585
6982,31,701580,1374660,673080,672379.5625,673369.2,230499.342407,561535.051937
1124,86,273960,3519180,3245220,3227792.25,3243765.6,2597190.26501,2520230.70479
5227,54,220080,1314000,1093920,1187726.875,1235974.8,682792.287231,886784.702049
7650,189,259860,308460,48600,125536.75,88732.8,1263347.1955,1717513.91126
4530,201,1293240,1645440,352200,341146.1875,337758.0,0.0,298257.729898
7307,164,49500,123600,74100,97751.921875,73159.2,0.0,-657508.951875
1689,110,1493640,5579400,4085760,4088424.0,4046431.2,3604472.20306,3337962.58115
4217,135,3186900,5649480,2462580,2451388.5,2460836.4,2429263.5415,2364029.80199
196,120,179940,576000,396060,425088.34375,521690.4,2011815.16052,2221868.46898
6908,204,970140,2567700,1597560,1589452.375,1582759.2,1000707.40857,1566850.06282
6791,191,1780920,1811280,30360,20988.5820312,122805.6,235237.105652,387551.898737
4047,213,133020,3206820,3073800,3181677.5,3117542.4,4501518.31799,3829904.53474
8723,188,4244760,4327560,82800,46534.4023438,81456.0,0.0,-125076.199972
2493,135,1770300,5649480,3879180,3848895.75,3882680.4,4175109.3736,3745620.9206
1767,138,1724220,1785600,61380,59948.0429688,92098.8,0.0,212077.060974
1580,79,1321500,4151700,2830200,2840606.5,2839494.0,0.0,2338727.10221
6773,46,1871400,2027040,155640,56434.6914062,165099.6,0.0,-56396.1525801
4489,23,1891320,1894920,3600,0.0,6967.2,0.0,62883.9704436
549,83,0,1818000,1818000,2862835.75,2982496.8,3892009.7475,3458545.86648
1207,12,46500,850020,803520,1552460.625,1206822.0,511013.856689,1571123.26859
1905,115,643260,954000,310740,600033.25,861672.0,1592144.78986,1820771.1047
330,141,124620,7406100,7281480,7275906.5,7012231.2,5741724.55811,5522397.139
6470,54,1314000,1314000,0,1450.33862305,38002.8,183051.885071,105458.292664
4077,213,158040,3206820,3048780,2968783.75,3055524.0,3910494.83417,3789989.81004
3971,166,1650300,1666080,15780,129119.007812,211488.0,190343.091614,-331753.449204
1027,83,375600,1818000,1442400,1441540.875,1442364.0,1498315.81671,1708856.66878
8311,26,1805160,2036760,231600,249197.84375,204795.6,367573.394287,344719.954449
1655,142,1226760,7299960,6073200,5942411.0,6026470.8,7142481.31464,6599403.4903
3386,203,603960,1897500,1293540,1281675.25,1258262.4,1354236.02881,1765256.1142
3030,107,268200,4991760,4723560,4795311.0,4516047.6,6186871.69061,4574108.82207
4929,98,4074480,7319880,3245400,3159751.75,3246344.4,3240449.37152,3572219.55379
4764,168,383280,438000,54720,107762.84375,299307.6,99850.855835,163945.831801
920,72,108360,2385960,2277600,2299998.75,2020294.8,2509820.81012,2400754.29117
8639,160,1328700,1564260,235560,225406.234375,229688.4,0.0,270405.179969
8855,57,2720700,2756640,35940,58346.3398438,52918.8,2602943010.21,-419294.149801
6479,75,4967160,6135000,1167840,1174283.5,1172185.2,2158333.55017,1437078.34071
3617,66,3261600,4817700,1556100,1480860.0,1563652.8,2022758.26019,1832114.85824
6261,63,4093140,6232860,2139720,2137092.25,2137639.2,401359403.502,2245800.03262
5344,142,4303980,7299960,2995980,2982071.0,2969197.2,4145343.35846,3036074.64523
5299,210,25680,1118160,1092480,1127992.875,1074943.2,952332.144226,787796.733199
2215,143,31800,1898460,1866660,1882378.25,1851460.8,1536642.36627,1720817.90029
8442,14,1163520,1327560,164040,201974.28125,146949.6,540403.843689,239895.418606
1402,130,92820,3083940,2991120,2998240.0,2978049.6,3138111.31396,3315121.38194
4904,196,0,3281700,3281700,2961467.0,2150077.2,1094996.30878,1443499.2637
5648,89,592980,1736340,1143360,1173113.5,1096584.0,1274158.45923,1274433.00459
8139,197,608220,626580,18360,72800.5625,66916.8,880772.35022,1303193.11591
5513,152,1050660,3766500,2715840,2987809.5,2404387.2,2917557.0639,3116264.00063
4871,215,1851720,1851720,0,0.0,231001.2,0.0,-923780.260513
5697,196,627300,3281700,2654400,2702012.25,2403790.8,1851723.33911,2049106.24454
4468,186,16860,3636240,3619380,3682304.0,2993767.2,2015171.54376,1395384.36787
1638,79,1351860,4151700,2799840,2766965.0,2777742.0,0.0,3122722.46232
5922,4,172560,1326000,1153440,1199315.375,1156780.8,1757503.28485,959476.020689
8924,206,1962660,2086740,124080,91388.234375,109971.6,1141344.07147,444795.466172
2004,86,1035180,3519180,2484000,2471813.75,2460928.8,1158230.22845,1804128.01665
894,110,739320,5579400,4840080,4568174.5,4824639.6,3656065.78662,3520084.34748
5819,17,17400,626460,609060,900248.125,971352.0,1651973.27405,1349388.28332
6633,32,166920,1205580,1038660,960673.625,949104.0,421900.066162,564594.908129
2852,158,268080,2044680,1776600,1838386.5,1862900.4,2468223.71985,2606959.304
715,118,53820,459900,406080,610273.6875,707118.0,4463088.86676,3952365.8878
6967,157,1654500,1993260,338760,352512.96875,415644.0,498801.578796,233396.622619
3510,184,180000,1800900,1620900,1587769.0,1555023.6,1428801.46442,1172885.24416
5296,134,3198420,3656580,458160,517866.96875,525932.4,753860.968567,190790.586314
5806,76,4930020,7552500,2622480,2615390.0,2615389.2,0.0,2684484.69332
5375,49,3938400,3991980,53580,147150.453125,50884.8,1486164.16205,3460.40492183
58,150,59400,626340,566940,789945.125,2346740.4,2284017.75287,1466343.75258
5726,103,4636200,4719960,83760,112207.65625,73147.2,0.0,168668.081907
1600,82,927000,2195880,1268880,1227618.125,1028262.0,1822091.31555,1353896.97686
6583,188,2485560,4327560,1842000,1822538.75,1812501.6,1461494.4472,1679549.1207
1130,76,1083000,7552500,6469500,6461748.5,6484752.0,305824774.678,6015448.43502
3452,23,1083900,1894920,811020,960394.3125,810519.6,781863.520081,1072679.29315
6417,210,1053720,1118160,64440,67887.09375,66792.0,196568.230774,-62209.1551089
6053,76,5097600,7552500,2454900,2454694.75,2452089.6,9463885942.33,2426286.45292
5237,125,3957960,3969060,11100,31184.4238281,54322.8,0.0,-197311.8004
6866,188,2802660,4327560,1524900,1556595.25,1523341.2,2410436.91431,1316462.92515
6804,213,2405700,3206820,801120,732549.0,747688.8,0.0,906715.053196
8952,219,3746340,3797940,51600,387264.0625,61257.6,0.0,396094.071971
5625,159,26160,2480580,2454420,1455493.75,2003691.6,1717052.71631,1438793.28714
5183,135,3877200,5649480,1772280,1697791.625,1848166.8,1652566.57013,1548024.55368
1158,104,273180,935100,661920,925109.9375,1103653.2,5919173.50604,3746788.75308
7647,183,23040,445560,422520,468652.5625,495300.0,37867.1849365,307149.052805
533,141,391320,7406100,7014780,7100123.0,7011826.8,6764989.86255,6023714.45707
6125,196,1043700,3281700,2238000,2361041.25,2280975.6,2498017.34259,2267264.90725
535,103,244620,4719960,4475340,3642088.5,2147340.0,1956324.89386,1978312.91464
1818,63,389100,6232860,5843760,5856551.5,5843644.8,5198839.17755,5601931.56283
2698,98,2244780,7319880,5075100,5069541.0,5090055.6,4046115.28204,4925560.63971
7950,220,1940940,2714040,773100,781243.4375,771572.4,1047936.05646,732784.819404
7171,162,3561300,4836120,1274820,1250430.5,1272921.6,569590924.694,1247784.5351
4646,156,2251860,2639280,387420,405257.21875,394501.2,680109.589417,505702.974519
4109,143,1732320,1898460,166140,177583.859375,169498.8,1503606.28094,879912.629939
5018,86,3515580,3519180,3600,168178.703125,174031.2,22204211458.2,5723.19841579
1746,63,355260,6232860,5877600,5894534.0,5869824.0,6347162.66675,6106959.31654
3900,141,3416880,7406100,3989220,3985317.0,3990388.8,4069882.96948,3893944.93785
7380,213,2750700,3206820,456120,511059.4375,434954.4,2647019767.35,-67867.0943198
8912,152,3766500,3766500,0,0.0,226261.2,0.0,172568.926558
6357,25,33420,1951380,1917960,1967161.75,1932308.4,3346519.6463,2645535.55459
7631,222,790200,1113000,322800,288966.03125,286520.4,0.0,-746487.664436
7569,205,460800,460800,0,43643.9609375,350289.6,0.0,-564212.867605
1897,101,81660,655020,573360,648722.9375,616095.6,1089618.05499,1276936.26919
3571,203,715440,1897500,1182060,1186896.25,1182135.6,993479.431213,896776.111988
2206,117,825360,1144740,319380,252166.53125,359540.4,56943.7307129,773994.022679
6457,110,5528100,5579400,51300,68971.984375,274808.4,5351713101.41,441304.487639
212,128,191460,346200,154740,139281.203125,448189.2,376128.36908,880101.66833
3068,201,78240,1645440,1567200,1600074.75,1809721.2,2301311.99023,1860040.08148
7699,15,954780,1822860,868080,864911.625,882160.8,2108339.03827,1017888.46759
2447,101,597420,655020,57600,361534.28125,227198.4,0.0,-545488.120092
4713,213,651600,3206820,2555220,2568898.0,2562025.2,2848492.21039,2556334.04186
170,146,126900,6670800,6543900,6535857.5,5956448.4,6114166.16211,5165811.95186
3671,79,3155700,4151700,996000,982931.6875,948099.6,3056107.35413,1263342.86915
9040,13,2514720,2525940,11220,25962.6035156,15067.2,134508.63446,115571.623543
2877,96,791400,2123400,1332000,1336795.125,1277931.6,2062646.19897,1476205.19824
2516,153,38100,1618560,1580460,2349413.5,1732308.0,3170032.74994,2598208.20254
5256,113,3169560,3646740,477180,510208.21875,347809.2,1247115.94775,1015549.99287
7920,170,20700,665160,644460,557641.4375,583285.2,0.0,112665.533459
675,93,546600,1242300,695700,693049.5625,796344.0,974889.058044,739768.800732
5506,57,27660,2756640,2728980,2743308.75,2726918.4,3189550.39362,2682883.81354
8054,178,621600,904200,282600,228812.359375,250137.6,581375.710999,40342.3423187
2227,63,664260,6232860,5568600,5572867.0,5566066.8,0.0,5439262.65494
6232,220,581520,2714040,2132520,2279201.5,2014868.4,0.0,2012863.48701
532,88,16200,555360,539160,1405512.0,1459664.4,2154423.35327,2394290.69351
7425,178,78000,904200,826200,868726.875,809746.8,204260.470703,204415.203138
4424,141,3736740,7406100,3669360,3668401.0,3682554.0,3335963.22809,3498137.34006
240,111,242280,3974400,3732120,3704217.75,3713793.6,4617988.84595,4242712.88965
7814,219,2937420,3797940,860520,857860.3125,857846.4,1204109.55359,1293827.31137
7913,179,203880,345960,142080,145906.03125,142478.4,2102899656.0,327481.133151
5938,218,1437420,1974480,537060,524558.0,521494.8,0.0,27289.3517517
4804,90,31200,1532940,1501740,1576251.375,1552282.8,1387501.68079,1542133.42457
3508,199,0,975720,975720,2366109.5,2671465.2,2954282.36487,1924572.62964
5003,69,1933860,2073180,139320,96180.515625,112909.2,0.0,-413032.887043
3011,67,2682960,3120480,437520,439350.71875,419174.4,845801.343994,709190.696248
8794,196,3139740,3281700,141960,119524.382812,198896.4,0.0,319515.015568
7426,174,1226340,1300440,74100,97713.328125,274651.2,0.0,-387511.324888
5942,76,4998960,7552500,2553540,2551785.75,2561526.0,23003079067.5,2896367.29247
4715,69,1774860,2073180,298320,282499.125,250515.6,0.0,72798.4186409
6198,210,911760,1118160,206400,29282.7050781,214623.6,0.0,-310832.457761
2296,126,197460,496560,299100,697311.6875,835477.2,1342197.03827,1358723.03325
4470,133,2614980,6181200,3566220,3683659.0,3487245.6,4118212.87866,3773232.65192
229,146,161940,6670800,6508860,6548887.5,6550652.4,8452177.38635,7221695.64633
8047,178,618900,904200,285300,246970.328125,278961.6,1089596.70166,75087.9784135
2845,215,160800,1851720,1690920,1403069.25,1788704.4,34478.8040771,699073.588557
2084,61,1958760,6225300,4266540,4222518.0,4280541.6,0.0,4040207.79799
8615,63,6001140,6232860,231720,227770.078125,234172.8,195131430.883,253989.455781
2960,108,1442940,3191940,1749000,1813995.75,1763436.0,1974293.86621,1837450.50061
4916,125,3778560,3969060,190500,237466.515625,194986.8,370192.401062,579558.374354
1878,115,630000,954000,324000,517257.59375,671916.0,1140266.28558,1518321.63375
6201,76,5360400,7552500,2192100,2179767.75,2220021.6,8594251234.71,2207674.02931
1461,1,87780,1447140,1359360,1221942.75,1345710.0,1056865.45984,1038452.01188
6379,151,2895660,3643800,748140,733716.875,758834.4,234899.861816,706424.17999
2815,123,1119180,3545820,2426640,2486440.25,2422425.6,3008447.06061,2298733.09897
5046,71,3624300,3996240,371940,369087.28125,381856.8,8075285506.82,302955.702941
2298,83,1519200,1818000,298800,299949.0,294861.6,0.0,321350.025146
1073,118,456300,459900,3600,0.0,191094.0,194763.932007,-11652.6284816
4914,142,4047060,7299960,3252900,3301114.5,3107743.2,3555550.63763,3369575.59435
8163,13,1849260,2525940,676680,690003.625,667813.2,1861935.37103,1078875.47612
6579,131,4895460,6825900,1930440,1896511.0,1880883.6,1126646.09369,2212298.47616
1670,1,220020,1447140,1227120,1204396.125,1231860.0,1788580.35315,2170378.87146
5700,4,74760,1326000,1251240,1044899.1875,1129068.0,63971.3526001,483956.079901
5916,57,256680,2756640,2499960,2438965.25,2490316.8,0.0,2133974.33759
6718,10,945720,979740,34020,0.0,72256.8,545778.353088,-225503.277379
4758,86,3373140,3519180,146040,152861.953125,145993.2,299987.545471,377026.245699
6685,61,5759700,6225300,465600,930489.3125,915234.0,283848.906799,649080.452155
2599,103,2106060,4719960,2613900,2633853.5,2477487.6,2174818.55066,2098186.96691
6754,32,260760,1205580,944820,886136.0625,867956.4,346835.012329,492211.787496
4743,142,3955680,7299960,3344280,3351944.0,3233916.0,2927305.8175,3382677.22133
5500,142,4535160,7299960,2764800,2722295.75,2708108.4,0.0,2725950.56754
6408,31,187680,1374660,1186980,1143091.125,1161462.0,1038079.39484,878389.824997
5752,220,99660,2714040,2614380,2369015.25,2367434.4,2211508.02423,1993593.84079
7488,15,693240,1822860,1129620,1110973.75,1164565.2,828737.474365,1058728.2442
1241,131,450900,6825900,6375000,6368442.0,6364783.2,5713611.39117,4914343.26114
5535,10,20460,979740,959280,1481525.75,1248928.8,1719299.6557,1859648.61068
8215,11,1616040,1777560,161520,167263.5,168499.2,0.0,312248.289925
7888,22,31500,810360,778860,475858.6875,588338.4,1487519.73566,1099204.48345
993,66,895860,4817700,3921840,3943593.25,3857343.6,2966142.89478,3777280.04469
6790,191,1777320,1811280,33960,19542.8730469,135050.4,0.0,186574.883479
2656,63,1084020,6232860,5148840,5143823.5,5163750.0,0.0,5233876.9868
8842,76,7430400,7552500,122100,77805.015625,239578.8,0.0,228353.35241
388,128,346200,346200,0,383449.8125,440522.4,0.0,-479502.656928
5981,13,9960,2525940,2515980,2303900.0,2048493.6,1761569.56531,1497463.64889
6924,18,595140,1779540,1184400,1184022.0,1167774.0,1010771.4646,1208331.96394
6900,167,11040,534900,523860,535740.5625,517722.0,1626831.21881,1310718.94674
6494,155,2506200,3225180,718980,714313.375,724754.4,871847.797668,737638.805158
3778,98,3128580,7319880,4191300,4200466.0,4114879.2,4885336.20227,4357150.89751
292,91,0,1030200,1030200,2542718.75,3173012.4,2556202.96033,2830455.12291
6306,31,134820,1374660,1239840,1279413.25,1245511.2,1064707.60706,600908.987713
1386,77,200040,3257040,3057000,3062098.0,3155538.0,4695316.41656,3798196.35835
8086,76,6829200,7552500,723300,705096.375,705492.0,2819165108.78,565881.093464
3344,67,3069900,3120480,50580,68093.140625,80383.2,0.0,-352247.891762
8403,28,493260,493260,0,0.0,10820.4,779950.481445,857089.943881
1784,98,1481040,7319880,5838840,5808333.0,5835218.4,6009269.12042,5510896.59153
3918,114,1024680,1201080,176400,218734.265625,212216.4,812626.325989,610761.273441
5100,157,24240,1993260,1969020,2069609.625,1885819.2,1940001.51715,1403869.53896
924,105,729720,1314480,584760,504386.9375,646208.4,2388500.76569,1227161.23926
3563,147,1326660,1479360,152700,156907.328125,206601.6,0.0,112889.284932
4472,156,2008320,2639280,630960,611931.75,613346.4,1172565.72278,581026.48523
5740,57,171780,2756640,2584860,2777982.75,2483935.2,3085499.6756,2599105.5921
3732,203,833100,1897500,1064400,1008957.875,996087.6,0.0,1218027.73841
6974,222,258540,1113000,854460,885108.25,839563.2,0.0,-121352.147548
205,68,219000,262800,43800,426109.125,368186.4,2482268.03705,2935418.12319
760,124,625800,754200,128400,40615.0234375,130645.2,70119.8026123,318072.227522
997,76,835620,7552500,6716880,6771262.5,6661923.6,6827369.99066,6706543.13744
6035,220,266400,2714040,2447640,2423356.5,2381128.8,2596847.07257,2476000.84896
2119,66,1965600,4817700,2852100,2850840.5,2820780.0,3305912.80585,2857957.22939
5988,220,233520,2714040,2480520,2524255.0,2439783.6,2999696.16437,2452022.41651
2836,215,155760,1851720,1695960,1456196.75,1768309.2,784467.7677,972978.421227
2574,156,500880,2639280,2138400,2245094.25,2100968.4,1219154.20593,1432247.40149
2416,66,2312100,4817700,2505600,2508058.0,2494728.0,2560419.54089,2388685.30065
8880,196,3197760,3281700,83940,18564.7109375,87368.4,0.0,86215.4223088
1226,12,57000,850020,793020,305961.875,886338.0,427769.313171,798099.95776
6680,18,281460,1779540,1498080,1767170.625,1716372.0,401141.523438,1181756.93558
569,135,9000,5649480,5640480,2523946.0,2918010.0,2872247.64099,2539738.46438
6456,31,223620,1374660,1151040,1178645.75,1152360.0,1272454.88,1353917.23834
2975,108,1450140,3191940,1741800,1743405.625,1744552.8,1654845.61438,1659790.49666
5086,156,2501580,2639280,137700,105385.304688,126088.8,10360508587.4,-66648.4454045
5076,180,1104000,3322080,2218080,2171191.75,2211726.0,2302211.18591,1993591.39018
247,65,172800,7544400,7371600,6543920.0,6027494.4,5171173.8703,5627403.51706
7451,188,3148980,4327560,1178580,1109417.875,1191669.6,1409523.20959,1065239.22249
5072,98,4152480,7319880,3167400,3123342.0,3112317.6,3526108.52521,2953512.43921
2644,135,1856940,5649480,3792540,3827075.75,3782871.6,5905363.30377,3869037.49693
7202,213,2639580,3206820,567240,573306.625,550801.2,82830.0387573,609722.322585
4917,130,3083940,3083940,0,59859.1796875,57660.0,0.0,271858.854157
5788,63,3618540,6232860,2614320,2634165.25,2618626.8,5860670211.5,2674593.24061
7033,167,82680,534900,452220,487558.96875,458149.2,5684.95849609,517985.223986
406,53,24120,582540,558420,591698.625,877965.6,3165522.89484,2458033.72625
6193,63,4046940,6232860,2185920,2185894.75,2194596.0,0.0,2164828.94458
4864,215,1848120,1851720,3600,0.0,236683.2,0.0,-742309.103596
7997,7,40380,40380,0,483020.9375,461007.6,1545068.23285,1616003.75491
4972,90,118500,1532940,1414440,1295837.125,1339390.8,0.0,207359.642819
1983,72,1172760,2385960,1213200,1300086.0,1238832.0,1950845.84924,1545171.81121
2753,98,2278740,7319880,5041140,5032272.0,4981514.4,2717257170.66,4690905.15607
5810,89,670920,1736340,1065420,984426.125,737817.6,1549356.67889,1193199.44812
3390,114,542220,1201080,658860,620879.25,645140.4,0.0,298647.42156
5470,196,471300,3281700,2810400,2577418.5,2712829.2,2559831.43048,2019503.13208
3948,116,433800,786600,352800,273730.0625,368914.8,0.0,228528.104414
2660,133,1146540,6181200,5034660,5055410.5,5038165.2,6335867.56342,4912809.82705
3075,151,124380,3643800,3519420,2512100.25,2099648.4,2358103.5448,1821301.75046
929,144,192240,1807260,1615020,1517961.625,1549960.8,2664271.72321,2155735.56245
5332,146,4532220,6670800,2138580,2159273.25,2141823.6,2605687.38757,2325560.09095
96,149,88140,223140,135000,145232.4375,169864.8,2137552.62634,1799776.26737
8976,160,1521060,1564260,43200,66169.203125,44306.4,6816480044.82,59653.7346907
194,100,4560,919500,914940,1912918.0,2031596.4,2658276.3988,2615124.37534
8636,64,6760380,6845160,84780,85820.4140625,90054.0,378710.47644,366788.988054
4502,153,1618560,1618560,0,0.0,85354.8,657918.136047,801423.999783
1055,131,278700,6825900,6547200,6525550.5,6529062.0,4470208.98755,4222959.40132
8359,30,398460,604800,206340,464658.46875,217940.4,761036.142639,59383.9483041
2825,69,163680,2073180,1909500,1809385.125,2222948.4,843593.268982,1225377.88061
3313,114,477660,1201080,723420,717645.625,720688.8,384725.881897,796502.192403
7869,15,1063020,1822860,759840,784550.75,772332.0,291076.929443,708355.102746
7636,219,2794680,3797940,1003260,975975.8125,1001907.6,1192268.96735,841083.8164
1373,146,1275360,6670800,5395440,5409596.5,5276565.6,4800835.41321,5416873.0065
6554,208,28440,1620480,1592040,1628311.375,1664569.2,788597.276611,1220251.74909
8151,224,0,648060,648060,117666.21875,521139.6,704421.198486,637391.421608
4102,131,2940720,6825900,3885180,3835037.75,3877534.8,2961032.08948,3451748.70628
981,105,798720,1314480,515760,511740.6875,510676.8,860125.791077,635390.842705
5208,146,4445820,6670800,2224980,2352315.0,2324138.4,1395930.6123,2410107.76552
4589,182,849660,915060,65400,125254.453125,236430.0,0.0,-96077.0956129
3955,123,2160420,3545820,1385400,1404268.5,1320987.6,509712.60321,1296886.24361
8873,29,21360,57540,36180,72973.78125,236202.0,0.0,12399.9207571
1065,112,0,1303440,1303440,1819761.75,1907330.4,3615545.39111,2973340.62944
3427,137,69180,243720,174540,128739.304688,203360.4,30727.3756714,225301.764735
8072,222,1081800,1113000,31200,38763.5390625,29508.0,0.0,-604227.958817
5524,76,4776000,7552500,2776500,2785475.5,2723545.2,2676653.94696,2765365.15963
3704,148,1938900,1938900,0,0.0,147366.0,0.0,-362736.966106
5476,213,1243500,3206820,1963320,1970945.0,1938031.2,2893833.60803,2491664.69256
4762,215,1794600,1851720,57120,56582.6953125,137700.0,0.0,-627782.607255
4906,142,4042980,7299960,3256980,3250797.5,3231686.4,0.0,3321020.45114
4832,156,2357460,2639280,281820,285716.1875,280928.4,1170801.95648,237206.417046
5956,204,18780,2567700,2548920,2312310.75,2444806.8,2931795.83582,2743924.22051
8783,37,575280,736020,160740,155418.65625,340755.6,0.0,142498.096428
7770,58,80100,992100,912000,941923.9375,900145.2,0.0,-361577.356209
7646,63,5228340,6232860,1004520,674908.625,884137.2,635979129.388,881142.443164
177,141,6000,7406100,7400100,3782905.75,4090694.4,3138521.78363,3104211.04392
2125,63,614160,6232860,5618700,5530290.0,5559394.8,5721758.92938,5475087.93632
1966,111,1882560,3974400,2091840,2112722.25,2209785.6,2655008.78259,1848600.38959
6247,11,80820,1777560,1696740,1815027.25,1674264.0,1824188.06854,2531548.57914
7037,195,115200,393120,277920,288312.15625,389883.6,0.0,122565.136379
1349,67,1292820,3120480,1827660,1608447.125,1867465.2,4234239.60358,3099378.40527
1583,135,875220,5649480,4774260,1895342.25,3541068.0,1148844.71222,1886736.23111
4845,156,2368920,2639280,270360,251572.828125,271941.6,1522613.36798,264592.507867
178,120,171600,576000,404400,457963.375,637341.6,1715213.70837,1821411.28618
4017,184,646800,1800900,1154100,1152477.5,1005780.0,1359676.16125,1080831.14307
1942,96,18060,2123400,2105340,1904283.875,1735131.6,1463037.08099,1516430.60551
2966,173,169020,3215700,3046680,3070402.75,2975608.8,2583151.92487,2593140.14966
4829,169,91860,2190660,2098800,2105562.75,2016225.6,1788950.44214,2317983.10793
5567,214,337260,341760,4500,69082.4921875,70880.4,0.0,486176.575451
392,53,17100,582540,565440,369679.0625,751203.6,881001.203125,1861211.41724
7493,220,1529640,2714040,1184400,1159776.75,1161988.8,247455.859741,380397.982384
762,76,652800,7552500,6899700,7103177.0,6909296.4,6722325.62549,6793672.58462
4133,198,708660,708660,0,0.0,15985.2,0.0,-693517.91331
2150,96,163800,2123400,1959600,1772731.625,1706382.0,636884.291992,1165460.93946
2452,94,534480,534480,0,0.0,262312.8,400599.71344,298111.016218
7203,61,6220800,6225300,4500,0.0,34128.0,1835576083.75,22606.5054183
2748,73,11100,1303500,1292400,1981189.625,1709328.0,2046299.20966,2119931.5379
3111,130,1671660,3083940,1412280,1413343.375,1406168.4,0.0,1612780.56614
2724,200,29040,59160,30120,0.0,432393.6,785026.895691,1811509.38077
7754,31,1319580,1374660,55080,50470.0703125,56983.2,0.0,-257633.36411
4091,151,1074960,3643800,2568840,2570247.75,2568763.2,2525575.02039,2216104.34538
5429,49,3987540,3991980,4440,0.0,128863.2,495543418.913,432744.978385
2995,67,2672700,3120480,447780,438695.03125,411842.4,307646.721802,501665.795454
6463,188,2399160,4327560,1928400,1933525.25,1595841.6,2093179.32593,2008711.36408
9016,131,6799200,6825900,26700,0.0,16845.6,0.0,-175555.114517
5221,156,2579700,2639280,59580,55713.8007812,73341.6,130843.545044,-12809.22469
6492,63,4244820,6232860,1988040,2097583.75,2078478.0,110374654.186,2237117.5392
1071,78,518400,1818900,1300500,1422962.5,935114.4,75258.5491943,718923.518135
4939,146,4290300,6670800,2380500,2192434.5,2403334.8,3318858.61395,2846160.40003
7939,63,5429340,6232860,803520,829750.6875,791355.6,0.0,683842.309352
2668,69,31860,2073180,2041320,2087472.875,2063498.4,1807212.30139,1643396.84091
7357,5,744600,748200,3600,0.0,130729.2,0.0,-414936.705227
7499,27,198720,402780,204060,196942.578125,196300.8,0.0,210694.232347
7971,196,2506260,3281700,775440,780791.75,770107.2,762334.277344,822733.743584
43,51,3000,280800,277800,161452.5625,407323.2,654833.853699,1523599.27025
953,66,863940,4817700,3953760,3942637.0,3890264.4,4177274.52795,3875333.66193
2868,173,108360,3215700,3107340,3046292.25,3105728.4,3511575.6087,2964393.20587
5355,142,4322340,7299960,2977620,2976813.0,2937942.0,3796840.81873,2646179.2961
2902,173,117600,3215700,3098100,3084970.0,3107857.2,4026127.4408,2984310.9083
808,83,158400,1818000,1659600,1603141.75,1558123.2,2544211.84918,2655561.19205
960,131,84780,6825900,6741120,6749157.5,6723718.8,4730620.32458,4466833.3319
3930,218,0,1974480,1974480,1606472.25,1568983.2,1599313.6322,1691621.33108
6210,176,225180,1462860,1237680,1633337.25,1237557.6,904262.426697,481537.796888
3986,130,2403540,3083940,680400,635619.0625,688124.4,0.0,862208.309475
2875,171,312600,435600,123000,275332.75,187482.0,415530.334229,960370.287125
6595,75,5053560,6135000,1081440,1086001.375,1053811.2,1129304.53931,1126776.89559
1029,83,376200,1818000,1441800,1442106.625,1441761.6,1530301.57953,1774727.91984
6042,210,633600,1118160,484560,484457.0625,459452.4,917158.388306,678503.835093
1234,117,30120,1144740,1114620,1496171.75,1235030.4,3024024.17596,1949391.07475
7751,219,2882340,3797940,915600,896348.9375,910360.8,140275.950989,767523.233358
1243,138,1225200,1785600,560400,504883.28125,463652.4,15061500665.6,447360.05266
2285,134,757920,3656580,2898660,2884481.5,2860713.6,2135358.16486,1841814.97662
1964,113,511860,3646740,3134880,3008419.75,3023538.0,3462316667.89,2867083.38584
7930,15,1100820,1822860,722040,715756.0,730771.2,0.0,619443.234652
895,106,699840,1023180,323340,462143.75,354512.4,109451.453308,631763.962056
8586,159,2480580,2480580,0,0.0,63240.0,0.0,-1408924.71049
2360,135,1568220,5649480,4081260,4445587.0,3997951.2,4095081.3653,3519420.42808
6092,220,453060,2714040,2260980,2306057.5,2294184.0,2975862.08795,2539754.14793
6575,26,303720,2036760,1733040,1501013.75,1668030.0,1330635.89948,1745806.12343
1377,133,14400,6181200,6166800,5942851.0,4979226.0,2380028.13019,2554549.4039
5084,71,3636600,3996240,359640,282607.8125,362115.6,0.0,234365.02102
4828,2,2880,2555640,2552760,2371950.5,2196662.4,1913426.95447,1597132.04791
2008,126,0,496560,496560,849467.375,851366.4,1275784.85504,1749223.96181
6049,63,3776400,6232860,2456460,2455411.75,2448140.4,0.0,2605769.95843
6268,172,24480,1443960,1419480,1414357.5,1419288.0,1168127.2926,743773.993711
1429,121,825900,856140,30240,35274.5117188,28292.4,0.0,-439075.44285
6034,57,342720,2756640,2413920,2407489.0,2393328.0,0.0,2298856.02626
651,84,459780,3714840,3255060,3248420.0,3090038.4,3203814.85248,3096274.07893
3402,137,61080,243720,182640,191082.625,187125.6,287831.223206,517768.729429
8419,37,373980,736020,362040,325545.6875,352597.2,851800.252441,955997.114573
916,142,532380,7299960,6767580,6611151.0,6774739.2,6475145.26788,6618620.21744
2818,63,1222740,6232860,5010120,5010730.0,5015066.4,0.0,5104912.64541
6530,10,823920,979740,155820,153423.203125,170392.8,0.0,170138.307304
2821,0,204840,1560960,1356120,2514456.25,2771559.6,2832154.01184,2300957.34319
3267,162,420660,4836120,4415460,4383663.5,4320889.2,3733056.99255,4158938.239
5610,193,23400,187200,163800,318094.3125,1065980.4,0.0,506035.44526
5564,113,3509460,3646740,137280,116325.742188,127130.4,567871.742859,486331.392919
290,120,264900,576000,311100,387628.09375,577930.8,679954.052795,1102122.60959
5170,125,3920160,3969060,48900,0.0,41835.6,575958.062012,65055.1026123
2494,156,445980,2639280,2193300,2304238.25,2192464.8,2379256.8183,3365325.17601
5117,156,2518320,2639280,120960,122025.109375,122781.6,14361992789.9,113578.33832
8449,224,335580,648060,312480,293089.71875,275264.4,0.0,-218182.525579
2736,110,2461080,5579400,3118320,3172664.5,3118730.4,3021398.04877,2895361.66586
6860,61,6018060,6225300,207240,225678.296875,233218.8,842226.300842,458059.184395
999,86,37680,3519180,3481500,3135235.25,3124386.0,2922522.92853,3035519.42617
574,127,16440,599940,583500,481091.8125,1026825.6,1729430.8645,1954608.68046
105,76,46200,7552500,7506300,6959921.0,6282372.0,5529811.54926,4564004.13873
467,103,217500,4719960,4502460,3151033.75,2805543.6,2171006.60248,2778065.29225
377,79,201660,4151700,3950040,3954537.0,3944553.6,5059326.19922,4311718.04928
859,84,606420,3714840,3108420,2965845.5,2733670.8,2846095.26874,2600607.3014
5979,63,3716160,6232860,2516700,2517095.0,2511926.4,27775500.1105,2589002.14842
2223,112,932760,1303440,370680,611730.6875,260749.2,333777.897888,268479.2722
492,141,374400,7406100,7031700,7025262.5,7027855.2,6451231.85217,6194760.24009
5483,102,2989980,3198240,208260,212544.15625,258888.0,867868.358276,762419.567622
1273,117,50460,1144740,1094280,1456989.75,1290968.4,2153753.29248,1903774.41095
8722,221,851400,934800,83400,88684.7890625,78136.8,613458.536621,56862.3618698
1548,132,172440,1658640,1486200,1560390.375,1235449.2,3591122.28839,3579470.97531
7521,185,41400,441420,400020,391048.625,428358.0,2108424.84735,749679.3989
2809,63,1220940,6232860,5011920,4983971.0,4930606.8,0.0,4872774.94845
4213,73,1256400,1303500,47100,37900.9609375,82264.8,0.0,-202844.182136
8392,220,2363940,2714040,350100,337716.25,336487.2,145951.976746,306515.69522
5004,69,1933860,2073180,139320,135027.265625,120306.0,0.0,-468564.933978
4050,116,493200,786600,293400,400142.46875,280819.2,298622.764038,230043.465856
8462,133,5962920,6181200,218280,222550.875,219435.6,365790.826599,306945.78951
273,87,164100,1090800,926700,996638.125,883822.8,1074555.86169,1728288.0141
9001,42,924360,953340,28980,0.0,29206.8,135103.393799,179616.555568
4548,213,434040,3206820,2772780,2755656.75,2763049.2,2630551.94574,3067358.82777
2612,92,0,613860,613860,978312.125,1737025.2,0.0,376499.205345
1982,63,504540,6232860,5728320,5738140.5,5731737.6,6660907.03363,5764199.39985
8588,14,1255560,1327560,72000,112377.523438,77307.6,37151.6404419,163440.072794
200,149,173040,223140,50100,29720.875,52023.6,0.0,214651.781314
4550,156,2072820,2639280,566460,556949.1875,567511.2,1131815.56128,738122.838585
7876,170,0,665160,665160,405639.875,514426.8,365858.40918,472660.156328
8485,212,129420,204240,74820,119509.273438,114844.8,0.0,25206.6901549
1947,98,1588980,7319880,5730900,5675223.5,5490028.8,5485696.91425,5532156.51203
7379,16,13200,117000,103800,12323.6347656,109618.8,0.0,-1622068.99511
1456,63,11400,6232860,6221460,6135577.5,5908618.8,3949753.90424,3847323.62707
1599,122,606480,861720,255240,235909.125,240871.2,0.0,161642.758339
1808,104,872100,935100,63000,68826.8984375,81777.6,0.0,-67406.3853107
5285,103,4204620,4719960,515340,561754.5,465067.2,0.0,564517.480564
3275,23,976500,1894920,918420,903184.75,923324.4,247069.523438,645695.861466
8476,139,24600,273900,249300,160409.796875,229339.2,528056.20166,385657.467233
3698,199,119340,975720,856380,1259957.625,937376.4,1576285.60071,2539666.13534
7292,3,67560,1055580,988020,982941.1875,914986.8,728345.983276,1108854.18644
3351,23,1031820,1894920,863100,862728.375,866170.8,15591271288.0,523905.825053
2765,165,70500,1262880,1192380,1219302.625,1134160.8,705379.006958,989245.615447
1834,133,456420,6181200,5724780,5305985.5,5268361.2,5772023.07422,5345484.17402
8140,190,14880,705600,690720,734705.0,637040.4,0.0,-422974.832007
7383,178,61800,904200,842400,741184.4375,842907.6,0.0,-518151.232388
5137,98,4180380,7319880,3139500,3168206.75,3150410.4,4585033.2771,3379559.58931
1734,63,336240,6232860,5896620,5878069.0,5882580.0,6173137.55591,6280065.4849
1634,135,904440,5649480,4745040,4451541.0,4230918.0,2499889.82379,2253943.62951
6087,13,118680,2525940,2407260,2306351.5,2319816.0,2232100.59827,1709944.40187
2152,133,684360,6181200,5496840,5419236.5,5341675.2,5285177.65472,4514269.22463
4127,165,1262880,1262880,0,22001.8242188,83895.6,287353.712402,-404938.138756
3667,148,1917240,1938900,21660,0.0,96733.2,0.0,-1160453.74039
1033,62,136860,3674460,3537600,3565442.0,3849890.4,3565747.24036,4860036.08629
3281,166,1048260,1666080,617820,696096.0,762718.8,541114.272949,607607.044976
1765,122,861720,861720,0,205278.84375,85032.0,0.0,41933.3309491
4915,142,4047060,7299960,3252900,3301114.5,3108034.8,2696834.25372,3369575.59435
8274,14,1010460,1327560,317100,325420.28125,307354.8,257379.175781,29346.5785362
2199,82,1468680,2195880,727200,911588.75,723624.0,0.0,425825.898896
3010,67,2682900,3120480,437580,419870.375,412852.8,655299.461914,562236.994398
234,124,124200,754200,630000,957433.0,1234443.6,1945142.29401,1059026.80314
5920,76,4984140,7552500,2568360,2565738.25,2570563.2,2905346.27655,2664757.79919
3709,203,808800,1897500,1088700,1082073.0,1086634.8,21596440116.3,1264899.21737
6572,32,128880,1205580,1076700,1046328.75,1029019.2,80802.5895386,687096.842769
7427,164,123540,123600,60,26725.984375,6213.6,0.0,132172.421175
349,51,277200,280800,3600,0.0,137233.2,0.0,141844.551136
4876,168,438000,438000,0,447.427581787,22992.0,824.002258301,88840.216122
8440,30,461640,604800,143160,184464.84375,129228.0,1493779.93188,278127.032956
6777,46,1873860,2027040,153180,64433.7734375,123268.8,88375.3961182,-57449.6316337
2005,63,529740,6232860,5703120,5687439.5,5692708.8,4790264.18665,5078613.54949
8583,30,552240,604800,52560,50373.4140625,61436.4,1211.34899902,-181484.111671
4750,151,1594680,3643800,2049120,2051968.625,2019674.4,1994585.72858,2056969.3018
957,80,338580,338580,0,0.0,174076.8,746857.943665,302138.955019
1891,133,507240,6181200,5673960,5696307.5,5430900.0,5590773.16534,5093181.44262
7947,63,5432940,6232860,799920,854089.375,797348.4,0.0,622402.649861
6097,174,232860,1300440,1067580,1055209.875,1097830.8,1314995.77539,943473.412062
8438,30,461100,604800,143700,168481.09375,140948.4,976506.438599,178607.433798
7041,195,117360,393120,275760,336355.28125,387650.4,0.0,305163.785995
2176,101,263400,655020,391620,392969.625,564986.4,0.0,56313.0781102
2813,165,123480,1262880,1139400,1263494.5,1391830.8,1960516.62933,1044465.00684
2835,158,262320,2044680,1782360,2113584.0,2017508.4,2651564.01355,2415803.12594
6616,204,649740,2567700,1917960,1855527.375,1838002.8,1761893.35504,2111600.27021
4067,184,676800,1800900,1124100,1069362.125,1027456.8,718720.23114,737882.920173
8808,76,7413120,7552500,139380,140167.078125,271364.4,0.0,25026.2651848
7810,22,0,810360,810360,535641.5,441946.8,270780.903564,1022591.55418
5739,216,465780,496500,30720,36253.421875,56084.4,125144.158569,-288864.585096
5902,57,255060,2756640,2501580,2487000.75,2497000.8,9761428332.82,2317720.88379
7755,58,65940,992100,926160,930585.5,867352.8,0.0,-22668.7042408
3332,130,1828800,3083940,1255140,1306377.125,1135368.0,483272.782227,915969.206852
8307,208,1546260,1620480,74220,97351.125,127434.0,32007.3205566,119381.688123
2600,123,952320,3545820,2593500,2587547.5,2560491.6,2402443.61194,2649721.89603
2864,141,2443920,7406100,4962180,4820744.5,4912462.8,4280526.78577,4488762.34595
1796,63,377940,6232860,5854920,5864204.5,5854262.4,4617134.79456,5453857.72237
2258,75,1452660,6135000,4682340,3711157.75,4223692.8,7172207223.15,3554607.45848
6990,146,6022800,6670800,648000,654824.8125,672030.0,830444.648254,774283.191371
7184,14,81120,1327560,1246440,1240912.75,1203406.8,0.0,1102964.69751
1610,132,220740,1658640,1437900,1501138.875,1127496.0,2713893.88025,2270364.03781
2899,114,48120,1201080,1152960,1569695.0,1573982.4,2227836.84363,2033507.34684
2217,84,1845360,3714840,1869480,1931117.0,2081066.4,1819859.89899,1739524.90468
4484,186,34080,3636240,3602160,3086329.25,2393023.2,1022740.13489,981297.06298
4406,152,137760,3766500,3628740,1793712.75,1532548.8,1149194.15399,1387066.80306
7725,178,423060,904200,481140,242345.015625,270214.8,392783.036133,351311.864708
3518,71,2416620,3996240,1579620,1655295.875,1428258.0,1543945.27246,919656.626482
6256,204,409080,2567700,2158620,2110135.0,2033463.6,2678400.81439,2441882.37938
8903,190,615480,705600,90120,94089.75,324339.6,0.0,-836592.191449
1491,110,1331400,5579400,4248000,4158999.5,4234755.6,3504514.56952,3141933.43834
8062,159,2006880,2480580,473700,390924.1875,458983.2,0.0,-213012.613586
1011,66,937080,4817700,3880620,3902438.25,3727509.6,4124525.3855,3685745.33557
125,106,18000,1023180,1005180,996210.9375,986809.2,0.0,729528.572717
6227,162,2835720,4836120,2000400,1968782.5,1965604.8,1954334.63843,2236675.3457
7485,27,185460,402780,217320,230280.53125,212011.2,2612707.39362,2188558.23813
3968,71,2857200,3996240,1139040,1137283.125,1139394.0,1272505.9577,960390.134175
4152,114,1164180,1201080,36900,34834.4453125,83460.0,0.0,-84320.3314724
4732,187,62100,2496960,2434860,2045538.875,2021029.2,740438.616821,903077.9006
2332,23,64380,1894920,1830540,1786613.75,1781001.6,2192387411.75,2090784.30641
6403,151,2909040,3643800,734760,769808.1875,728622.0,955870.363342,926390.100726
5083,146,4369680,6670800,2301120,2338309.5,2265546.0,18445338070.6,2297734.8291
5865,196,706860,3281700,2574840,2483550.5,2501606.4,2667235.38257,2323210.2995
6521,10,813600,979740,166140,156780.6875,164016.0,557691.332642,-64691.1630892
6895,195,34920,393120,358200,461599.75,607870.8,959568.851746,998966.787755
1134,76,1087200,7552500,6465300,6468692.5,6472982.4,6412616.0589,6187242.31217
6606,5,155340,748200,592860,566281.3125,501505.2,0.0,146498.245058
1409,1,44580,1447140,1402560,1527410.75,1430624.4,0.0,289717.27025
6150,131,4603320,6825900,2222580,2221739.75,2232434.4,2405074.91504,2089847.19801
748,80,181920,338580,156660,261235.671875,806314.8,983039.466858,1587469.66114
9041,131,6822300,6825900,3600,0.0,2625.6,0.0,197586.653643
1502,12,235500,850020,614520,598960.875,662647.2,60835.3825073,826704.050986
6916,222,222300,1113000,890700,871653.1875,864880.8,44809.4098511,244364.170914
3251,77,1896660,3257040,1360380,1328492.0,1419594.0,1235195.8501,1603013.12699
1729,79,1555200,4151700,2596500,2656048.25,2626297.2,1777739.08508,2499002.43911
3892,213,25680,3206820,3181140,2661760.0,2578555.2,2778399.34393,1920923.4733
2957,135,2083920,5649480,3565560,3110273.0,3018696.0,4012650.22998,3517333.31434
8237,63,5633340,6232860,599520,599100.75,599496.0,237833005.394,452351.449486
6166,98,5131800,7319880,2188080,2188331.5,2181008.4,6510822560.63,2281502.70999
2986,132,1430400,1658640,228240,217777.140625,275227.2,970664.864136,317506.591281
5192,157,64680,1993260,1928580,1880220.5,1566806.4,1165408.67981,1124766.30421
7068,209,4500,1091400,1086900,1192115.0,1295682.0,619908.971436,816467.090451
4882,161,1870080,1955580,85500,212351.65625,78118.8,0.0,337284.328951
4136,153,1401480,1618560,217080,289997.5,257486.4,1753342.12146,1370101.15181
2195,63,644340,6232860,5588520,5578528.5,5586255.6,4934675.89111,5298926.54796
5350,177,1315440,1713060,397620,504050.53125,466906.8,481528.546997,523128.890113
9067,76,7552500,7552500,0,91458.140625,52027.2,26137.8673706,124792.493132
2186,1,716880,1447140,730260,718521.75,735927.6,1178654.1156,576135.083705
6731,75,5159760,6135000,975240,972739.0,974971.2,1334186.02771,1056798.16676
17,149,0,223140,223140,2442661.0,2154589.2,1688476.25183,2309193.48488
7739,219,2875140,3797940,922800,950337.6875,923595.6,1515227.29797,1221727.58726
1481,146,1341840,6670800,5328960,5365412.5,5330714.4,5921877.38153,5195520.19641
6555,208,28440,1620480,1592040,1623876.875,1783622.4,2020320.23083,2083453.56622
6759,75,5178000,6135000,957000,965925.9375,905856.0,923874.860107,965558.506617
1128,121,611700,856140,244440,268288.25,278940.0,0.0,-590220.076825
7224,61,6225300,6225300,0,0.0,59532.0,1543569.50159,112823.229844
2970,162,74400,4836120,4761720,4885163.0,4694340.0,2939819.42908,3380851.51708
7382,195,328200,393120,64920,225923.265625,88416.0,0.0,-463842.441961
5057,156,2488260,2639280,151020,160016.375,146766.0,0.0,-54897.9675669
7299,219,2444940,3797940,1353000,1336531.0,1236296.4,1723920.11829,1654661.70582
5516,213,1261740,3206820,1945080,1925464.25,1916229.6,0.0,2293022.0713
8728,188,4245960,4327560,81600,71828.15625,70470.0,0.0,-120075.153269
4332,84,3684300,3714840,30540,0.0,140617.2,0.0,105112.208282
948,76,794460,7552500,6758040,6757222.5,6757206.0,6741923.25342,6816735.03494
6670,4,856860,1326000,469140,473663.4375,360045.6,418742.655762,245882.503389
5786,177,1709460,1713060,3600,52536.859375,363500.4,69478.1529541,-443841.920238
3032,130,1473480,3083940,1610460,1589206.875,1613140.8,1547924.00616,1951358.432
5061,157,0,1993260,1993260,1268104.625,931041.6,1371209.67694,1306770.15674
1686,133,244080,6181200,5937120,5861222.0,5861551.2,4482740.63281,4486393.68138
4645,133,2859600,6181200,3321600,3246302.5,3322562.4,3722032.53363,3405960.12875
1466,33,64680,78900,14220,0.0,119968.8,407281.360718,645026.099309
3222,77,1872060,3257040,1384980,1364339.875,1505070.0,2101775.01263,1719168.49501
3711,203,813900,1897500,1083600,1116971.0,1081045.2,1006191.54401,1498600.80048
2740,73,0,1303500,1303500,1870578.25,1725522.0,2318374.13739,2297580.10017
529,91,283440,1030200,746760,745664.25,827668.8,1628876.55109,1109642.92
3309,192,331980,4648740,4316760,4329547.0,4313472.0,4253908.56714,3567662.88417
6089,204,239340,2567700,2328360,2290386.75,2354798.4,2865459.42889,3073165.14007
4117,218,108840,1974480,1865640,1506624.375,1162125.6,1805255.78033,1026314.05987
9073,37,736020,736020,0,0.0,18568.8,0.0,417009.831648
1256,61,1266180,6225300,4959120,4943990.0,4955938.8,0.0,5182089.40717
3007,130,1458360,3083940,1625580,1641772.625,1623386.4,1872651.62,1871398.35141
4417,0,1514820,1560960,46140,48368.3867188,285856.8,0.0,435021.182237
793,84,545100,3714840,3169740,2805974.75,2641033.2,2551788.25702,2670288.95553
968,118,229500,459900,230400,344048.8125,389018.4,1550919.02594,733959.087012
407,76,367200,7552500,7185300,7240812.0,7180320.0,8377979.32336,9350186.42484
2156,94,188280,534480,346200,319336.90625,423942.0,882457.705444,1355344.97859
7211,213,2640480,3206820,566340,541551.8125,557197.2,1639819.66772,645581.904907
5577,213,1304760,3206820,1902060,1909943.125,1898206.8,1670989.11865,1885427.66316
5654,220,60480,2714040,2653560,2402260.75,2498750.4,2393016.95526,2270794.63743
6239,11,76020,1777560,1701540,1674321.75,1681378.8,2530899.59113,2123013.40777
1448,133,70620,6181200,6110580,5910207.0,5974126.8,4782438.7326,4560795.10577
2075,108,695340,3191940,2496600,2393683.5,2287932.0,3183149.271,2768393.13358
6274,63,4104120,6232860,2128740,2131377.5,2136177.6,448642660.213,2248648.09333
7209,162,3587460,4836120,1248660,1229154.25,1240410.0,1604269.07544,1214445.44232
8885,219,3717540,3797940,80400,47023.7617188,73156.8,136631.57605,186367.691923
944,80,313200,338580,25380,7072.52636719,287908.8,214467.551208,390168.370102
7531,16,117000,117000,0,29854.3339844,14994.0,279267.844177,-112020.544021
221,84,26520,3714840,3688320,4509497.0,3236188.8,4583291.61176,4227874.9632
7103,213,2585880,3206820,620940,633852.625,645055.2,1211898.23737,632743.783747
6631,75,5079180,6135000,1055820,1056803.125,1047140.4,1192809.96729,724128.722264
8970,42,914700,953340,38640,94490.0859375,53780.4,3408450698.5,23402.2870377
4403,215,1457460,1851720,394260,322687.625,332649.6,425062.096497,-203121.666337
87,149,77940,223140,145200,366460.75,264090.0,1729978.86127,1683130.53688
2632,161,16320,1955580,1939260,2012662.75,1904907.6,0.0,1691468.07604
1733,98,1448280,7319880,5871600,5889424.0,5858026.8,6507537.66357,5888175.4458
7847,209,644880,1091400,446520,527143.875,226122.0,638726.989197,908787.457377
2797,171,271260,435600,164340,231158.328125,401332.8,1325568.07129,1415978.78177
4849,103,3973320,4719960,746640,742461.125,664209.6,819113.701721,716622.686381
7861,13,1673760,2525940,852180,829624.0625,852610.8,1336933.0697,822061.295416
6672,31,364500,1374660,1010160,901693.875,874153.2,450507.707703,680508.812647
93,149,83520,223140,139620,46091.1015625,218352.0,1969620.71039,1975722.40051
1173,122,310320,861720,551400,601812.0,594213.6,855782.499268,1318855.46777
3006,130,1458360,3083940,1625580,1612916.625,1618167.6,1531995.78943,1871398.35141
6817,204,913920,2567700,1653780,1620519.25,1617746.4,1438239.84875,1572992.26998
6254,63,4088880,6232860,2143980,2191587.75,2141451.6,600804199.413,2163299.33775
811,106,637560,1023180,385620,372104.6875,388210.8,639526.189636,615147.318197
2378,166,183600,1666080,1482480,1454996.875,1254936.0,1985647.86804,2220889.04646
3957,79,3487500,4151700,664200,636859.9375,843649.2,1788208.37561,1022337.12684
7969,2,2555640,2555640,0,102306.765625,199004.4,26877.4651489,-541039.734007
8253,220,2153340,2714040,560700,578008.875,502538.4,387686.352905,305440.632775
6279,18,22800,1779540,1756740,1786223.0,1719444.0,1182540.94525,1496185.73408
7248,213,2668680,3206820,538140,519353.4375,539340.0,0.0,438836.303815
4092,107,1270620,4991760,3721140,3455140.0,3731169.6,3484839.48486,3494812.45924
2908,142,2353500,7299960,4946460,4909741.5,4944224.4,5325862.63623,5253797.71321
6115,220,493800,2714040,2220240,2205578.0,2234332.8,2587378.86212,2452573.18927
8277,14,1017720,1327560,309840,322474.75,301693.2,817029.517883,291589.526309
1095,127,534540,599940,65400,85275.375,129447.6,111993.863892,222100.15921
1506,105,1314420,1314480,60,0.0,92054.4,355876.682983,145985.436381
6661,46,1783380,2027040,243660,12881.1054688,102560.4,523038.659851,42665.4792039
4878,156,2380080,2639280,259200,164227.015625,218702.4,473067.085144,-13469.685182
7311,24,1485300,1547520,62220,53828.3164062,86986.8,39759.4313965,152582.343028
6195,63,4046940,6232860,2185920,2180245.5,2189421.6,0.0,2164828.94458
2853,158,268740,2044680,1775940,1838539.875,1862041.2,2132887.22485,2483985.55052
1928,63,473940,6232860,5758920,5781549.5,5759444.4,5196785.47754,5790329.49424
933,66,824340,4817700,3993360,3613314.75,3958156.8,4633280.23987,4394451.58146
2174,94,198600,534480,335880,422364.9375,382201.2,1146908.50226,1441626.23117
7925,7,0,40380,40380,792893.1875,544384.8,1532426.92291,667484.958613
7966,209,716220,1091400,375180,351021.25,354141.6,2031463.39313,1783054.58737
7289,15,544080,1822860,1278780,1276824.125,1229666.4,1447083.1828,885193.843232
4113,163,95640,548880,453240,595974.0,607476.0,962582.640137,959642.265946
1089,72,406980,2385960,1978980,2060012.25,1979232.0,3526551.83844,3093963.71353
1880,111,1836060,3974400,2138340,2157290.75,2165428.8,1983293.90735,2186647.6342
395,53,19620,582540,562920,423436.9375,836864.4,1319334.47388,2049211.38708
2042,144,1292040,1807260,515220,512853.09375,487762.8,492743.277771,718750.046797
4973,135,3759180,5649480,1890300,1835504.125,1868977.2,1383069.66925,1713998.05014
1263,122,374700,861720,487020,487741.65625,547323.6,1325883.41711,771501.356128
6221,146,5396340,6670800,1274460,1264464.125,1310412.0,1508217.90308,1291053.73933
6084,204,151980,2567700,2415720,2402062.25,2402931.6,3279649.84167,3107288.21953
3594,199,48000,975720,927720,1493487.75,1645813.2,1756668.12701,2110330.62492
361,142,66300,7299960,7233660,7300013.5,7031540.4,4695924.77606,4249912.58952
6380,141,5365380,7406100,2040720,1905389.0,1971868.8,0.0,1978701.39581
8153,13,1844760,2525940,681180,664462.625,666222.0,0.0,822599.630223
5449,214,267900,341760,73860,183533.515625,213816.0,1355607.07605,775638.797209
5944,76,4999500,7552500,2553000,2544871.0,2559199.2,30441745505.9,2896136.04097
6562,32,117660,1205580,1087920,1043773.75,1001559.6,364230.075134,858558.090547
3261,130,1784820,3083940,1299120,1305092.625,1300861.2,0.0,1607041.20883
1602,123,0,3545820,3545820,3648501.25,3527718.0,3064228.82703,2736414.59666
1944,94,40380,534480,494100,346939.4375,602479.2,1721737.91284,1591722.59881
2134,134,654600,3656580,3001980,2962988.0,3043113.6,2291058.12915,1801348.37196
8805,13,2388000,2525940,137940,149300.90625,136730.4,12741132479.0,80717.77866
673,87,567660,1090800,523140,491885.34375,608404.8,986823.378601,777994.972927
5335,63,3208080,6232860,3024780,2990890.5,3052010.4,9002607061.01,2918221.55435
4533,107,1534200,4991760,3457560,3476042.5,3438938.4,2914832.68781,3327187.7098
2781,171,254460,435600,181140,142922.546875,290065.2,1445158.27765,1525791.08811
6730,5,242700,748200,505500,549383.625,563804.4,309686.568665,375847.826473
1463,146,1338000,6670800,5332800,5340274.5,5372785.2,4821721.91034,5186113.07654
821,127,164340,599940,435600,424224.40625,521536.8,276445.537354,801110.460808
8676,37,526560,736020,209460,214995.171875,209352.0,0.0,321182.417658
5000,71,3585720,3996240,410520,374363.09375,402105.6,20448667580.9,300882.359654
6936,204,998580,2567700,1569120,1621756.625,1563942.0,1209896.65204,1511323.03605
8495,40,0,163800,163800,916993.25,190357.2,904346.272095,436217.700837
1920,96,11460,2123400,2111940,2019845.5,2067024.0,1507901.33057,1655518.17114
8866,196,3192900,3281700,88800,92501.921875,93715.2,0.0,-69919.679009
1496,140,1207680,1300140,92460,49682.703125,81087.6,559485.553589,888912.595221
6874,151,3353580,3643800,290220,276728.15625,285505.2,0.0,204531.787281
763,142,436140,7299960,6863820,6998159.5,6865507.2,6322277.96918,6139389.30237
5552,169,664260,2190660,1526400,1449650.0,1510130.4,796923.530212,1314557.31161
5105,103,4113300,4719960,606660,596221.5625,611739.6,3644350528.53,779644.432491
6674,204,678780,2567700,1888920,2475499.75,2157052.8,1785573.07977,2355572.09277
5067,213,852900,3206820,2353920,2330507.75,2345137.2,1011170.76715,2384288.62071
5973,10,263820,979740,715920,717494.375,741182.4,852201.01062,496147.16044
1681,76,1468800,7552500,6083700,6086391.0,5738145.6,6429059.1806,6427364.52261
8746,162,4834680,4836120,1440,35042.625,180376.8,0.0,-279451.820904
4729,213,674940,3206820,2531880,2553045.0,2529853.2,2764621.09216,2530060.82447
862,76,724860,7552500,6827640,6842078.0,6828171.6,6369420.88629,6357448.58614
2688,96,651000,2123400,1472400,1358489.625,1335468.0,532948.658142,1148613.34795
6353,196,1209300,3281700,2072400,2084483.5,2072062.8,1955578.90704,2164233.81854
