,id,elapsed_time,total_time,remaining_time,XG_2000,RF_50,LM_pred,Lasso
5523,76,4772400,7556100,2783700,2784798.5,2787022.8,2607666.70117,2800191.97452
113,76,56100,7556100,7500000,7483941.5,6810625.2,5622463.74219,4347066.66998
5932,204,0,2571300,2571300,1617036.75,1455072.0,2077949.87695,1462805.13105
5616,220,20400,2717640,2697240,2023652.5,1999714.8,1654770.01562,2036899.90072
4190,203,1248900,1897500,648600,653923.3125,635186.4,63474768039.0,371350.229568
3116,141,2744100,7409700,4665600,4695101.0,4672953.6,4636872.31641,4733533.98438
7743,98,6421080,7323480,902400,877356.625,905942.4,1162517.2793,1173450.33604
8393,196,2911380,3285300,373920,365993.625,376340.4,249524.886719,528966.487084
5314,156,2635680,2639280,3600,2448.55810547,8280.0,706217.804688,-165138.711518
6486,63,4244220,6236460,1992240,2049418.25,2021036.4,44235693560.3,2298519.86631
2305,98,1845180,7323480,5478300,5478983.5,5436250.8,6856190.30859,5321869.63953
5305,214,24420,341760,317340,263189.5,366268.8,266884.123047,373479.730937
1924,83,1263420,1818000,554580,594762.9375,706161.6,476619.322266,743889.417508
7052,151,3467400,3643800,176400,189644.265625,184525.2,448742.46875,-61124.8836156
4759,131,3459900,6829500,3369600,3377041.0,3382628.4,3623888.80078,3265640.38999
4432,63,2540880,6236460,3695580,3676767.75,3676290.0,1.63919496333e+11,3787654.09813
6798,75,5332500,6135000,802500,801557.25,812208.0,482965.154297,893639.193474
7568,75,5916660,6135000,218340,416803.71875,804255.6,107069.693359,-147777.851398
5104,103,4112820,4719960,607140,609778.0625,609187.2,0.0,744576.694441
8017,22,112980,813960,700980,618068.3125,604648.8,0.0,14411.4787856
1184,129,1184400,1188000,3600,0.0,440556.0,0.0,-1359478.37305
2752,156,619440,2639280,2019840,2010008.875,2013909.6,1981036.55664,1606335.97465
5425,63,3401940,6236460,2834520,2830453.0,2837373.6,3521855.69141,2940835.40493
5917,220,180060,2717640,2537580,2450383.5,2378235.6,1770336.32617,2543268.27675
4167,163,117840,548880,431040,658290.9375,479122.8,0.0,336684.688815
115,146,70560,6670800,6600240,5906097.5,5488482.0,5169269.44336,4637334.76404
8899,58,911160,995700,84540,93617.3125,94706.4,165161.408203,-227171.428667
1291,66,1261200,4817700,3556500,3541246.5,3608564.4,3060721.24414,3422269.16693
7500,13,1308240,2529540,1221300,1123014.75,1218362.4,418233.951172,771712.568733
7932,220,1936440,2717640,781200,778902.8125,782505.6,756302.396484,747389.3593
3093,130,1540380,3083940,1543560,1613353.5,1517940.0,1077133.19141,1937699.06323
7625,63,5218140,6236460,1018320,1036556.5625,983118.0,0.0,935859.439369
1564,110,1391040,5579400,4188360,4197498.0,4188565.2,3998544.42969,3827214.20567
1295,66,1269600,4817700,3548100,3541916.75,3579547.2,3160938.86328,3418700.99813
3817,182,242580,915060,672480,722755.625,721753.2,38969.9589844,-170164.986719
4014,203,1147080,1897500,750420,758413.0625,741362.4,0.0,776462.508423
660,84,464940,3714840,3249900,3282446.5,3272181.6,3796889.79688,3223305.05074
6473,218,1974480,1974480,0,6137.76855469,41173.2,0.0,-217996.168928
2979,67,2667840,3120480,452640,523849.75,359328.0,664890.580078,862735.894695
4356,107,1441800,4995360,3553560,3481939.5,3554185.2,3238202.59766,3348614.64084
4442,156,1998000,2639280,641280,643091.9375,629718.0,1117085.60156,790827.92783
3743,73,847500,1303500,456000,486356.3125,418645.2,620888.511719,1102180.07785
20,67,300,3120480,3120180,3105979.25,2500312.8,2.03187096149e+12,2301712.55481
4474,135,3333660,5649480,2315820,2249204.75,2298598.8,2648868.93555,2268471.22607
8269,196,2768520,3285300,516780,504831.0,505350.0,0.0,406548.902153
4539,151,1342740,3643800,2301060,2591447.25,2296173.6,2718717.49414,2790366.56256
1050,118,329820,459900,130080,166877.78125,174884.4,423489.462891,371607.953716
6299,146,5444400,6670800,1226400,1279105.75,1281506.4,28827275511.8,1361494.53138
869,110,727680,5579400,4851720,4759429.0,4624988.4,3579116.19141,3088764.33846
2959,114,99480,1201080,1101600,762980.25,1049179.2,1782732.53516,1536527.73758
3069,72,2061960,2385960,324000,479290.6875,395635.2,1707213.8418,1145507.84008
4107,0,1330860,1560960,230100,436688.90625,280328.4,1285825.17188,989014.446376
7931,15,1100820,1826460,725640,720096.0625,734859.6,411459.753906,773323.602575
1201,77,73320,3257040,3183720,3155127.75,3271846.8,1123414.61133,1848130.56176
313,91,14460,1030200,1015740,1615290.125,2124835.2,2911830.06445,3146152.03967
7885,42,113880,956940,843060,671471.4375,627424.8,1920254.75781,1148834.91804
4297,213,284520,3206820,2922300,3033460.5,2925712.8,3617796.52539,3753927.63636
3788,130,2147460,3083940,936480,897633.375,936597.6,0.0,1095102.12566
1250,140,1051320,1300140,248820,283767.375,246525.6,510875.417969,714321.912267
8477,139,24600,273900,249300,225995.765625,230829.6,264012.623047,284681.18482
2193,101,272460,655020,382560,352403.0,409954.8,545112.957031,53952.4835889
8450,224,339180,651660,312480,328637.625,277078.8,0.0,-183102.013146
7001,204,1026180,2571300,1545120,1535092.5,1547474.4,1433534.38867,1483646.24737
5771,134,3652980,3656580,3600,258859.09375,352934.4,124392.826172,-246842.197778
1651,97,292800,294600,1800,804016.6875,945195.6,2392459.38086,2441933.0182
8458,37,396600,739620,343020,351638.0,344085.6,502594.382812,802509.910153
4877,130,3055140,3083940,28800,0.0,60664.8,0.0,-190275.236092
5090,19,16740,608940,592200,736081.9375,1001613.6,401424.9375,321738.330017
8426,65,7196640,7548000,351360,341180.1875,346680.0,413300.794922,214455.689662
2509,153,34080,1618560,1584480,1753399.125,1708630.8,691063.603516,1641108.2584
3077,142,2489160,7303560,4814400,4881308.5,4810275.6,4330610.11328,4901239.09874
7585,131,5790300,6829500,1039200,1042056.0,1014139.2,1185940.96875,1020267.86268
2324,63,737280,6236460,5499180,5506989.0,5491728.0,15651679428.6,5477592.43174
3066,141,2591760,7409700,4817940,4841588.0,4818318.0,5113009.79102,5109289.6999
696,84,511380,3714840,3203460,3120124.5,3157462.8,3253798.44336,3645478.09894
6852,187,1814940,2496960,682020,636274.6875,594913.2,494609.287109,37593.662016
4234,213,247140,3206820,2959680,2977537.0,2961339.6,3468618.40234,3489259.90352
9021,37,719100,739620,20520,22883.1738281,25119.6,150465.283203,407661.880516
3636,71,2502720,3996240,1493520,1497862.625,1484256.0,2243340.17969,1599587.03964
5848,123,3544020,3545820,1800,197716.171875,466603.2,0.0,214442.499517
6882,5,465900,748200,282300,244029.203125,269265.6,217072.929688,282184.013224
8667,30,608400,608400,0,0.0,26160.0,0.0,-228109.642724
8875,224,590460,651660,61200,151900.34375,336152.4,37558.7753906,-27849.073383
8355,14,1102920,1331160,228240,439745.125,227160.0,0.0,265014.684354
2105,77,827040,3257040,2430000,2377205.25,2379181.2,2706869.16797,2573275.68897
922,131,35340,6829500,6794160,7135024.0,6704386.8,5058735.16211,4378827.88312
3264,107,582180,4995360,4413180,4385841.5,4342578.0,4546949.70508,4148785.7652
8554,196,3023700,3285300,261600,262476.0,263922.0,0.0,196592.591264
3921,60,3429600,7404900,3975300,2881812.25,3414105.6,4414755.44531,4061866.13084
8391,37,351720,739620,387900,384951.75,374622.0,2443757.82422,2927542.11308
588,106,506220,1023180,516960,523073.0625,536164.8,0.0,565551.370475
213,146,156420,6670800,6514380,6378908.0,6436567.2,5518559.91211,5108390.94266
1998,63,527820,6236460,5708640,5772448.0,5715780.0,6150087.6543,5946191.54514
5808,4,118140,1326000,1207860,1196736.5,1160516.4,436459.509766,441955.921933
2189,166,24600,1666080,1641480,1237529.625,1598726.4,1343478.69141,1108388.41663
5075,62,3592860,3674460,81600,188854.3125,92737.2,166626.978516,639305.372163
3232,192,287700,4652340,4364640,4377614.0,4365741.6,4405896.5,4005095.18181
5735,4,84720,1326000,1241280,1343214.125,1263880.8,511843.089844,502444.429233
3703,203,807900,1897500,1089600,1102799.875,1092110.4,1.6630810263e+11,1268961.84861
5459,24,17940,1547520,1529580,1189545.75,1366255.2,2949302.21484,2280840.25692
2956,135,2083860,5649480,3565620,3232975.5,3134658.0,4207305.45898,3602675.68526
8491,65,7229640,7548000,318360,218284.15625,241278.0,297903.841797,292935.203199
6277,63,4104360,6236460,2132100,2133684.0,2132433.6,0.0,2112662.59422
6104,155,2226300,3225180,998880,976762.0625,1001836.8,208860.578125,606168.054408
5899,196,721320,3285300,2563980,2621785.5,2538063.6,0.0,2339670.88854
5939,220,194100,2717640,2523540,2383029.25,2415927.6,2311686.87891,1886352.46484
2839,203,90780,1897500,1806720,2194025.25,1547910.0,1438751.44922,1528519.47749
2517,142,2094360,7303560,5209200,5216250.0,5194230.0,7838572416.22,4945037.81945
2485,143,366300,1898460,1532160,1532639.625,1453611.6,1253064.23047,1161550.46457
5574,10,40800,979740,938940,1619349.125,1207803.6,1283595.77344,1481643.92843
6596,131,4905060,6829500,1924440,1929043.625,1900729.2,67135248141.1,2063475.66539
2455,101,599220,655020,55800,20453.7246094,248570.4,0.0,-499455.111934
6955,204,1002960,2571300,1568340,1573275.5,1566812.4,1416963.03125,1529538.06537
8578,64,6733500,6848760,115260,116334.148438,130190.4,601109.435547,-34961.9630029
6346,63,4157520,6236460,2078940,2097055.375,2076730.8,0.0,2270239.22269
891,144,174840,1807260,1632420,1612614.0,1506475.2,1867204.64258,1851120.64744
8892,13,2440020,2529540,89520,92249.2109375,98875.2,1.11037003176e+11,145613.020133
3772,147,1479360,1479360,0,263.175811768,75902.4,429906.646484,142843.491773
7968,2,2555580,2555640,60,106160.007812,208768.8,17253.7246094,-165911.193138
2166,112,908100,1303440,395340,449671.9375,380338.8,719831.589844,533351.205712
3706,203,808200,1897500,1089300,1100865.25,1090412.4,1.7457587099e+11,1274757.82572
3254,130,1782480,3083940,1301460,1388890.875,1332248.4,852968.861328,1305502.89453
8377,14,1118640,1331160,212520,166971.40625,210238.8,0.0,394328.702465
3775,188,192360,4331160,4138800,4184959.5,3536166.0,3251976.72266,2538743.60025
2131,77,859440,3257040,2397600,2382695.0,2353572.0,2079736.54688,2388129.76989
6094,63,3954060,6236460,2282400,2255901.5,2353677.6,0.0,2558352.75921
4731,187,62040,2496960,2434920,2016230.0,1695697.2,467678.314453,733547.751459
3707,182,26700,915060,888360,1043691.5,956880.0,0.0,362009.433823
8940,219,3746160,3801540,55380,21171.0214844,61082.4,271310.039062,300528.804262
4119,218,109020,1974480,1865460,1630886.625,1165401.6,1514688.46094,1022841.39689
8853,13,2425020,2529540,104520,108492.867188,107005.2,0.0,16542.6297754
5809,4,118200,1326000,1207800,1218608.25,1180726.8,567975.064453,441930.435013
5388,214,234840,341760,106920,109348.429688,136743.6,922116.720703,322678.405954
5986,204,44700,2571300,2526600,2340546.0,2498156.4,3285937.77539,2756074.71176
7415,8,0,615060,615060,489245.4375,584361.6,658264.964844,617898.014645
942,83,258120,1818000,1559880,1398870.0,1586263.2,2684304.27734,2243634.76262
1374,103,1002120,4719960,3717840,3734179.25,3661027.2,3392825.20703,3709324.34477
1238,131,450480,6829500,6379020,6257958.0,6360618.0,5348637.25195,4966751.47781
7031,157,1684200,1993260,309060,295479.90625,327284.4,0.0,144614.01007
7855,13,1671840,2529540,857700,819855.1875,857974.8,879476.859375,837388.607701
4212,119,2310780,2742780,432000,415586.65625,405313.2,429270.835938,671033.880787
6998,222,268800,1113000,844200,733471.6875,725713.2,0.0,-433342.685183
281,51,222000,280800,58800,62098.0117188,209580.0,0.0,-399933.429347
3357,130,1855380,3083940,1228560,1244245.875,1223960.4,1532526.7207,1212817.08814
295,65,214200,7548000,7333800,7357024.0,7037394.0,8082225.7793,7261102.89604
3283,148,1653900,1938900,285000,411599.0,301828.8,482062.349609,528447.516659
1102,61,1152480,6225300,5072820,5328503.0,5199602.4,4584292.35352,5206572.61222
1192,87,1090800,1090800,0,4539.34082031,58626.0,0.0,-600474.314778
1008,66,926460,4817700,3891240,3851738.5,3831297.6,3796979.98828,3927756.59333
2866,158,277800,2044680,1766880,1730494.125,1768327.2,1155667.21289,1867542.37233
2751,130,1294200,3083940,1789740,1642520.375,1736350.8,927845.738281,1642051.26482
3941,155,519000,3225180,2706180,2310717.25,2233461.6,1987073.625,1956178.16298
2188,12,850020,850020,0,166.343856812,59293.2,166250.773438,371928.976141
7606,188,3386820,4331160,944340,983987.0,929323.2,474079.298828,899727.423821
1139,104,266460,935100,668640,1501999.75,1444152.0,6599733.90234,4931741.90019
1524,132,157380,1658640,1501260,1550324.625,1391187.6,2196467.38086,2316469.2753
8776,64,6836700,6848760,12060,52904.0585938,30318.0,477261.970703,-58371.8247532
550,120,572400,576000,3600,0.0,98617.2,2506903.83789,1907326.07251
5748,213,1405140,3206820,1801680,1797669.5,1801447.2,32762401632.0,1695350.51153
829,83,177300,1818000,1640700,1604318.5,1605496.8,2344277.91211,2445241.24572
3919,166,1614600,1666080,51480,44789.8710938,137384.4,1215859.05078,368637.306999
5371,214,204420,341760,137340,241294.59375,255054.0,0.0,1364047.91821
2483,70,1690920,3064200,1373280,1340425.625,1659578.4,1103818.3125,1110514.56599
5169,98,4208580,7323480,3114900,3070983.0,3032948.4,3324066.75586,2984401.37562
4940,2,68340,2555640,2487300,2451101.75,2230586.4,1365035.04297,1283606.62225
4945,103,4020060,4719960,699900,645711.1875,628346.4,700403.193359,1018299.19302
6233,220,581580,2717640,2136060,2283387.0,2020268.4,0.0,2015573.72569
2472,143,360120,1898460,1538340,1419355.375,1474296.0,1037016.49609,715159.95859
8043,211,34560,87180,52620,0.0,218431.2,544966.748047,344918.26871
5162,217,108180,557700,449520,394441.4375,517285.2,1683277.06836,1331052.67952
5189,20,3600,39660,36060,0.0,274640.4,837780.306641,1166829.17466
3979,114,1062600,1201080,138480,137186.046875,178482.0,645981.193359,310766.651022
6820,5,431580,748200,316620,324186.25,320995.2,0.0,-245634.969885
5736,4,84720,1326000,1241280,1372982.75,1262364.0,963767.5625,747079.066804
6770,13,722280,2529540,1807260,1784026.5,1816574.4,2016303.88086,1851659.28544
6564,61,5686200,6225300,539100,604106.875,590534.4,0.0,768362.189377
6943,31,686520,1374660,688140,677324.375,711957.6,897753.320312,781163.033663
4847,2,20880,2555640,2534760,2161803.0,1979212.8,1577899.9043,624531.096735
5839,213,1459260,3206820,1747560,1746247.75,1741918.8,2006849.49414,1754772.06324
4207,135,3182400,5649480,2467080,2470008.0,2466430.8,2248592.75586,2337161.02496
6704,204,698760,2571300,1872540,1869985.25,1867563.6,2362429.125,2007079.60028
790,75,95280,6135000,6039720,6039090.5,5672578.8,5046478.18359,4360610.1308
1212,77,83580,3257040,3173460,2722965.0,3333352.8,2194502.42969,1756004.61441
6693,204,689100,2571300,1882200,1881131.5,1878538.8,1997153.94531,2083852.92564
6516,110,5567400,5579400,12000,94970.34375,204392.4,95391269784.5,245550.256702
1976,133,557340,6184800,5627460,5583899.5,5497947.6,5809819.7207,5418092.14726
8739,162,4835220,4839720,4500,3531.8671875,130528.8,431963.185547,-390937.226443
5826,220,147660,2717640,2569980,2745255.75,2442804.0,3312065.38672,3116017.11132
2375,156,252600,2639280,2386680,3032713.75,2852686.8,3048362.12109,3246210.48717
5378,71,3945600,3996240,50640,43029.6914062,91549.2,47060361161.2,342615.379698
3813,119,2052480,2742780,690300,803625.75,825678.0,1120087.35352,1271438.74147
8916,219,3735000,3801540,66540,53754.6210938,66711.6,799476.644531,235657.779694
6533,32,102240,1205580,1103340,1051252.5,980680.8,737924.652344,702878.618989
5663,193,74340,187200,112860,744321.125,846189.6,0.0,-90940.2225093
1470,138,1379340,1785600,406260,399504.3125,557894.4,517607.044922,528871.779184
368,124,257400,754200,496800,513388.03125,451680.0,0.0,95317.5334154
6238,63,4076400,6236460,2160060,2195758.5,2161213.2,1.06254186968e+11,2387865.93523
4612,142,3876600,7303560,3426960,3385642.0,3423896.4,2827380.19531,3419287.35235
3685,203,794160,1897500,1103340,1151620.625,1103104.8,1452107.08594,1326017.72733
6926,167,38100,534900,496800,420621.625,500842.8,0.0,740093.129177
8908,37,655440,739620,84180,60951.6171875,335110.8,0.0,214699.447727
1357,138,1309620,1785600,475980,478910.40625,468088.8,894114.074219,751498.706936
8146,13,1843020,2529540,686520,678632.0,697003.2,0.0,781199.398526
8936,29,51180,57540,6360,64409.4453125,13752.0,0.0,-19230.8967915
7222,205,116100,460800,344700,411361.375,607202.4,0.0,258872.621432
146,76,86400,7556100,7469700,7526245.5,7466647.2,8074557.53906,7431870.2828
8499,159,2424780,2484180,59400,10700.0458984,83042.4,0.0,-1140742.99629
486,141,372000,7409700,7037700,7040037.5,7037460.0,6715281.25586,6222874.16321
5959,56,4492800,6361440,1868640,1770754.625,1845720.0,2629135.70898,2253945.80305
1190,127,599940,599940,0,0.0,10243.2,0.0,-201337.520318
1041,88,422340,555360,133020,151594.5625,364323.6,899828.734375,1536263.34582
3165,98,2701380,7323480,4622100,4625825.0,4616064.0,4923702.27539,4768752.57994
198,138,180000,1785600,1605600,1573652.25,1559329.2,2515191.08398,2532186.57065
1218,122,347820,861720,513900,577600.3125,725445.6,412104.0,765903.113654
1881,98,1555740,7323480,5767740,5763753.5,5668690.8,6010525.16406,5925670.74175
2202,101,274740,655020,380280,369039.5,409431.6,0.0,-1076.36646233
4663,215,1729320,1851720,122400,128184.023438,101668.8,57017.0078125,-448102.397467
1820,111,1781880,3974400,2192520,2190654.25,2200513.2,2919666.61914,2200638.91059
6826,18,518700,1783140,1264440,1212813.0,1216011.6,1436563.10938,1211893.44969
7141,205,77760,460800,383040,599432.6875,726858.0,0.0,47907.9001674
8173,197,621960,626580,4620,78308.2421875,129062.4,1102286.625,1229713.00672
4083,131,2935500,6829500,3894000,3892478.25,3893161.2,3588796.1875,3613740.15587
5412,177,1488720,1713060,224340,272560.96875,333102.0,586227.640625,759832.485481
8227,37,118800,739620,620820,621824.375,640422.0,1743570.4668,1557374.92819
6343,63,4156140,6236460,2080320,2081112.625,2084847.6,24248714056.1,2171770.42968
5241,103,4186020,4719960,533940,528783.5625,569295.6,0.0,550547.986496
4934,156,2416920,2639280,222360,233780.828125,220718.4,823772.292969,395230.837713
9055,76,7552380,7556100,3720,3922.5546875,2958.0,2.52439950677e+11,126370.425397
203,149,177540,223140,45600,37554.0273438,63589.2,0.0,223989.720761
6414,54,1277460,1314000,36540,2936.20751953,113515.2,0.0,-397311.415688
3238,184,5760,1800900,1795140,1701153.75,1603796.4,1113350.3457,1276507.65057
8492,133,5981640,6184800,203160,211619.28125,226192.8,144721.767578,93821.2246234
6949,89,1731840,1736340,4500,10238.9277344,72097.2,210553.425781,421657.637444
2789,173,55680,3215700,3160020,3144758.75,3180489.6,3139641.10352,3187104.96643
7439,75,5704320,6135000,430680,432094.5625,284660.4,791514.875,434781.937093
6161,155,2279160,3225180,946020,969145.8125,984396.0,1170846.71289,399098.207312
1646,12,338640,850020,511380,509030.9375,526039.2,670405.84375,1345095.14025
309,65,225600,7548000,7322400,7520065.5,6875853.6,7910621.00781,7340028.54865
521,150,555180,626340,71160,109417.085938,332115.6,0.0,-752953.327254
1392,110,1267320,5579400,4312080,4334925.5,4268050.8,2547194.79102,3208128.54893
1253,131,459180,6829500,6370320,6252084.0,6356590.8,6317059.54492,5133850.94889
7962,7,26160,40380,14220,500168.03125,421851.6,714050.681641,693239.113171
7187,188,2990220,4331160,1340940,1342853.625,1335360.0,1535425.19727,1392774.85262
3418,166,1143000,1666080,523080,432800.65625,492771.6,0.0,401511.392377
451,150,527400,626340,98940,314315.21875,198987.6,55102.4765625,293271.168711
8950,29,54900,57540,2640,0.0,50478.0,0.0,-57126.6491723
2770,165,73440,1262880,1189440,1191479.5,1181526.0,5487163378.06,1031141.38509
5908,4,170400,1326000,1155600,1150599.375,1156213.2,1647765.56445,1087432.43825
2639,107,2940,4995360,4992420,4633484.0,4595380.8,4467611.7207,4971911.24385
367,76,284400,7556100,7271700,7265237.0,7274604.0,9016711.41211,7643346.19175
3820,151,899220,3643800,2744580,2764760.75,2743980.0,2761015.74609,2500658.00074
4351,131,3107760,6829500,3721740,3730515.0,3721597.2,3651304.91992,3788254.6267
5731,134,3624600,3656580,31980,32581.2285156,272470.8,88443.0742188,81362.1971747
5644,76,4842900,7556100,2713200,2700594.5,2604056.4,3556272.10156,2985041.03283
8014,26,1481880,2040360,558480,574653.375,546771.6,571279.523438,607542.702186
3503,188,3480,4331160,4327680,1927014.5,2889300.0,2474165.29883,2024850.69932
396,141,193140,7409700,7216560,7126760.5,7202598.0,5752926.92578,5679745.11347
1585,63,99060,6236460,6137400,6256655.0,5909079.6,4120852.30469,4089212.72763
8736,40,148620,163800,15180,544.06451416,16741.2,506326.228516,895304.463508
8129,196,2600700,3285300,684600,686906.3125,685974.0,31179971115.6,244863.629417
8559,220,2481660,2717640,235980,239274.59375,229954.8,856274.349609,353714.254462
983,75,259560,6135000,5875440,5795904.5,5772805.2,5163583.625,4488212.99265
498,60,370140,7404900,7034760,6819574.5,6743478.0,3051597.35156,4046211.27673
6935,195,72300,393120,320820,541530.1875,457408.8,1279892.12891,696740.947624
2246,156,156720,2639280,2482560,2766298.75,2666667.6,3216871.22852,3243875.12338
3139,142,2667540,7303560,4636020,4608394.5,4630923.6,4334969.08008,4685461.98745
4456,168,59820,438000,378180,319572.0625,922570.8,1806326.44922,1283754.8696
2273,75,1458060,6135000,4676940,3682823.5,3893107.2,3578967.11914,3429444.06319
4711,156,2289120,2639280,350160,348113.25,350244.0,87070.2597656,268678.729757
1762,1,432720,1447140,1014420,1042800.6875,993550.8,1071685.97852,1556163.47964
3371,203,596160,1897500,1301340,1285860.25,1293237.6,841145.072266,1071469.20327
7360,167,272100,534900,262800,247024.359375,242502.0,0.0,100121.538024
9009,63,6210540,6236460,25920,45093.2226562,24439.2,13718782082.9,46896.4392196
1544,133,119100,6184800,6065700,6068385.0,6062716.8,4417643.82812,4361559.4203
6646,10,898920,979740,80820,71277.234375,179908.8,365443.111328,-306497.48953
2674,133,1165500,6184800,5019300,5018020.5,5032188.0,6342015.36133,4838967.91512
940,83,255600,1818000,1562400,1400730.625,1596940.8,2704243.01562,2247473.50878
7644,186,2694000,3639840,945840,885905.25,805594.8,157588279.006,361820.331495
8935,57,2760240,2760240,0,165947.15625,111424.8,0.0,267908.15304
1825,98,1503360,7323480,5820120,5818660.0,5818161.6,5663590.04297,5611070.61687
3815,116,324900,786600,461700,392448.0,416852.4,212211.40625,708889.749904
3201,156,1062600,2639280,1576680,1572315.0,1578124.8,1598733.74023,1530374.76863
5430,49,3988800,3991980,3180,0.0,307116.0,29538980182.3,245328.360239
4628,191,2460,1811280,1808820,1812724.125,1560895.2,2076485.11328,970943.305931
7663,183,38040,445560,407520,604333.0,524446.8,0.0,-547971.046353
5958,63,3701340,6236460,2535120,2531224.25,2533377.6,0.0,2610213.5567
6072,13,96960,2529540,2432580,2350405.25,2403772.8,1331946.49609,1209492.73074
4724,141,4039200,7409700,3370500,3319619.0,3388408.8,2839966.0625,3081981.92365
1710,98,1316580,7323480,6006900,5964171.5,5960152.8,6138428.0918,6245292.00122
3260,130,1784820,3083940,1299120,1298304.5,1300965.6,1073543.96875,1595966.06868
7549,172,971220,1443960,472740,442698.21875,269793.6,0.0,-744235.94315
175,60,0,7404900,7404900,3600152.75,4928616.0,3082060.88477,3129392.80554
331,79,149820,4151700,4001880,3961696.0,4002506.4,5076592.36328,4381862.57137
2304,126,202560,496560,294000,297675.90625,523887.6,666936.339844,850795.918763
3523,71,2421780,3996240,1574460,1577511.5,1529563.2,1780204.6875,1145474.71845
8599,212,204240,204240,0,35006.625,86714.4,0.0,77362.2264327
2717,165,36720,1262880,1226160,1522409.875,1182294.0,925672.875,1058546.74792
7220,61,6225300,6225300,0,5585.71728516,35412.0,2.01765353795e+11,-24635.6245009
2415,94,504000,534480,30480,336508.375,360649.2,892373.953125,747174.113138
6065,204,120480,2571300,2450820,2447794.75,2429977.2,2888376.78125,3052455.9922
1987,56,1299600,6361440,5061840,5120877.0,4961008.8,4687886.82227,4235252.4842
1420,113,12240,3646740,3634500,5072079.5,5045998.8,4347054.69531,3809275.24777
1064,131,314400,6829500,6515100,6594275.0,6527341.2,5035524.3418,4493511.5256
4436,0,1521240,1560960,39720,36182.5546875,53246.4,0.0,59667.4756208
4653,74,2854140,2979600,125460,853512.75,211891.2,3316003.50391,2973060.21971
3726,73,820200,1303500,483300,582978.4375,638384.4,2568754.65625,824638.476156
246,120,226800,576000,349200,337188.9375,385297.2,1000285.51367,1551048.29335
4690,158,1846140,2044680,198540,203835.40625,211784.4,415489.890625,530110.774623
5029,86,3519180,3519180,0,269461.15625,253238.4,7640760469.43,39539.5734583
143,109,96900,274500,177600,110807.429688,273249.6,283442.464844,481431.846954
1570,1,170880,1447140,1276260,1258101.75,1369909.2,1914613.69336,2284628.93725
24,68,50400,262800,212400,616215.0625,327465.6,1507208.94336,2054645.20554
6735,204,735660,2571300,1835640,1842198.875,1843962.0,2083945.64258,1967340.11259
8180,224,14640,651660,637020,364935.65625,342661.2,0.0,220592.674584
500,79,401400,4151700,3750300,3581901.5,2855940.0,2585516.26172,3273858.71341
8446,30,467520,608400,140880,148839.625,122785.2,759467.662109,138882.759264
6833,2,1706160,2555640,849480,706449.25,724654.8,168356.285156,-33852.5849696
5862,76,4964220,7556100,2591880,2593973.5,2588670.0,0.0,2644403.63174
5680,142,4656420,7303560,2647140,2644684.0,2647611.6,3955215.93359,2795942.70765
3171,67,2944320,3120480,176160,203095.4375,178298.4,0.0,197140.379171
8991,131,6798300,6829500,31200,9117.98242188,27186.0,446730.326172,138198.606931
3782,188,197940,4331160,4133220,4771813.0,3659474.4,2646648.36523,2293850.85462
4574,135,3521760,5649480,2127720,2130341.5,2126222.4,2526005.00781,2418605.20871
1142,76,1089000,7556100,6467100,6454231.0,6462429.6,6626109.43164,6345601.06327
477,91,267420,1030200,762780,819764.25,769627.2,2173864.60547,2179207.2576
5279,113,3181500,3646740,465240,440954.46875,422988.0,118568.583984,528453.788518
7080,48,131040,156420,25380,31699.765625,105994.8,821511.138672,1003711.83445
2891,171,317100,435600,118500,102345.0625,138435.6,743580.238281,991431.771938
7376,213,2750280,3206820,456540,499700.90625,427552.8,1.22886729778e+11,-85532.8441197
2002,102,85440,3198240,3112800,3306527.25,2952974.4,2102108.79688,2006586.54038
3202,142,2706540,7303560,4597020,4594017.5,4583004.0,3975172.45508,4431345.89556
6920,151,3388680,3643800,255120,329618.4375,273283.2,1318793.79297,519455.268316
7722,76,6605880,7556100,950220,954840.1875,949894.8,0.0,1028258.66007
2278,83,1508400,1818000,309600,288570.8125,286754.4,0.0,286979.998402
6384,18,86820,1783140,1696320,1688923.5,1673770.8,1474487.65625,1507907.17471
8939,65,7487400,7548000,60600,0.0,63112.8,305852.853516,209239.429109
4883,180,989280,3322080,2332800,2284700.0,2256085.2,1555972.67578,2152769.34297
577,106,504000,1023180,519180,534431.75,555176.4,1299633.03711,369766.724193
5445,169,601320,2190660,1589340,1475676.5,1608148.8,1616684.16016,1553064.07971
5265,125,3969060,3969060,0,0.0,120285.6,0.0,-794014.555111
2267,65,2023200,7548000,5524800,5295321.0,4304428.8,5517656.10156,4835517.66703
5282,213,968460,3206820,2238360,2101814.25,2249745.6,2117467.59375,2454007.97307
555,120,576000,576000,0,0.0,98061.6,2855005.9082,2124735.45074
5268,71,3738600,3996240,257640,191092.921875,256453.2,33029777756.2,60730.8428242
4426,96,2081400,2123400,42000,132385.0,64316.4,0.0,127180.688798
6850,89,1663680,1736340,72660,152710.421875,207615.6,1225733.52344,693745.460159
2377,1,876540,1447140,570600,752042.0625,528223.2,1333758.69727,1377991.93912
9010,13,2495460,2529540,34080,63936.109375,33265.2,0.0,13047.9299856
6432,151,2922300,3643800,721500,706130.0,723685.2,1187605.11523,885649.416295
898,118,161400,459900,298500,290731.0,352137.6,705691.183594,917506.707899
1614,66,1480260,4817700,3337440,3311175.5,3372668.4,3997097.04297,3652240.84683
7212,4,1326000,1326000,0,0.0,62251.2,0.0,26274.9958574
5997,76,5042220,7556100,2513880,2524886.5,2515003.2,2072762.50391,2354672.50276
2053,83,1341780,1818000,476220,493678.96875,476054.4,663888.898438,495677.593783
7472,75,5740260,6135000,394740,375787.59375,262780.8,484432.146484,216247.345423
7511,219,2598480,3801540,1203060,1186301.875,1207555.2,1633384.09961,1460309.36947
1020,131,171240,6829500,6658260,6572679.5,6634036.8,3920897.94727,3821269.49666
1075,106,997200,1023180,25980,0.0,50418.0,380787.148438,-112333.007228
1404,130,94740,3083940,2989200,3003645.25,2990425.2,1902183.91406,3180008.59171
6183,31,38520,1374660,1336140,1340975.5,1297538.4,1249765.73438,898424.58437
1801,79,1604340,4151700,2547360,2547967.5,2549220.0,0.0,2041241.68882
5682,142,4656540,7303560,2647020,2643111.0,2644876.8,2.51325726264e+11,2795891.73381
2949,84,2489820,3714840,1225020,1246784.125,1284086.4,1360730.31836,1598926.19541
686,80,144900,338580,193680,413964.875,674440.8,1589378.10156,2049431.82858
531,93,443280,1242300,799020,994578.625,2399698.8,0.0,2479492.57148
1876,63,443160,6236460,5793300,5824838.5,5780509.2,5563241.49609,6057620.04276
2092,119,468960,2742780,2273820,2199357.25,1906064.4,1557616.68945,1941434.62972
4244,135,3215280,5649480,2434200,2435906.25,2441643.6,4605729674.25,2611994.10895
2942,50,4500,35220,30720,0.0,155282.4,0.0,275969.727317
8099,30,111420,608400,496980,499139.125,494967.6,1477638.49609,1118799.6649
6453,155,2475300,3225180,749880,745331.625,748345.2,762621.822266,890496.203229
4161,163,116040,548880,432840,574838.8125,417253.2,299355.837891,348521.547138
8251,13,1929000,2529540,600540,584917.125,591097.2,303228.361328,375135.744899
7078,167,124080,534900,410820,497329.28125,491486.4,620175.337891,659682.925828
4485,199,742740,975720,232980,231444.59375,235036.8,0.0,-47106.8435253
3771,203,865260,1897500,1032240,1040254.75,1023222.0,482372.244141,1101157.5924
524,142,279360,7303560,7024200,7378067.5,6959461.2,6364070.31641,5837229.29133
2013,102,86640,3198240,3111600,3994989.75,3108636.0,4977791.09766,3901031.40879
7960,11,1451340,1777560,326220,322651.1875,312250.8,563901.482422,717476.463684
9036,42,950280,956940,6660,85794.4921875,7802.4,237103.042969,333486.265855
3322,198,34500,708660,674160,636633.375,719497.2,323798.945312,880159.411663
8001,18,1386960,1783140,396180,377173.09375,365532.0,0.0,405472.979241
5794,169,808260,2190660,1382400,1215152.375,1353192.0,1010880.93359,1491748.24459
8373,212,49860,204240,154380,173126.84375,162079.2,0.0,-375614.664828
4998,71,3585120,3996240,411120,424480.96875,402148.8,0.0,264313.821585
7865,13,1674120,2529540,855420,839941.6875,850959.6,1041697.0918,876392.943238
7094,167,129840,534900,405060,401172.21875,405352.8,0.0,246283.587031
8335,209,1078680,1095000,16320,69767.421875,17287.2,1018531.93555,810089.906214
6148,26,9840,2040360,2030520,2111787.5,2045449.2,2543242.41211,2073120.69675
3559,137,159540,243720,84180,0.0,173058.0,0.0,-382951.806218
3334,130,1840140,3083940,1243800,1102218.25,1240974.0,728756.480469,734613.135472
3807,98,3258180,7323480,4065300,3997845.25,4019161.2,0.0,4192578.05882
8809,160,1425840,1567860,142020,136925.03125,136059.6,430066.638672,310214.600359
5720,57,168780,2760240,2591460,2846068.75,2406414.0,2116660.90234,2530432.50198
4229,107,1355400,4995360,3639960,3324804.75,3434928.0,4351203.67773,3880586.13155
2909,67,2612640,3120480,507840,509430.96875,500649.6,108526.917969,942530.159657
8363,212,42900,204240,161340,305194.1875,231074.4,0.0,-385362.717401
923,76,754920,7556100,6801180,6576995.0,6793128.0,7226356.04297,7125148.54816
4411,71,3123960,3996240,872280,877699.3125,868566.0,97164455308.0,1066790.32303
4657,63,2803020,6236460,3433440,3433494.25,3489453.6,2894232.62305,3493143.3662
1763,56,1149240,6361440,5212200,5100233.0,4124808.0,4419631.03125,4046661.38871
5658,213,1368780,3206820,1838040,1855119.875,1851972.0,1684598.66016,1959310.57288
433,87,423000,1090800,667800,645391.25,976252.8,2203076.20703,2363655.4085
1343,1,14340,1447140,1432800,2065639.375,1838617.2,0.0,1782925.34054
3963,203,1121640,1897500,775860,782809.25,824421.6,0.0,634481.408484
4890,107,1871880,4995360,3123480,2908911.0,2868146.4,3764682.64844,3366861.61078
5295,113,3188460,3646740,458280,498271.65625,234068.4,791695.677734,926878.057436
5556,98,4590180,7323480,2733300,2748539.25,2722099.2,2372020.26172,2714234.14658
5454,169,602880,2190660,1587780,1590792.625,1558405.2,0.0,1553476.63723
6490,172,169200,1443960,1274760,1291052.5,1228209.6,536229.130859,656048.701449
4114,96,1897500,2123400,225900,252555.265625,292488.0,668305.335938,349434.599549
3347,72,2385960,2385960,0,0.0,34074.0,0.0,-65896.9398991
6310,141,5330820,7409700,2078880,1832024.625,1913064.0,0.0,2384192.89819
1577,82,921360,2195880,1274520,1263258.375,1066209.6,765399.132812,1533374.66424
6260,26,93660,2040360,1946700,1957033.25,1929349.2,2897290.01172,2558166.10155
7509,157,1993260,1993260,0,90728.2578125,50775.6,498274.412109,-88914.2466919
4299,133,2530500,6184800,3654300,3644214.5,3670240.8,3780146.27539,3897515.53151
5119,141,4264200,7409700,3145500,3143214.25,3145920.0,2882141.67578,3053150.39502
9078,9,18660,18660,0,646211.1875,1375903.2,2347455.32422,2064988.08703
5795,103,4669020,4719960,50940,0.0,47455.2,0.0,176558.707078
5492,19,406860,608940,202080,283334.625,422756.4,1488299.59766,743837.086486
4477,199,739020,975720,236700,232655.671875,238436.4,142032.001953,-56558.1505247
2777,92,127320,613860,486540,434080.09375,617097.6,0.0,508185.233289
8310,26,1808760,2040360,231600,223361.71875,231121.2,898362.833984,245566.058121
1970,133,551760,6184800,5633040,5590299.5,5437815.6,6337818.83789,5255176.83972
6729,5,242700,748200,505500,534939.125,543519.6,680874.15625,512481.560588
3128,151,295980,3643800,3347820,3260350.5,2208780.0,1353782.16406,1490102.16401
7965,6,123120,133560,10440,483612.125,227473.2,1675467.67773,1400017.10469
5167,157,59160,1993260,1934100,1912092.375,1680588.0,754280.095703,860256.678068
6553,64,5032200,6848760,1816560,1790001.875,1771622.4,1675241.08984,1689965.40234
8999,206,2001960,2090340,88380,0.0,68863.2,234086.216797,26390.9799812
1619,145,68580,586680,518100,510679.8125,644725.2,1564569.70312,1666481.38892
3409,137,64320,243720,179400,207536.59375,179366.4,437813.275391,389642.499289
8867,188,4325160,4331160,6000,30768.2265625,32018.4,0.0,16603.9478094
7649,63,5228700,6236460,1007760,1002702.3125,990696.0,0.0,510327.951265
1679,110,1466700,5579400,4112700,4122157.5,4101121.2,4084164.40039,3653806.92987
1235,117,30180,1144740,1114560,1607060.125,1221693.6,3084490.79297,1952266.75867
7623,15,887340,1826460,939120,923299.8125,944952.0,856266.978516,757864.667018
2315,83,1527060,1818000,290940,282272.78125,272350.8,0.0,230712.062413
4899,142,4041360,7303560,3262200,3258957.5,3257788.8,2984190.82227,3311230.97644
9022,36,42960,129360,86400,54499.7109375,1151349.6,974820.453125,1266903.81554
5798,63,3618840,6236460,2617620,2678620.0,2619999.6,0.0,2838756.55026
2832,158,260280,2044680,1784400,1964685.75,1934314.8,1792344.51562,2146103.31623
3012,67,2683020,3120480,437460,390487.375,435438.0,365669.001953,743400.162673
954,144,239400,1807260,1567860,1457362.625,1402083.6,2632585.14258,2220993.5458
5814,63,3638520,6236460,2597940,2573048.25,2610108.0,0.0,2877249.01267
8613,30,574020,608400,34380,33044.7578125,79512.0,692441.783203,-200255.301741
8619,196,3056100,3285300,229200,180006.828125,215542.8,61734641772.9,65623.1056695
8300,14,1071300,1331160,259860,245658.734375,250052.4,509091.111328,358203.382681
8759,152,3683760,3770100,86340,137888.578125,83170.8,96026.6875,304494.547741
7523,176,1206240,1462860,256620,199972.6875,298710.0,630334.609375,-362701.428495
3598,111,3266400,3974400,708000,690692.8125,696825.6,0.0,353344.789103
2256,108,844140,3191940,2347800,2401579.0,2348160.0,2271447.77441,2563019.37476
1143,83,571380,1818000,1246620,1240730.875,1011246.0,1870495.77051,1294644.30196
902,144,182040,1807260,1625220,1493081.625,1600347.6,1726845.72363,1730271.94829
4027,203,1153500,1897500,744000,745155.0625,714613.2,900089.746094,678852.164588
3661,61,3322140,6225300,2903160,2737731.5,2880936.0,3090495.58789,2956348.48348
2230,108,808500,3191940,2383440,2238747.25,2269374.0,3096861.10742,2499889.4434
5446,107,2336520,4995360,2658840,2594673.0,2309398.8,2782828.80664,2640817.98085
8661,63,6034140,6236460,202320,200491.53125,190114.8,19416029501.1,355751.415177
5359,210,94920,1118160,1023240,1046688.6875,1063675.2,101808.623047,359221.971227
6297,31,125100,1374660,1249560,1246359.125,1246524.0,1284653.27148,1632534.69221
8716,65,7376400,7548000,171600,45205.5546875,89013.6,147180.419922,92996.1454576
3158,173,445680,3215700,2770020,2764340.0,2762911.2,3157827.4082,2492010.41613
5236,180,1194840,3322080,2127240,2131145.75,2100162.0,1857702.27734,2135407.60574
4737,186,328380,3639840,3311460,3320440.75,3199849.2,3669683.70703,2872060.73826
2943,96,828300,2123400,1295100,1298495.25,1296000.0,1234201.50586,1258122.01644
5232,20,35160,39660,4500,530868.0625,615162.0,0.0,1324373.02067
5827,220,147660,2717640,2569980,2590560.75,2442976.8,2291243.35352,2526395.91729
7019,18,631500,1783140,1151640,1149048.0,1155090.0,1245152.89258,1254254.13748
8192,14,852000,1331160,479160,601618.5,443845.2,0.0,609508.59605
6066,204,129300,2571300,2442000,2440990.25,2424718.8,2876585.11328,3096457.54466
850,103,459540,4719960,4260420,4057003.5,3492868.8,4771966.50977,3968483.47395
3197,173,465660,3215700,2750040,2745395.75,2722016.4,2048017.90234,2696896.88499
1593,142,1194360,7303560,6109200,6131776.5,6094495.2,4563079.46484,5909938.37841
2733,165,44940,1262880,1217940,1529506.375,1315022.4,34535.5429688,861513.223251
7617,15,884820,1826460,941640,923995.1875,944258.4,141183.013672,594014.766306
4577,213,563280,3206820,2643540,2658949.5,2644446.0,3139024.53516,2995456.48156
3540,84,3033540,3714840,681300,683581.5,655426.8,331455.017578,716504.229337
1316,60,1118400,7404900,6286500,5796311.0,4165467.6,5481630.04883,4713004.64986
4796,142,3985980,7303560,3317580,3307238.25,3315440.4,2736170.84961,3336523.97037
905,144,182400,1807260,1624860,1510007.5,1600083.6,1399080.63867,1591858.42003
2457,156,423780,2639280,2215500,2399463.25,2227262.4,2786485.39648,3255909.22317
6830,204,923040,2571300,1648260,1552259.5,1612012.8,2446017.75391,2024262.18519
2495,144,1740300,1807260,66960,104208.234375,67153.2,0.0,367109.879657
1711,82,1028880,2195880,1167000,1223869.125,1635340.8,1332556.85352,1619071.57295
7744,8,361680,615060,253380,227219.578125,232626.0,0.0,-599980.29167
6609,208,73140,1624080,1550940,2034979.375,1553060.4,2579181.51953,2100617.65714
8150,13,1843320,2529540,686220,688022.875,694860.0,0.0,784311.624167
1526,122,547200,861720,314520,317514.15625,316033.2,0.0,272419.023724
5422,98,4510980,7323480,2812500,2967341.0,2830364.4,3105017.47266,3060996.51616
8725,37,560820,739620,178800,180580.15625,421755.6,0.0,33245.0796217
7043,195,120120,393120,273000,326103.28125,318417.6,0.0,286084.19832
8863,13,2430060,2529540,99480,103950.875,104246.4,0.0,14401.7284923
4699,71,3408480,3996240,587760,574160.375,625585.2,0.0,552535.667413
6014,13,31680,2529540,2497860,2245086.75,2292324.0,1602483.20898,1151120.76227
2629,98,2181180,7323480,5142300,5144724.0,5134154.4,5360218.88477,5247370.77818
3621,188,76500,4331160,4254660,3703017.75,3118232.4,1825784.4043,1980923.51947
3690,116,117660,786600,668940,942235.25,730575.6,1395160.01953,1241418.96555
7731,13,1586400,2529540,943140,944091.3125,934039.2,311652.794922,1081689.23367
3893,71,2800980,3996240,1195260,1137442.0,1175102.4,2635474.875,1154110.76145
3391,155,11580,3225180,3213600,2206074.0,2988055.2,1224019.60352,1581256.97497
3595,116,47760,786600,738840,543915.5,712459.2,717374.832031,913713.049544
25,111,46800,3974400,3927600,4173781.25,4127788.8,2636060.73242,3228853.12918
1501,146,1351020,6670800,5319780,5323051.0,5323768.8,4489120.55078,4901577.48247
5629,146,4852800,6670800,1818000,1769350.625,1815733.2,0.0,1938830.65675
1160,76,1095840,7556100,6460260,6448739.5,6458317.2,7531804.54492,6316308.89351
6421,155,2451660,3225180,773520,770458.0625,780345.6,745634.591797,458247.983862
5395,146,4708680,6670800,1962120,1936402.75,1970946.0,1503907.88477,1910242.09056
938,62,13920,3674460,3660540,3325593.0,3880099.2,5728562.10547,5210195.87813
3256,161,597300,1955580,1358280,1335784.125,1119423.6,969775.908203,1499761.49184
7367,167,276600,534900,258300,228885.375,256239.6,364751.833984,103503.872245
5661,57,137760,2760240,2622480,2571473.75,2636622.0,2372630.31445,2616378.07951
3167,23,904920,1894920,990000,1012684.375,961736.4,1813070.30664,1319654.82905
3370,173,600060,3215700,2615640,2644677.5,2626304.4,2112923.20898,1723127.99946
8577,159,2480580,2484180,3600,0.0,76218.0,0.0,-1298954.00964
2783,98,2306040,7323480,5017440,4845902.0,5013309.6,5024440.08203,5034922.7884
4578,47,0,31200,31200,170176.953125,342375.6,1528538.55664,1362145.99877
3052,201,53040,1645440,1592400,1513209.75,1775142.0,2472432.74414,1960145.54384
5457,24,17340,1547520,1530180,1318135.625,1317790.8,2300696.10156,1612449.01602
6390,218,1922100,1974480,52380,87885.296875,131720.4,0.0,-541908.744866
1604,104,592500,935100,342600,351390.28125,464413.2,38329264615.4,418776.732794
7692,220,1788840,2717640,928800,853898.1875,887146.8,1549106.36914,776630.268939
6174,63,4024620,6236460,2211840,2206543.0,2210072.4,0.0,2250486.00127
263,138,251280,1785600,1534320,1420940.0,1440967.2,1766996.95703,2088549.17152
5570,142,4575780,7303560,2727780,2719473.0,2676909.6,11064882043.8,2984664.86608
111,120,105240,576000,470760,607727.5625,1142239.2,2561322.37305,2065607.90424
7514,176,1201740,1462860,261120,231923.734375,273232.8,23553.15625,-364597.376457
5832,102,3198240,3198240,0,31602.4277344,221269.2,145663.876953,310020.36259
4336,168,4140,438000,433860,2034893.75,2271721.2,1262017.76367,1453117.90578
2869,67,2600340,3120480,520140,523211.15625,531123.6,41359.59375,738498.82427
3461,137,78120,243720,165600,178158.15625,374222.4,474019.199219,299875.809751
641,100,449640,919500,469860,452662.25,514786.8,1760040.7832,1589322.08451
49,146,3180,6670800,6667620,7081208.5,6054188.4,3911214.63672,3753386.47797
6622,13,616920,2529540,1912620,1872547.5,1872824.4,2018715.69922,1581476.30704
7554,188,3343200,4331160,987960,1082699.25,1057105.2,0.0,667234.68411
5300,134,3203400,3656580,453180,455150.875,434767.2,821131.414062,304449.004885
3140,156,1028100,2639280,1611180,1347523.0,1563938.4,1241377.71094,1520978.80587
7130,213,2601360,3206820,605460,605330.5,622479.6,107961.441406,508460.292754
8020,63,5483340,6236460,753120,793567.9375,743341.2,0.0,793484.919881
506,60,373020,7404900,7031880,6841228.0,6238477.2,923366.984375,4252252.96821
1100,106,1023180,1023180,0,7521.15478516,108723.6,138985.806641,-188199.590303
67,146,39600,6670800,6631200,6651484.0,6264834.0,5111395.32617,4488301.24486
7401,27,118260,402780,284520,333450.0625,287118.0,1249232.98828,1327677.27401
8567,139,84360,273900,189540,162338.421875,158185.2,0.0,-82742.3298081
5671,193,79800,187200,107400,830898.0,924745.2,0.0,-193013.144102
1140,104,266520,935100,668580,719496.6875,855456.0,3464590.21875,3902146.15526
2253,77,950700,3257040,2306340,2279285.0,2325013.2,2984954.44922,2548751.38246
7980,25,1333860,1954980,621120,603669.3125,674354.4,81527.2167969,539753.369656
5179,20,0,39660,39660,31629.3222656,266733.6,1322634.36523,1171325.18236
6710,174,663360,1300440,637080,637933.1875,614810.4,622813.121094,275749.89984
2854,108,1373460,3191940,1818480,1821113.125,1810218.0,93410961059.3,1883240.00514
7348,178,31740,904200,872460,893078.8125,866398.8,0.0,230946.978217
4898,107,1873200,4995360,3122160,2903790.0,2928657.6,3891672.90039,3280933.8762
7152,213,2609340,3206820,597480,594806.625,596212.8,883807.826172,661500.41829
4295,63,2468100,6236460,3768360,3770361.75,3697230.0,78942260654.9,3845126.51293
6539,61,5671200,6225300,554100,635688.3125,587312.4,34680826985.2,835555.703414
2823,108,1361340,3191940,1830600,1831894.125,1823575.2,1648565.72852,1814389.57481
3237,192,298200,4652340,4354140,4378794.5,4360885.2,4493657.49219,4000634.9708
6165,131,4611060,6829500,2218440,2242979.75,2223579.6,2180688.73047,2211559.78925
4164,153,1413360,1618560,205200,202398.609375,212613.6,534225.855469,1214886.48176
4666,186,271620,3639840,3368220,3313321.5,3349304.4,3644780.13086,2944888.86686
7139,220,1297440,2717640,1420200,1420123.375,1421071.2,1765304.53711,1627877.34462
7113,167,134220,534900,400680,398136.5,401176.8,78073.4960938,217822.403654
5607,159,0,2484180,2484180,1091205.5,1459206.0,1579079.9043,1616466.5678
7823,131,5966700,6829500,862800,879104.875,860720.4,1104812.90039,1021914.59181
1980,56,1296000,6361440,5065440,4840719.0,4404026.4,4489808.21875,3683937.65169
6687,204,681900,2571300,1889400,1880640.75,1858525.2,1743387.3457,2144111.17316
387,128,346140,346200,60,473893.125,426439.2,0.0,-604505.992033
6768,46,1869420,2027040,157620,151811.640625,135072.0,742581.208984,12806.7518254
7169,14,68400,1331160,1262760,1196725.0,1165573.2,41660938128.5,1159753.14718
2088,102,121980,3198240,3076260,3484247.5,2945331.6,3492625.50781,3237712.32736
7237,14,121680,1331160,1209480,1204773.0,1114743.6,0.0,1247107.19817
2824,0,205380,1560960,1355580,2433804.5,2615394.0,2253260.54883,2283327.6406
642,124,543720,754200,210480,297970.71875,370660.8,0.0,-1233889.70553
1169,105,1083660,1314480,230820,286729.75,273153.6,300048.246094,-295660.748304
8447,196,2947680,3285300,337620,368345.34375,339175.2,678968.052734,402741.742135
8042,183,285000,445560,160560,59301.5390625,176757.6,0.0,-291151.273718
4509,71,3191760,3996240,804480,813978.0,800857.2,0.0,1008564.91703
8257,3,841980,1059180,217200,255466.203125,145441.2,0.0,-191758.083457
3439,155,26700,3225180,3198480,3068377.25,3244068.0,2601214.63672,2992426.19538
5507,24,47940,1547520,1499580,1575055.625,1348816.8,2826272.64844,2873738.54366
3037,114,145380,1201080,1055700,997629.625,1621882.8,2940834.09766,2350670.55666
4835,142,4003080,7303560,3300480,3299621.0,3300399.6,0.0,3230971.11176
2589,130,1179900,3083940,1904040,2573676.5,2116488.0,574529.517578,1519977.98401
70,68,111600,262800,151200,331463.625,575566.8,2983566.36133,2619233.04288
7908,220,1914420,2717640,803220,850893.25,801955.2,295190.511719,525687.979556
6842,5,441540,748200,306660,266326.25,321920.4,0.0,297549.21146
1328,72,599160,2385960,1786800,1980842.25,1905094.8,3260449.83008,2459876.06451
4862,168,434400,438000,3600,0.0,21184.8,516788.830078,628155.489154
3853,116,358200,786600,428400,322594.0625,404434.8,790639.658203,748144.90882
3912,71,2821680,3996240,1174560,1165708.75,1172590.8,22637077223.4,1315985.36728
2181,94,201000,534480,333480,346970.65625,346648.8,871305.435547,1613759.78765
4483,199,742260,975720,233460,231386.625,236389.2,161175.236328,-46902.948165
2397,156,281280,2639280,2358000,2471342.5,2472615.6,1849663.25391,3031003.40902
7192,219,2383320,3801540,1418220,1428780.75,1421829.6,2325883.38086,1581198.89808
3048,192,13980,4652340,4638360,4646998.0,4536904.8,4131944.63867,3763286.06738
3449,96,1310940,2123400,812460,858177.375,820882.8,902913.796875,944592.873463
2831,63,1229280,6236460,5007180,5017057.5,4999215.6,0.0,4748150.55516
8051,211,38340,87180,48840,87567.1328125,245587.2,0.0,52289.5360661
2499,102,549840,3198240,2648400,3025237.0,2214670.8,2929560.00977,2512313.59243
6107,162,2727960,4839720,2111760,2080654.75,2113110.0,2023233.19531,2398838.61362
5517,10,0,979740,979740,1728567.25,1840178.4,2523007.71094,1670320.73532
3036,162,116100,4839720,4723620,4813795.0,4705203.6,4799984.45703,4082786.20675
5320,63,3184920,6236460,3051540,3021309.0,2974150.8,2378238.29883,2919715.30311
6903,18,569340,1783140,1213800,1214552.0,1195388.4,1649103.16016,1327655.88554
1161,72,454260,2385960,1931700,1945228.25,1946598.0,46346211823.7,2392524.57818
7384,178,61800,904200,842400,641776.125,818056.8,0.0,-370830.909244
3454,114,563100,1201080,637980,607623.75,585454.8,1319368.00195,664984.871308
701,124,603000,754200,151200,137976.484375,263874.0,1020274.44727,795506.379056
4854,110,4233600,5579400,1345800,1371715.25,1295516.4,1322360.79492,1527068.93658
456,106,430440,1023180,592740,810593.75,1091181.6,2223941.52148,864640.270202
3296,92,613680,613860,180,815.877929688,113551.2,0.0,178875.909361
2731,135,1920540,5649480,3728940,3706640.5,3735070.8,3721270.44336,3587721.98877
8769,13,2369160,2529540,160380,206170.375,185198.4,1228297.38477,317556.731759
2646,156,533160,2639280,2106120,2070323.5,2100564.0,1875541.24414,1912411.82946
8763,25,1954980,1954980,0,1373016.0,308295.6,1568744.55469,1205000.94049
3869,198,541440,708660,167220,129648.046875,195201.6,0.0,-58390.1210553
4909,90,89280,1532940,1443660,1353610.125,1364223.6,1476718.77344,1233829.00314
5975,10,267000,979740,712740,707319.125,803232.0,872770.453125,447427.344131
9030,206,2023740,2090340,66600,49802.7148438,55138.8,217558.232422,367491.592232
157,110,90900,5579400,5488500,4950425.0,5148603.6,4741489.19531,4167446.2712
5948,204,12420,2571300,2558880,2371632.5,2185380.0,2541620.22656,1760615.42371
7595,27,379140,402780,23640,22586.1367188,25125.6,17629.78125,467205.750364
1623,110,1425420,5579400,4153980,4149607.75,4150938.0,2806642.21484,3121541.82628
202,128,178740,346200,167460,34411.7265625,334470.0,0.0,122439.672739
8347,224,264480,651660,387180,246699.296875,331600.8,0.0,-378510.727371
4467,186,16800,3639840,3623040,4041461.75,3081915.6,1382639.99023,1328198.2421
4373,215,1445460,1851720,406260,412463.75,389085.6,948896.205078,19017.3629177
144,106,45660,1023180,977520,977938.25,919994.4,14527613145.0,1736511.91368
94,111,119820,3974400,3854580,3745775.75,3933489.6,4348047.67188,3830365.05023
6176,210,889860,1118160,228300,309192.46875,234660.0,165615.166016,-70073.1973527
4339,203,1351500,1897500,546000,444318.28125,480040.8,2.26992398512e+11,453850.938211
5281,214,8460,341760,333300,321336.03125,365916.0,0.0,-289455.609326
3364,130,1866780,3083940,1217160,1203004.625,1218501.6,819745.271484,852585.817942
8617,37,496800,739620,242820,247560.46875,239468.4,127157.742188,356737.652262
2921,84,2467980,3714840,1246860,1211560.375,1290344.4,2092459.60352,1889659.32288
8923,219,3740940,3801540,60600,55444.53125,66390.0,445938.472656,230341.937315
2805,114,13080,1201080,1188000,1307629.625,1241331.6,1829566.16797,1762433.76913
1321,140,1110600,1300140,189540,184851.109375,187478.4,1135328.79688,1168050.87962
7283,204,1187700,2571300,1383600,1227952.625,1135722.0,1015059.47656,1378331.94434
8765,13,2366280,2529540,163260,186577.96875,188334.0,396447.0,396027.497581
7946,185,441420,441420,0,0.0,47859.6,0.0,-52852.5709949
1044,131,190980,6829500,6638520,6552694.5,6595030.8,3707377.61328,4095390.52018
1340,117,115560,1144740,1029180,1178364.75,1254562.8,3565588.42969,2281277.52645
622,88,73800,555360,481560,921318.6875,1889389.2,1932994.77344,1941563.14011
6005,13,22260,2529540,2507280,1962887.75,2050172.4,1325672.63867,995824.784229
5962,204,20280,2571300,2551020,2450086.0,2468901.6,3038438.66406,2904036.22346
967,144,245400,1807260,1561860,1072234.75,1408957.2,2385439.33203,2115060.64787
1165,72,459840,2385960,1926120,1821568.75,1894552.8,1109062.63477,1781538.61389
6678,57,946740,2760240,1813500,1787975.25,1711702.8,59315365232.2,1781552.02185
515,91,278940,1030200,751260,733353.3125,734484.0,740315.339844,1309159.39579
1958,98,1593660,7323480,5729820,5716244.5,5473452.0,5068035.2832,5253398.44084
6712,75,5134320,6135000,1000680,992843.3125,992812.8,877397.226562,1026041.7161
7862,185,397440,441420,43980,40168.171875,48978.0,110806.941406,-61083.4415078
7890,28,32400,496860,464460,472403.09375,458990.4,529052.857422,1123906.27007
1419,113,12180,3646740,3634560,4968692.0,4808805.6,3653563.28125,3140654.6246
4826,156,2354280,2639280,285000,287533.1875,295863.6,67134505244.1,277831.05078
2897,161,197520,1955580,1758060,1769221.875,1744984.8,1916687.63477,2065869.86589
8971,160,1519560,1567860,48300,101048.78125,42404.4,0.0,147265.400339
591,127,20520,599940,579420,504654.09375,675087.6,979853.236328,1591608.32554
679,83,86400,1818000,1731600,1870602.875,1611486.0,1345528.65234,1821917.87457
1918,134,507120,3656580,3149460,3110249.5,3181987.2,2824321.6875,2466508.46708
5383,196,418560,3285300,2866740,2873985.5,2794118.4,1739934.98828,2073248.51347
328,141,124500,7409700,7285200,7053512.0,6580669.2,5042101.78906,5193550.77267
5149,131,3666420,6829500,3163080,3077499.5,3145399.2,2891018.73828,2990422.93792
8738,220,2579400,2717640,138240,136261.734375,130980.0,193647.195312,96362.5750247
4253,163,185820,548880,363060,378450.65625,541053.6,708255.421875,429059.390036
544,84,395160,3714840,3319680,3403884.25,3281413.2,4781833.23047,4573073.45872
7168,135,5573280,5649480,76200,79143.96875,102006.0,0.0,263259.319866
6263,63,4095060,6236460,2141400,2131423.75,2137952.4,4754045925.7,2186532.18509
4944,125,3792060,3969060,177000,333649.96875,194676.0,0.0,829905.999261
8028,209,748800,1095000,346200,338186.21875,341464.8,1267261.11914,1519251.59357
9061,76,7554300,7556100,1800,0.0,1608.0,144235.388672,98780.5568733
7788,63,5342940,6236460,893520,869373.375,866583.6,33578428803.1,839271.819901
6894,18,558000,1783140,1225140,1229344.0,1206610.8,1503952.16406,1032378.52283
5990,154,86400,115500,29100,543572.0625,598669.2,2063089.61133,2185077.12744
3899,141,3416580,7409700,3993120,3996275.75,3993411.6,3970121.78711,3921732.6771
5421,63,3398940,6236460,2837520,2818578.0,2842053.6,3604462.30273,3014153.30306
1081,88,555360,555360,0,38470.4921875,57538.8,1260387.23633,1556316.88339
606,82,68040,2195880,2127840,2039143.375,1678770.0,2558379.46094,2085598.80562
1440,63,0,6236460,6236460,5163884.5,5410420.8,3858569.41602,3527522.35123
6970,48,59040,156420,97380,224646.875,92149.2,1617202.50586,1011109.65631
41,51,0,280800,280800,291490.8125,877200.0,1260036.01562,1458392.11531
2893,130,1381560,3083940,1702380,1672742.25,1690936.8,94637618082.0,2301184.46783
3340,23,1027320,1894920,867600,805355.75,869133.6,27808030866.2,613061.866966
4269,73,1303500,1303500,0,424235.5625,225958.8,0.0,-257167.044195
5753,89,642900,1736340,1093440,969459.3125,614859.6,0.0,516702.963029
7838,196,2429820,3285300,855480,815401.9375,847228.8,1033548.04102,927940.203999
6455,155,2475600,3225180,749580,742641.75,743001.6,809828.923828,1070591.78393
3182,192,245160,4652340,4407180,4421810.0,4384653.6,4427909.85547,4266590.14375
1061,86,225180,3519180,3294000,3264773.75,3319917.6,3492309.89258,3365485.21961
7156,167,156420,534900,378480,374973.625,375765.6,0.0,226937.914422
1722,135,1106880,5649480,4542600,4307965.0,4226278.8,1610635.63867,1628702.15588
6520,10,813480,979740,166260,166109.109375,303001.2,397506.701172,-76627.2098369
4839,169,101400,2190660,2089260,2177186.25,3251284.8,1735928.68164,2035191.05116
231,51,166200,280800,114600,551436.3125,927265.2,642931.269531,1074589.89732
8264,13,1962600,2529540,566940,540792.5625,544694.4,1924798542.21,461162.505274
1594,142,1194360,7303560,6109200,6204614.0,6028606.8,5133216.75391,5849790.76578
3028,162,103500,4839720,4736220,4740739.5,4717174.8,4382764.07031,4055700.65912
158,79,4500,4151700,4147200,3914371.75,3223291.2,2901849.35547,2977200.3175
5503,102,2999400,3198240,198840,223816.125,376184.4,0.0,578817.096072
1948,98,1589160,7323480,5734320,5686936.5,5480646.0,5612072.38867,5545577.28042
2807,92,160860,613860,453000,467334.875,631827.6,0.0,205351.769727
8532,40,27120,163800,136680,160674.5625,148190.4,905636.978516,1068140.91199
1348,67,1292580,3120480,1827900,1838721.375,966957.6,3916578.41016,3057060.85257
3129,130,1694880,3083940,1389060,1460153.5,1409778.0,1613937.9082,1706690.44338
2488,98,2098560,7323480,5224920,5218760.5,5237132.4,84088287271.0,5246730.93331
7492,189,52260,308460,256200,322901.375,326661.6,1405313.82812,1052853.22169
739,56,123060,6361440,6238380,6145575.5,4123414.8,4305305.54883,3666988.292
6309,172,54360,1443960,1389600,1318581.375,1416147.6,1494110.67578,1033038.70407
8030,220,1994100,2717640,723540,716788.3125,714747.6,1218268.13086,640772.623367
210,141,26100,7409700,7383600,6606379.5,4781185.2,5089225.02539,4693512.8806
3496,86,2319780,3519180,1199400,1252904.125,1195045.2,2609782.37305,1803058.66218
1371,112,225420,1303440,1078020,1123309.75,760747.2,559184.066406,1099572.97272
5073,156,2493420,2639280,145860,133979.546875,150909.6,17486088367.2,-30529.3632618
8568,40,53580,163800,110220,161699.578125,136546.8,774987.087891,1028648.27857
5592,217,523620,557700,34080,52436.0117188,33763.2,0.0,345623.454466
7715,178,416940,904200,487260,251269.65625,225306.0,0.0,101511.451687
7745,186,2776200,3639840,863640,901745.9375,909186.0,21780081275.6,1204811.1092
5015,217,33660,557700,524040,589388.1875,545372.4,2089965.49609,2631212.13414
1674,146,1473060,6670800,5197740,5208520.5,5208294.0,5880023.5332,5666210.09515
1822,66,1760460,4817700,3057240,3123711.0,3075819.6,3826030.79883,3355470.37313
5469,210,283620,1118160,834540,847421.5625,817954.8,285421.832031,299365.726511
8817,160,1435980,1567860,131880,104859.148438,134985.6,161899.226562,294835.06015
8934,196,3227220,3285300,58080,80329.9140625,63655.2,0.0,209015.978666
8488,14,1191120,1331160,140040,100224.742188,132350.4,202632.253906,124072.305324
255,99,3600,28560,24960,132873.375,957542.4,1790446.95312,2524988.85263
404,141,194400,7409700,7215300,7091556.0,7171995.6,8007433.24609,6143582.87286
4520,213,418380,3206820,2788440,2783198.25,2861376.0,2983100.16992,3467680.10467
135,146,86460,6670800,6584340,7504989.5,6545485.2,5169337.60938,4872087.09621
1735,79,1559700,4151700,2592000,2594767.0,2551524.0,2743047.60352,2662345.07251
8510,57,2517060,2760240,243180,259746.046875,273866.4,0.0,177273.06392
5292,113,3184260,3646740,462480,494868.75,251571.6,616197.664062,534003.35651
7685,15,939540,1826460,886920,880426.1875,879238.8,94636408584.0,604217.496979
6122,63,3990720,6236460,2245740,2255757.0,2240596.8,13402144781.8,2420486.48923
3483,148,1786860,1938900,152040,134851.859375,149905.2,760806.556641,253878.904971
4391,156,1982100,2639280,657180,626135.3125,571926.0,1748925.39648,559090.228484
1946,98,1588980,7323480,5734500,5718853.0,5496573.6,5668126.57812,5614881.28231
5145,131,3662700,6829500,3166800,3176646.5,3159013.2,3253567.62305,3135490.98704
6728,13,683940,2529540,1845600,1840270.25,1836049.2,1769619.4375,1732510.90378
7525,64,5788440,6848760,1060320,1090157.75,927267.6,2048794.75977,1157873.20291
3876,203,1059420,1897500,838080,824554.125,838479.6,0.0,826420.983727
8609,63,5999340,6236460,237120,259642.0,232710.0,19963564474.7,424326.433985
7919,170,20580,668760,648180,235234.640625,363434.4,0.0,82492.3196949
7564,27,349020,402780,53760,54058.2382812,50547.6,594513.673828,383205.662299
2325,156,190080,2639280,2449200,2700777.75,2509162.8,3736610.59961,3701431.99562
8207,13,1891560,2529540,637980,638247.5,640032.0,618124.580078,270376.41964
3194,130,1733160,3083940,1350780,1359652.25,1371674.4,1520638.67383,1491542.29559
3412,137,65160,243720,178560,119072.835938,224559.6,861395.376953,332459.55837
7622,15,886800,1826460,939660,942756.875,945627.6,677121.974609,815512.846957
4501,96,2123400,2123400,0,0.0,20986.8,620451.683594,386000.792223
5641,177,1626660,1713060,86400,46693.421875,150102.0,65660.4453125,-84856.5748073
6111,220,492060,2717640,2225580,2227261.0,2180902.8,1718263.26953,2453772.86197
6821,13,883680,2529540,1645860,1592948.125,1642602.0,1843271.6875,1681421.73449
1441,113,28920,3646740,3617820,5945111.0,5891929.2,5468153.95898,4786112.49261
1859,138,1782000,1785600,3600,13744.3691406,12420.0,0.0,-164707.938543
4268,73,1300800,1303500,2700,614766.375,218118.0,0.0,120964.21337
2582,143,430260,1898460,1468200,1403813.125,1394976.0,1118488.42773,974827.358938
450,150,527400,626340,98940,143201.375,312820.8,166243.728516,86405.109042
1103,77,0,3257040,3257040,2827477.0,3479878.8,3617840.2207,2624630.60847
1873,111,1835220,3974400,2139180,2113812.25,2219151.6,2244387.09375,2042364.27709
8220,196,2677320,3285300,607980,633364.4375,606068.4,0.0,287155.345355
7218,61,6225300,6225300,0,7256.80419922,82726.8,113437.412109,52185.7701413
5077,98,4155300,7323480,3168180,3125971.5,3145896.0,3733206.51953,3037995.69406
5549,63,3473340,6236460,2763120,2760130.5,2762824.8,2164167.47266,2657243.48557
8966,206,1990080,2090340,100260,36201.2851562,76329.6,113940.617188,118607.449083
4608,199,957840,975720,17880,121740.0625,109455.6,0.0,-258435.779822
8338,208,1564740,1624080,59340,60066.34375,63906.0,0.0,14271.5627582
3865,98,3307500,7323480,4015980,3886634.5,3950876.4,66046663329.1,3927446.9273
1682,98,1270980,7323480,6052500,6106408.5,5949574.8,6563330.36133,6764623.01343
5245,20,39660,39660,0,584112.625,729608.4,42970207500.8,1345103.43047
602,56,35160,6361440,6326280,3551095.5,2850356.4,1967420.28711,2320624.13645
7021,213,2529060,3206820,677760,679654.625,674446.8,1103243.5918,589259.56399
4784,98,3997380,7323480,3326100,3240580.75,3253018.8,3503628.64258,3453801.73452
3767,73,856320,1303500,447180,445515.5625,433585.2,44378127614.5,585821.805902
4986,213,803040,3206820,2403780,2404880.0,2415684.0,0.0,2803045.07406
8405,13,2150760,2529540,378780,373931.53125,367144.8,0.0,354665.28365
8026,26,1488720,2040360,551640,511700.125,524490.0,396999.320312,442276.675623
454,52,382260,608400,226140,334583.84375,802023.6,0.0,496516.014352
2218,82,1478580,2195880,717300,775053.0,706009.2,1278418.53125,579651.575381
1054,72,341160,2385960,2044800,2100759.75,2007444.0,24899204541.8,2433990.95333
4837,90,47700,1532940,1485240,1464272.625,1594310.4,1313557.46875,969773.260032
8642,188,4197360,4331160,133800,160495.109375,151524.0,0.0,142881.755251
5155,19,46080,608940,562860,559166.625,705704.4,0.0,-146456.106099
6565,46,1724160,2027040,302880,262262.125,287624.4,0.0,470159.196445
7290,164,41040,123600,82560,44750.328125,457748.4,0.0,-359900.862894
7711,141,6486000,7409700,923700,917334.8125,938108.4,1447085.9043,847483.490145
3665,203,783720,1897500,1113780,1094302.875,1115148.0,51957634820.0,223045.084055
8174,197,622020,626580,4560,66302.4140625,128797.2,978831.613281,1010690.525
6119,89,1039080,1736340,697260,716461.8125,735292.8,1476375.39844,991269.855137
863,131,7620,6829500,6821880,6671566.5,6029085.6,2662395.90234,2559341.50883
2261,117,888180,1144740,256560,304414.75,226398.0,256137.666016,620464.506273
1628,123,13980,3545820,3531840,3483570.75,3898477.2,2551604.96289,2492737.04285
4656,168,313680,438000,124320,211383.734375,272499.6,1057642.70508,447797.659565
55,109,10800,274500,263700,116037.96875,720774.0,2162464.79297,1743309.09462
4554,156,2074200,2639280,565080,561117.375,546111.6,398669.681641,617816.117754
5370,146,4673100,6670800,1997700,2037306.0,2060510.4,2314130.45312,2106211.19191
771,76,656760,7556100,6899340,6897747.0,6900476.4,6953951.99609,6608078.73757
1477,113,45300,3646740,3601440,4183919.0,3870962.4,4077173.2168,3633261.86218
1904,115,643260,954000,310740,616506.5625,730201.2,1422225.09375,1538665.60869
8943,13,2463000,2529540,66540,0.0,74305.2,345135.585938,171945.139371
4887,213,749580,3206820,2457240,2447289.0,2464459.2,2432284.33789,2777175.4209
7138,5,622620,748200,125580,111972.203125,118578.0,0.0,-31128.3674066
5967,155,1967100,3225180,1258080,1178850.5,1215586.8,1298637.38477,620332.702648
731,53,353040,582540,229500,239315.34375,264266.4,108325.666016,669202.504524
3112,96,1086600,2123400,1036800,980182.0,886286.4,1144597.73828,1084500.71257
7815,31,1374660,1374660,0,28820.3710938,23211.6,1191914.55273,513359.234477
4643,141,3997200,7409700,3412500,3429911.25,3416726.4,3467862.29297,3293988.88727
7702,176,1454340,1462860,8520,74578.703125,103312.8,399607.396484,-542641.282485
5367,216,226380,496500,270120,322284.59375,342961.2,205471.689453,391297.13602
2198,142,1737960,7303560,5565600,5533029.5,5640600.0,5898358.49414,5264519.69397
5849,89,697860,1736340,1038480,858168.4375,769794.0,1418503.99414,1083874.77371
2549,83,1814400,1818000,3600,1548.51367188,2592.0,0.0,6741.16190145
8061,209,768600,1095000,326400,397623.9375,317833.2,1218873.74219,1516004.8776
6774,191,1651020,1811280,160260,161406.203125,167430.0,0.0,187091.697269
90,111,115860,3974400,3858540,3502808.0,3654637.2,2651299.95508,2942582.85456
1031,86,90660,3519180,3428520,3368598.5,3462806.4,2630389.7793,3161087.48719
1277,122,379140,861720,482580,516365.6875,643792.8,399733.804688,828973.955148
1172,112,80340,1303440,1223100,1242387.875,1152620.4,618427.716797,1183136.36932
1617,61,1507920,6225300,4717380,4667020.0,4527601.2,5917286111.3,4817323.16296
2014,126,960,496560,495600,285158.78125,598537.2,2207468.73633,2090802.3286
3188,142,2692980,7303560,4610580,4649043.0,4612410.0,5085123.11719,4525055.45936
1553,134,101820,3656580,3554760,3507690.0,3508671.6,3877045.67578,3992020.59546
836,66,777120,4817700,4040580,4051809.5,3970399.2,0.0,3827692.83665
2638,1,1153080,1447140,294060,282685.875,708334.8,13670777183.8,179327.73603
1300,132,13440,1658640,1645200,1607060.0,1490406.0,1906459.14648,2026492.60264
5758,220,100440,2717640,2617200,2423018.25,2523398.4,2607716.60156,2038422.42365
3946,71,2848560,3996240,1147680,1182538.625,1151113.2,1460163.83398,1386073.41029
7690,76,6591540,7556100,964560,966698.375,900847.2,1.07836237412e+11,535818.676678
1119,112,41880,1303440,1261560,1366439.25,1191417.6,1595956.02148,1574356.70063
958,72,161460,2385960,2224500,2451374.0,2018580.0,3204232.97461,2523043.8023
7558,75,5913060,6135000,221940,443616.0,803534.4,0.0,-104043.038738
1092,131,339840,6829500,6489660,6607604.0,6519291.6,2903428.98047,3754784.83896
8662,64,6785520,6848760,63240,58392.5625,63975.6,202864.470703,227827.062524
8306,22,432420,813960,381540,370347.8125,302979.6,457325.515625,820760.020237
2518,108,1136940,3191940,2055000,2044969.75,2049889.2,1344672.25,1749360.8742
4291,63,2465520,6236460,3770940,3772055.25,3698223.6,2805866.69727,3846222.45049
6029,13,43020,2529540,2486520,2280094.0,2318809.2,1474232.94336,1093302.30166
1453,60,1204800,7404900,6200100,6121954.5,5669340.0,5030040.27734,4898439.0232
3239,130,1779480,3083940,1304460,1373182.875,1336246.8,1400020.37305,1494987.69656
8077,211,61800,87180,25380,27533.8515625,45747.6,0.0,-172085.107421
5900,196,721320,3285300,2563980,2623173.25,2539828.8,0.0,2339670.88854
1458,130,139740,3083940,2944200,2920020.0,2948936.4,2684844.29297,3031579.61196
6906,222,217800,1113000,895200,903573.5625,829683.6,194433.945312,289090.529399
3133,192,219240,4652340,4433100,4108104.5,4097089.2,5118943.32031,4715024.54921
6932,4,1177800,1326000,148200,46581.7265625,150579.6,0.0,66185.2266803
8375,207,196440,276180,79740,48581.5703125,156628.8,0.0,-46799.7000875
3916,60,3426000,7404900,3978900,2888160.75,3418065.6,3768973.27734,3574165.84761
7665,183,41460,445560,404100,534562.5,513932.4,0.0,-549423.800795
1832,135,1171800,5649480,4477680,4165377.0,3839712.0,3479818.49023,2916273.17319
5926,4,176880,1326000,1149120,1151854.375,1138306.8,422449.935547,963185.500888
303,79,136320,4151700,4015380,3513054.0,3957120.0,5178046.60938,4582315.46594
5099,196,109560,3285300,3175740,3152567.75,2861482.8,2159745.83398,1309768.49528
2047,133,607800,6184800,5577000,5476362.5,5228709.6,5433660.50391,4884912.62943
4640,131,3388500,6829500,3441000,3433182.0,3438267.6,2997817.41602,3362522.19283
3205,142,2706720,7303560,4596840,4591732.5,4580942.4,4040108.90625,4420251.54062
8915,58,918540,995700,77160,91033.0390625,85134.0,466384.785156,29780.4389189
8778,13,2370240,2529540,159300,159714.9375,180309.6,117500.865234,-193093.646908
5307,196,222360,3285300,3062940,3098005.5,2898890.4,2256454.83594,1914304.9915
6781,204,844140,2571300,1727160,1721229.5,1718746.8,2201414.36914,1818757.18277
5122,187,267600,2496960,2229360,1407571.625,1593138.0,718343.785156,879707.769186
8008,18,1393140,1783140,390000,364491.5,370881.6,2206831.39062,543300.162527
2147,145,577200,586680,9480,25307.7792969,115872.0,0.0,-527183.492362
3512,86,2331180,3519180,1188000,1193447.875,1166551.2,1203456.81836,1136812.09759
7036,160,41520,1567860,1526340,1352768.625,1373791.2,997248.650391,1639740.211
1365,132,61020,1658640,1597620,1744207.375,1196006.4,1698628.27344,1898041.02559
5843,63,3645540,6236460,2590920,2666338.25,2601974.4,0.0,2596581.65176
6382,220,674760,2717640,2042880,2035418.0,1952139.6,2284829.71289,1993248.91454
7006,204,1027320,2571300,1543980,1509144.5,1542099.6,1336165.93359,1377493.31101
3834,98,3286980,7323480,4036500,4031980.5,3943052.4,4170216.66016,4239044.86307
7063,31,747180,1374660,627480,616438.6875,619244.4,688492.691406,548356.441051
2545,78,1814400,1818900,4500,0.0,436104.0,0.0,-21619.709041
4328,203,1347900,1897500,549600,438011.4375,473288.4,1.02991367698e+11,287665.905
6986,151,3425820,3643800,217980,245953.09375,225042.0,0.0,230315.917882
4852,74,2976000,2979600,3600,44573.2304688,29282.4,2412829.17578,2292817.93378
6226,162,2835660,4839720,2004060,1982565.0,1938936.0,2303539.72656,2173967.01696
2020,83,1325640,1818000,492360,463956.84375,556861.2,645560.908203,561021.945311
1951,83,1270440,1818000,547560,564337.8125,540176.4,1471546.55664,549227.302394
164,146,125700,6670800,6545100,7515052.5,6535437.6,5896224.9668,5360540.84044
3960,114,1057140,1201080,143940,168921.265625,293724.0,398958.960938,533193.417598
7572,15,853500,1826460,972960,960302.125,821445.6,0.0,552864.681558
8501,40,2880,163800,160920,107268.835938,200024.4,396117.744141,596612.787788
3308,173,544800,3215700,2670900,2696687.75,2665112.4,3253400.87695,2248261.75995
8406,43,4500,4500,0,85690.1484375,144074.4,317069.884766,510262.143799
5591,57,82560,2760240,2677680,2660926.25,2674714.8,2160330.875,2554389.79413
5711,10,133560,979740,846180,877247.625,1172065.2,1535812.45117,1160550.74023
4514,151,1332240,3643800,2311560,2113885.75,2325962.4,1609604.91992,2197821.01592
7846,6,51840,133560,81720,508320.34375,495577.2,1700501.55859,1745465.84499
8103,37,32460,739620,707160,593206.6875,664202.4,1393334.38477,1073062.42612
4055,184,673200,1800900,1127700,1114857.5,1039371.6,649904.126953,866844.429847
2424,83,1753200,1818000,64800,76700.9921875,151000.8,0.0,-123755.777507
4418,135,3312840,5649480,2336640,2261454.5,2309355.6,2008827.02734,2247658.04113
8638,40,89760,163800,74040,166982.5,111865.2,1121350.01562,1476752.73865
7566,167,534900,534900,0,51367.6601562,230677.2,0.0,-531431.589341
455,79,382320,4151700,3769380,3829385.0,3641805.6,3369572.4082,4099710.93909
4024,135,3073380,5649480,2576100,2562444.5,2574356.4,0.0,2801822.57949
3959,123,2161620,3545820,1384200,1344266.75,1254502.8,0.0,1331373.41872
6402,18,97740,1783140,1685400,1571320.75,1550454.0,1534243.95312,1517037.74546
2795,79,2423700,4151700,1728000,2091520.875,1747282.8,1885229.26758,1655726.876
5781,63,3614940,6236460,2621520,2714991.25,2621613.6,2.57097052948e+11,2454236.34943
6255,131,4680300,6829500,2149200,2200472.75,2157967.2,2180284.81055,2331563.65088
9013,131,6801900,6829500,27600,37138.8203125,20712.0,0.0,153293.676634
471,79,393600,4151700,3758100,3647916.5,3127202.4,2503893.81641,3860978.04743
6051,204,104700,2571300,2466600,2495322.0,2451788.4,3209960.44531,3177053.28564
7987,196,2516100,3285300,769200,663491.0,775990.8,152474.611328,654859.924722
5866,169,845820,2190660,1344840,1342977.375,1336945.2,1880046.00586,1302227.79343
6952,5,515820,748200,232380,204056.265625,280056.0,424019.899414,336673.576693
5455,196,463920,3285300,2821380,2827501.0,2429110.8,3251289.45801,2171019.87812
630,56,41880,6361440,6319560,4333044.5,2992890.0,4487162.88574,3883895.30823
4294,131,3059040,6829500,3770460,3772539.75,3768711.6,3646974.63086,3775940.42779
8857,37,636060,739620,103560,105822.851562,116701.2,0.0,-51148.5414412
736,118,59760,459900,400140,405597.59375,449466.0,4500729378.24,142768.936258
5589,217,523200,557700,34500,44936.8789062,56172.0,0.0,337294.999591
3860,98,3297360,7323480,4026120,3879800.75,3885439.2,19267404087.1,3978514.36912
6482,196,1284900,3285300,2000400,1991359.25,2004789.6,10637248319.9,2266893.60988
3852,184,537960,1800900,1262940,1199882.25,1087843.2,1462527.14648,1097642.48188
849,142,502080,7303560,6801480,6898656.0,6756686.4,7786659.69141,6762076.66391
807,75,103080,6135000,6031920,4759685.0,5489763.6,5040341.47852,4555273.39153
6348,220,665400,2717640,2052240,2060967.5,1995021.6,2094737.45703,2085679.96178
884,118,156180,459900,303720,303830.28125,382772.4,1211343.21484,552476.497005
3520,86,2332980,3519180,1186200,1240299.125,1156507.2,1401015.75391,1651857.0798
1927,134,511980,3656580,3144600,3147564.75,3175213.2,2377656.44336,2466705.97669
5382,49,3942900,3991980,49080,36576.875,52024.8,0.0,207214.4958
2577,158,79320,2044680,1965360,1847946.0,1915826.4,2903826.16406,2717720.07685
3689,116,114720,786600,671880,975433.6875,742741.2,1537568.00195,1310737.69304
5154,69,2016300,2073180,56880,148083.109375,80725.2,16922902275.8,-175299.087083
6100,155,2221800,3225180,1003380,1002980.4375,1020739.2,1145512.69141,960226.522146
3389,71,2339640,3996240,1656600,1021526.8125,1295284.8,578166.347656,82153.0442925
1567,63,92520,6236460,6143940,5714584.0,5652627.6,5255538.25195,5055770.3407
8160,63,5563740,6236460,672720,674950.8125,669512.4,0.0,755887.226279
6980,31,701400,1374660,673260,673004.75,674038.8,58530.8925781,728782.332468
7454,8,24060,615060,591000,585885.5,611797.2,0.0,-228556.743941
425,142,239340,7303560,7064220,7062712.5,7076371.2,5657691.45508,5685771.54201
7093,167,129780,534900,405120,401120.8125,413598.0,800543.384766,444282.097112
8558,139,82080,273900,191820,181122.375,149334.0,0.0,-318411.145157
405,79,220080,4151700,3931620,3866024.5,3947553.6,5625640.63477,4809361.29644
6905,188,2831160,4331160,1500000,1469532.25,1498548.0,1832374.96875,1643063.89251
3151,73,429480,1303500,874020,707722.875,900926.4,1481630.39453,1012445.58963
4404,215,1457520,1851720,394200,416308.21875,427464.0,0.0,-204799.651264
6578,63,4304040,6236460,1932420,1931060.375,1915018.8,0.0,1918535.04215
1048,86,105780,3519180,3413400,3197173.75,3380949.6,2806136.46289,2895173.7313
539,76,505080,7556100,7051020,7065089.0,6913744.8,5311284.23633,6464458.259
7922,15,1091820,1826460,734640,734082.375,746920.8,329436.859375,784026.777513
5153,157,39000,1993260,1954260,1655510.125,1757023.2,547622.291016,738551.853121
5954,10,251160,979740,728580,782100.8125,827355.6,802034.671875,479461.427545
5212,216,0,496500,496500,1077871.125,805364.4,2042011.66406,1690557.2074
2431,108,1098240,3191940,2093700,2083378.875,2128556.4,2230215.43359,2499893.83211
8731,162,4833360,4839720,6360,0.0,141868.8,0.0,-169470.92636
7042,195,117420,393120,275700,308509.96875,314216.4,0.0,287231.109722
834,121,244440,856140,611700,608450.875,600962.4,632077.712891,640421.954199
8157,196,2612220,3285300,673080,671746.9375,673816.8,3230550058.04,771295.720177
5219,213,939480,3206820,2267340,2236468.5,2252793.6,2866423.67578,2324437.31446
1274,108,10020,3191940,3181920,4222613.0,3091096.8,3975261.73242,4001562.23036
8526,159,2446380,2484180,37800,23962.5449219,48849.6,0.0,-1135241.47416
590,56,28800,6361440,6332640,3004089.25,2599149.6,1763203.43164,2516846.84647
8115,28,175620,496860,321240,267298.9375,304448.4,241665.949219,197031.417208
7476,174,1273260,1300440,27180,0.0,43946.4,0.0,-383519.702205
6839,213,2422560,3206820,784260,776991.375,727708.8,0.0,798620.649369
3785,141,3217500,7409700,4192200,4196052.0,4200151.2,0.0,4328467.32217
6601,151,3043920,3643800,599880,583365.4375,593140.8,470527.972656,637672.512957
1204,117,14280,1144740,1130460,1108927.375,1053687.6,1318368.51953,1687648.50855
7995,172,1390920,1443960,53040,107012.757812,136670.4,70942.8515625,-288828.579447
3928,114,1029180,1201080,171900,190164.921875,224190.0,758551.826172,463148.740963
1376,130,81540,3083940,3002400,3210029.5,3023892.0,4943046.61328,3424033.65849
118,76,57360,7556100,7498740,6856790.5,6449863.2,4878896.72266,4326343.41878
1676,135,926100,5649480,4723380,4506442.0,4209180.0,2788270.68555,2397237.14755
8465,188,4088760,4331160,242400,244693.984375,246632.4,932968.716797,588932.828535
3546,147,1317000,1479360,162360,160478.515625,206680.8,399278.642578,83891.7573461
610,140,430620,1300140,869520,864717.1875,876756.0,1962070.60156,2222977.95689
1622,134,153300,3656580,3503280,3487655.75,3417828.0,2681901.04688,2600039.83692
6871,13,908520,2529540,1621020,1575786.375,1598317.2,108007.833984,1686397.02954
7607,98,6321780,7323480,1001700,988498.5625,1025766.0,82577.28125,1113097.05704
1197,77,66000,3257040,3191040,3164444.0,3276464.4,1169717.67969,1810239.62695
6044,204,89340,2571300,2481960,2441739.75,2458335.6,3284374.88672,3262195.69129
1497,33,74400,78900,4500,7456.77880859,93433.2,309931.550781,589890.473776
3316,130,1815180,3083940,1268760,1283331.0,1268600.4,1134632.75,1123175.41133
5971,57,290100,2760240,2470140,2474234.0,2464717.2,0.0,2562968.65488
7658,220,1745640,2717640,972000,984418.5,959338.8,93810.5683594,559059.780097
1581,119,0,2742780,2742780,1547794.0,1728800.4,809243.066406,1892758.55478
8720,188,4247160,4331160,84000,85284.75,82776.0,127302.908203,51645.2219471
3536,165,738960,1262880,523920,499951.84375,642228.0,0.0,-311033.152756
163,111,193800,3974400,3780600,3719914.25,3806782.8,3827406.04102,3715339.8049
0,68,0,262800,262800,1506319.375,971979.6,836105.884766,1323488.99005
8416,14,1157580,1331160,173580,170104.046875,155652.0,0.0,192930.174771
6999,204,1024560,2571300,1546740,1531144.125,1548550.8,1397415.43359,1460352.74443
6213,213,1881720,3206820,1325100,1468641.375,1486448.4,0.0,1593004.60383
3850,114,975240,1201080,225840,230848.453125,240423.6,92484.2421875,601263.448579
453,76,468120,7556100,7087980,7354606.0,7091799.6,5765903.35742,7369583.8562
4084,116,518400,786600,268200,285002.03125,267835.2,355267.636719,84408.2091744
4508,213,412440,3206820,2794380,2830435.5,2806921.2,3224208.51562,3586335.20255
2569,158,78120,2044680,1966560,1993583.625,2030523.6,1956351.44531,2839360.55888
8883,221,938400,938400,0,250683.609375,36830.4,747689.431641,482307.164248
1931,72,1143720,2385960,1242240,1162999.375,1356476.4,1707464.68164,1583788.17435
3107,158,572280,2044680,1472400,1388950.75,1431196.8,1609817.55273,1664069.89119
1176,105,1096260,1314480,218220,320780.3125,269958.0,426501.765625,-222358.497432
6398,18,94740,1783140,1688400,1644137.75,1561082.4,1180719.5918,1381918.46379
2023,86,1041180,3519180,2478000,2480108.0,2484430.8,2377802.10352,2293447.33528
3019,158,368880,2044680,1675800,1696196.875,1731232.8,1862050.0625,2261139.04999
6870,13,908400,2529540,1621140,1575122.125,1603209.6,834748.125,1645447.66433
702,124,603000,754200,151200,135530.421875,255120.0,1191720.92773,795506.379056
5213,196,173160,3285300,3112140,1731925.125,1734435.6,2304391.30664,1750862.90354
8954,22,813960,813960,0,1823597.625,1636812.0,3026328.52148,3415331.40378
8332,152,3419940,3770100,350160,346611.84375,337027.2,0.0,193193.83209
5303,134,3206400,3656580,450180,449746.09375,451173.6,537572.175781,303174.658883
7193,15,486900,1826460,1339560,1329827.0,1308012.0,666651.921875,76569.0098593
6103,204,282360,2571300,2288940,2249703.5,2299034.4,3298706.41797,3126348.51101
3975,60,3462900,7404900,3942000,3712035.75,2910732.0,4565467.1582,3803483.52954
6196,76,5356800,7556100,2199300,2348745.5,2232039.6,0.0,2080178.4173
1384,33,6240,78900,72660,134616.234375,250082.4,754144.71875,1137172.76985
7522,167,395340,534900,139560,137796.609375,143644.8,0.0,166702.758731
1379,49,536400,3991980,3455580,3080335.5,2741068.8,2938381.34766,3184721.53146
796,144,99240,1807260,1708020,1644259.75,1743572.4,2298568.98047,2032653.06113
1395,133,19920,6184800,6164880,6117804.5,5265523.2,3806813.84961,3758704.90447
7689,186,2747400,3639840,892440,891626.3125,862220.4,6978400584.95,500063.79885
9075,21,474060,474060,0,0.0,161252.4,0.0,-287380.529555
1736,79,1559700,4151700,2592000,2600604.75,2593092.0,3166476.73633,2669938.92602
7826,131,5968500,6829500,861000,855397.125,860671.2,1475051.33008,1021149.98421
1680,146,1482000,6670800,5188800,5204807.0,5145926.4,5742627.91211,5633298.69662
6517,26,261840,2040360,1778520,1776889.375,1778449.2,0.0,2185783.33312
6257,151,2820180,3643800,823620,864966.6875,909453.6,0.0,945102.874157
6834,2,1706220,2555640,849420,757679.0,759466.8,90484.203125,-25803.7360495
6890,151,3367320,3643800,276480,294934.96875,331750.8,0.0,288994.964846
4440,168,54060,438000,383940,376797.1875,627218.4,1218940.61914,1073783.06036
5301,134,3203400,3656580,453180,451439.84375,435741.6,261267.458984,304449.004885
1135,76,1087200,7556100,6468900,6503651.0,6474140.4,7059221.72656,6228263.04704
3050,192,14400,4652340,4637940,4517578.5,4535731.2,4160686.70312,3765474.75256
1518,132,154500,1658640,1504140,1618301.375,1305258.0,1714131.67188,1702540.30305
1462,148,0,1938900,1938900,1315354.5,1322208.0,1690716.16211,2270610.71546
8225,14,899400,1331160,431760,419502.78125,417076.8,0.0,-784726.096528
7874,179,188760,345960,157200,163859.40625,168147.6,107351.363281,1187563.33613
1285,108,14220,3191940,3177720,3509050.75,3065808.0,3430233.03125,3460625.49055
5114,187,265440,2496960,2231520,1792093.25,1579167.6,1220845.54688,1046175.95717
3034,173,210900,3215700,3004800,2998094.0,3028714.8,2994787.49023,2479488.13134
7923,209,686040,1095000,408960,379596.75,364261.2,1725689.66016,1492610.19669
5339,152,812460,3770100,2957640,2350838.75,2276577.6,2584930.30273,1863123.20981
1111,87,1034460,1090800,56340,58018.5585938,125070.0,168997.919922,8459.62637416
8415,220,2392440,2717640,325200,329353.96875,330802.8,495408.460938,193479.912982
3277,135,2442000,5649480,3207480,3132700.75,3020058.0,2965205.13672,2959989.95404
1845,115,590580,954000,363420,841742.75,1147327.2,850380.605469,1399292.00914
5510,142,4538760,7303560,2764800,2683546.25,2691556.8,11063266762.0,2808310.661
7854,42,103680,956940,853260,567484.125,617624.4,1585606.29883,1336587.4516
3837,203,1031820,1897500,865680,858206.8125,879584.4,84104.3300781,987960.202115
5396,98,4500180,7323480,2823300,2949591.25,2871290.4,3110877.48242,2989271.4384
4654,142,3894960,7303560,3408600,3369499.0,3400239.6,4966520.67773,3520967.00253
5201,177,1215600,1713060,497460,441218.34375,491197.2,0.0,66018.2744266
4134,23,1677660,1894920,217260,173294.734375,165003.6,160860.466797,35883.1321584
4745,156,2315760,2639280,323520,330282.4375,316707.6,0.0,341466.305534
685,83,90000,1818000,1728000,1916787.125,1642821.6,3124891.28125,2586210.99068
7589,25,1073940,1954980,881040,887805.4375,883402.8,390118.623047,788652.56253
6714,146,5716800,6670800,954000,912200.625,956721.6,1258124.99414,1007400.40458
5190,98,4212180,7323480,3111300,3047546.75,3023745.6,2858457.07812,2979905.36793
8743,160,1391880,1567860,175980,164826.015625,159049.2,212509.0,166048.30853
3668,147,1398720,1479360,80640,65138.5625,70705.2,0.0,-862111.100611
5789,134,3656580,3656580,0,328391.15625,361881.6,703931.308594,87824.2900867
3159,156,1039140,2639280,1600140,1686988.625,1606546.8,2044747.80078,1507064.33288
6278,31,110040,1374660,1264620,1134989.375,1210581.6,1692456.80273,1428323.57759
2040,72,1213740,2385960,1172220,1180528.125,1289127.6,979706.109375,1157934.66535
8697,131,6650940,6829500,178560,175895.515625,354332.4,0.0,154431.419372
7308,167,242640,534900,292260,305470.625,275055.6,0.0,140119.499515
3891,116,384420,786600,402180,412912.8125,442382.4,666805.724609,264786.937793
1335,76,1244280,7556100,6311820,6340976.0,6290929.2,6507257.7793,6504038.5878
434,87,424200,1090800,666600,635077.0,1036176.0,1967097.36133,2296184.70982
1407,77,210840,3257040,3046200,3276092.0,3172753.2,3977181.35547,3913895.23062
232,51,168420,280800,112380,355530.09375,892556.4,319348.253906,984940.028138
640,75,0,6135000,6135000,4184947.75,4382226.0,2701957.6543,2642271.51551
4001,71,2876400,3996240,1119840,1139172.375,1120890.0,1048663.94531,1023375.9516
5991,76,5036400,7556100,2519700,2515009.75,2516829.6,2538152.13672,2671100.66811
517,111,575520,3974400,3398880,3393593.75,3547800.0,3710358.44727,3562035.90979
2793,79,2419200,4151700,1732500,1507344.25,1801003.2,0.0,-26133.4140166
5639,146,4856400,6670800,1814400,1862604.375,1810399.2,1973935.66602,1901852.44164
2364,156,245340,2639280,2393940,2928717.0,2895258.0,2728395.66016,3190453.84556
4893,2,48960,2555640,2506680,2310331.75,2306450.4,1084503.14062,997802.403579
1977,86,1003860,3519180,2515320,2522153.5,2494442.4,2261415.12891,2554689.72401
7051,213,2553180,3206820,653640,654011.625,656448.0,78940902172.6,429714.158285
8408,133,5926500,6184800,258300,268763.28125,279417.6,0.0,-118331.614998
632,150,621180,626340,5160,21112.3144531,222192.0,0.0,-41536.2757475
8525,192,4594440,4652340,57900,198562.71875,131524.8,438825.220703,185738.875523
6570,208,42840,1624080,1581240,1590722.5,1605446.4,2641014.57812,2619380.13918
2478,142,2076360,7303560,5227200,5209574.5,5272843.2,75377266934.5,4999683.12902
1452,79,1234800,4151700,2916900,2643855.0,2770785.6,2778161.38867,2655505.30782
3004,108,1463940,3191940,1728000,1726992.0,1745646.0,1575634.04492,1880628.19374
6392,31,176520,1374660,1198140,1214246.875,1181193.6,1342334.2793,1027440.23529
4305,219,42960,3801540,3758580,3457541.0,3733964.4,1703697.57031,1720082.87752
3476,203,643320,1897500,1254180,1281748.875,1303484.4,1037073.50586,1770164.83525
4921,90,93420,1532940,1439520,1407500.0,1423266.0,1815635.93555,1957080.47321
8598,42,710400,956940,246540,190816.859375,232944.0,0.0,-323175.212745
3292,192,318240,4652340,4334100,4305544.0,4325655.6,3399083.87109,3626199.41636
8063,26,1510860,2040360,529500,581008.5,535370.4,260022.945312,469359.29428
4168,107,1303020,4995360,3692340,3670187.75,3662959.2,3831504.68359,3463813.12806
3801,151,868740,3643800,2775060,2563799.5,2733199.2,2763449.42773,1909407.38675
7445,197,20400,626580,606180,651351.0,488540.4,1699466.99414,1907216.29543
7216,3,22740,1059180,1036440,1035693.125,1017055.2,1006316.21094,1344072.85432
5284,113,3181860,3646740,464880,488632.21875,371115.6,245700.138672,769275.339631
4686,151,1539300,3643800,2104500,2222022.0,2094979.2,1617424.41016,1933039.15277
8356,30,402000,608400,206400,549719.75,470294.4,631649.626953,155507.510495
4797,186,358800,3639840,3281040,2844390.0,3222512.4,3682471.39258,3094283.51041
3989,141,3475200,7409700,3934500,3941003.0,3944916.0,3980427.07031,4290096.98719
2625,123,961380,3545820,2584440,2581287.0,2579412.0,2600978.24219,2608705.91804
8762,219,3648540,3801540,153000,169909.4375,143142.0,1.39868808684e+11,406388.409041
7331,133,4949520,6184800,1235280,1224576.75,1204154.4,1441071.96094,1669815.42613
4108,0,1330860,1560960,230100,401010.46875,277140.0,1028582.04883,838424.900308
5255,63,3141300,6236460,3095160,3096759.25,3099375.6,3591118.17773,3066346.8089
1745,63,355200,6236460,5881260,5831619.0,5882292.0,5879948.03906,6223349.34503
6561,64,5036700,6848760,1812060,1768360.25,1627951.2,1291576.33594,1526855.08407
5582,177,1587900,1713060,125160,274535.53125,179505.6,0.0,223130.873279
5924,196,728100,3285300,2557200,2562386.5,2541694.8,2366638.60156,2379473.72348
3083,141,2602260,7409700,4807440,4751551.0,4762124.4,4853405.4375,5108215.68471
2678,156,560220,2639280,2079060,2077152.625,2093284.8,1865795.95703,1818565.25266
4408,141,3732240,7409700,3677460,3666279.75,3684084.0,4080074.40039,3642723.25587
7455,220,1479240,2717640,1238400,1139945.875,1187214.0,1083209.72266,1142608.62143
7241,3,44100,1059180,1015080,1019845.875,1002384.0,1379002.03516,1183969.93352
2901,141,2455620,7409700,4954080,4943721.5,4910976.0,4634117.88867,5043507.82563
2928,156,733620,2639280,1905660,1901435.5,1890258.0,2560038.73242,2250107.8546
2159,77,868440,3257040,2388600,2400899.5,2408698.8,1920560.07617,2505016.00201
3659,199,99000,975720,876720,916107.1875,877712.4,1677530.72852,2244137.34142
8633,42,728940,956940,228000,225566.671875,218113.2,0.0,71168.4791465
8376,37,337140,739620,402480,419453.40625,393190.8,2093465.64258,2942343.62786
5623,213,1337040,3206820,1869780,1887071.25,1865275.2,2712662.1582,2000954.47697
4292,219,33840,3801540,3767700,3488414.0,3689598.0,2217148.21289,1722023.74517
2672,215,23100,1851720,1828620,1139943.125,1387742.4,296917.714844,968636.357453
2316,156,188640,2639280,2450640,2822967.25,2576611.2,2766116.41797,2785987.01533
1074,88,551760,555360,3600,15006.9306641,116070.0,1588273.30859,1538479.81982
7937,30,0,608400,608400,308964.40625,511158.0,1043817.60938,663008.149273
3628,66,3282600,4817700,1535100,1484420.0,1567543.2,1633950.73828,1803487.66692
2684,123,1005900,3545820,2539920,2611357.0,2541332.4,2402524.92773,2319339.7658
3170,67,2944140,3120480,176340,203095.4375,178887.6,0.0,197216.839931
3450,203,626880,1897500,1270620,1252409.5,1270250.4,1511899.20703,1961632.22935
5796,19,583800,608940,25140,27931.0410156,81967.2,0.0,-55812.5307671
6619,191,1543320,1811280,267960,200121.734375,177007.2,0.0,311045.296191
5270,131,3740100,6829500,3089400,3089591.0,3089910.0,2824555.45312,2793153.40825
9044,63,6235740,6236460,720,0.0,10735.2,8062526596.0,106329.680742
4079,107,1268160,4995360,3727200,3769335.75,3693585.6,4294794.89258,3578923.03656
6236,31,81180,1374660,1293480,1284997.375,1301124.0,1089812.94336,924313.050331
5844,131,4236900,6829500,2592600,2567853.75,2587414.8,3134656.05078,2698467.48788
7129,48,153840,156420,2580,0.0,68870.4,910517.992188,133924.725802
3562,116,31800,786600,754800,789478.1875,716071.2,814846.003906,1385597.6853
4112,0,1332840,1560960,228120,207680.8125,280657.2,827088.21875,751925.917279
5904,63,3671640,6236460,2564820,2561351.25,2565753.6,0.0,2526092.96607
1912,77,707340,3257040,2549700,2584082.25,2585043.6,2772636.42383,2768548.87385
2072,63,558540,6236460,5677920,5672893.5,5675389.2,5397187.64844,5338876.33116
2409,94,500400,534480,34080,305088.5625,266736.0,699898.431641,748703.32834
6137,220,507900,2717640,2209740,2250828.25,2180053.2,2231758.44922,2506862.71271
217,146,157440,6670800,6513360,7551757.5,6518257.2,7292811.52344,6242297.63101
261,141,85500,7409700,7324200,6621469.0,6949515.6,4572845.35156,4517585.67431
371,76,284460,7556100,7271640,7125075.0,7146086.4,8135934.70898,7117444.02555
4478,135,3341700,5649480,2307780,2245110.75,2298748.8,2578480.08594,2265891.13011
5161,217,108120,557700,449580,394441.4375,522243.6,1346393.57031,1325039.68237
1704,119,100620,2742780,2642160,2654574.75,2645370.0,3085356.72656,2735091.29528
3506,184,179400,1800900,1621500,1655832.0,1569884.4,1417438.33789,1128021.54927
8473,133,5977140,6184800,207660,216333.921875,213392.4,411641.201172,265187.536843
1388,77,200220,3257040,3056820,3043196.5,2950620.0,4179831.07031,3659961.69295
8862,204,2463540,2571300,107760,117343.625,114824.4,0.0,-92118.1434457
2165,94,195060,534480,339420,454426.4375,364862.4,676188.939453,1253994.39173
4885,161,1870080,1955580,85500,68240.7109375,102129.6,686022.445312,539237.359352
6383,151,2896920,3643800,746880,732773.6875,746443.2,776734.279297,556966.350926
7611,27,387000,402780,15780,26498.0292969,42064.8,0.0,550070.562119
4723,131,3432300,6829500,3397200,3405145.25,3386836.8,3148541.15625,3190078.37913
3385,114,539760,1201080,661320,622185.1875,618655.2,934864.880859,1110324.39279
2350,66,2159340,4817700,2658360,2655177.25,2655301.2,2604128.35742,2634247.82556
7762,58,68280,995700,927420,733451.5625,866432.4,0.0,-246102.406762
4892,169,137100,2190660,2053560,2045948.25,2133912.0,2161705.11719,2269170.65844
1584,134,136260,3656580,3520320,3415967.5,3476546.4,2337250.11328,2620852.00787
183,100,0,919500,919500,2583793.0,2966838.0,2219052.25195,2489213.73392
5054,146,4359360,6670800,2311440,2307017.0,2308988.4,0.0,2482023.52133
3755,203,861900,1897500,1035600,1024842.0,1044100.8,987483.972656,1125201.18892
322,76,232080,7556100,7324020,7220993.5,7195525.2,6912896.51172,7613246.49654
4927,202,166740,166740,0,49873.1328125,1008894.0,144234.939453,-74418.1233106
7204,61,6220800,6225300,4500,0.0,82968.0,2.01766969133e+11,99203.828557
513,91,278880,1030200,751320,735543.0,735196.8,1023099.80273,1344817.22992
812,76,679260,7556100,6876840,6826052.0,6726468.0,7428966.42969,6824076.94538
994,87,799140,1090800,291660,316400.78125,308271.6,608621.429688,542642.04653
8522,30,517500,608400,90900,97936.4296875,110164.8,0.0,55238.9960911
2652,69,18660,2073180,2054520,2337123.5,2396391.6,2688387.98047,2468393.54024
3582,203,720900,1897500,1176600,1197316.0,1173764.4,17170421972.7,1628574.67967
3674,203,791100,1897500,1106400,1107288.875,1106721.6,0.0,1204455.17158
7909,28,39300,496860,457560,519007.84375,461272.8,584368.478516,1036711.35628
8333,3,1010520,1059180,48660,37901.3632812,49291.2,0.0,-254112.266233
3262,142,2750100,7303560,4553460,4583573.0,4275826.8,0.0,4561629.23964
6982,31,701580,1374660,673080,671059.5,679408.8,433423.259766,635775.470232
1124,86,273960,3519180,3245220,3203245.5,3239794.8,2598071.0918,2550014.55187
5227,54,220080,1314000,1093920,1262272.875,1256216.4,688242.421875,885801.302427
7650,189,259860,308460,48600,83112.8125,89028.0,1425913.6875,1747814.82571
4530,201,1293240,1645440,352200,335564.40625,345141.6,0.0,304661.280393
7307,164,49500,123600,74100,100276.085938,79206.0,0.0,-543890.946568
1689,110,1493640,5579400,4085760,4049184.25,4019796.0,3797339.49414,3410110.28302
4217,135,3186900,5649480,2462580,2459243.0,2456875.2,2451479.23438,2360899.40693
196,120,179940,576000,396060,351305.21875,398067.6,2010833.79297,2302830.63971
6908,204,970140,2571300,1601160,1586410.125,1568763.6,841987.59375,1410786.67095
6791,191,1780920,1811280,30360,37341.6914062,101694.0,350694.996094,377558.816688
4047,213,133020,3206820,3073800,3289522.25,3125000.4,4607003.89844,3887138.7977
8723,188,4248360,4331160,82800,83159.078125,81648.0,0.0,-98345.9387111
2493,135,1770300,5649480,3879180,3840339.5,3884460.0,4190155.58398,3824950.60719
1767,138,1724220,1785600,61380,64420.4648438,248394.0,0.0,265830.643512
1580,79,1321500,4151700,2830200,2719439.25,2851944.0,6624710191.78,2371475.79246
6773,46,1871400,2027040,155640,84898.78125,135631.2,0.0,-47616.249287
4489,23,1891320,1894920,3600,0.0,12199.2,0.0,112839.344429
549,83,0,1818000,1818000,3330601.25,3421639.2,4192850.53125,3621817.0843
1207,12,46500,850020,803520,1621598.625,1405844.4,500265.066406,1536644.81408
1905,115,643260,954000,310740,517917.5,906105.6,1432581.37695,1701985.30141
330,141,124620,7409700,7285080,7700289.5,7165131.6,5898905.97461,5638146.63327
6470,54,1314000,1314000,0,2829.03857422,19009.2,201444.179688,136232.054786
4077,213,158040,3206820,3048780,3164478.75,3062950.8,3810091.66016,3727837.93382
3971,166,1650300,1666080,15780,139170.3125,230571.6,103382.455078,-338824.355264
1027,83,375600,1818000,1442400,1437891.75,1442353.2,1580925.06836,1664934.1494
8311,26,1808760,2040360,231600,212170.890625,223873.2,488915.697266,309468.335331
1655,142,1226760,7303560,6076800,5916057.5,5910597.6,7143979.3457,6644857.84107
3386,203,603960,1897500,1293540,1176950.375,1346470.8,1709942.50781,1628001.95964
3030,107,268200,4995360,4727160,4851418.0,4658112.0,4605746.92383,4544977.53031
4929,98,4074480,7323480,3249000,3247587.75,3267190.8,3393530.55273,3678583.92402
4764,168,383280,438000,54720,164078.59375,242176.8,115671.0625,219113.393754
920,72,108360,2385960,2277600,2006107.75,2097309.6,2498968.49609,2402385.66572
8639,160,1332300,1567860,235560,251811.828125,227738.4,3285.35351562,275406.812729
8855,57,2724300,2760240,35940,48948.4023438,57949.2,0.0,-322285.44887
6479,75,4967160,6135000,1167840,1176467.625,1164190.8,2122972.85742,1385427.60335
3617,66,3261600,4817700,1556100,1403392.125,1628068.8,1589334.45898,1708372.74151
6261,63,4093140,6236460,2143320,2132448.0,2138977.2,0.0,2229993.13872
5344,142,4303980,7303560,2999580,3131971.25,2906112.0,3963358.40625,3088433.01403
5299,210,25680,1118160,1092480,982927.5625,994911.6,640195.630859,639582.572586
2215,143,31800,1898460,1866660,1829265.5,1696762.8,1645323.43164,1817264.40277
8442,14,1167120,1331160,164040,177070.734375,150142.8,684083.568359,248623.772389
1402,130,92820,3083940,2991120,2997455.25,2994655.2,2900456.54883,3204771.17852
4904,196,0,3285300,3285300,2538500.5,1691210.4,918188.677734,1394106.17663
5648,89,592980,1736340,1143360,1131260.375,1120762.8,1219296.42773,1151480.21238
8139,197,608220,626580,18360,56930.1328125,55346.4,1075183.07031,1424553.93952
5513,152,1050660,3770100,2719440,2718181.25,2603516.4,2720525.60156,2592996.38116
4871,215,1851720,1851720,0,0.0,39528.0,0.0,-869445.789688
5697,196,627300,3285300,2658000,2317772.5,2349584.4,1958482.35938,2162470.40501
4468,186,16860,3639840,3622980,4049507.0,3122182.8,2031342.40039,1330539.8488
1638,79,1351860,4151700,2799840,2633186.75,2761467.6,0.0,3138335.01114
5922,4,172560,1326000,1153440,1155703.25,1151031.6,1740610.32031,938711.128845
8924,206,1966260,2090340,124080,158589.453125,135429.6,1135341.45703,410499.751609
2004,86,1035180,3519180,2484000,2459158.0,2456649.6,1245528.07812,1829535.78713
894,110,739320,5579400,4840080,4972456.0,4495428.0,3685317.85156,3434302.6801
5819,17,17400,626460,609060,915501.1875,819872.4,1545292.41602,1246321.15827
6633,32,166920,1205580,1038660,954163.875,927164.4,710065.830078,612860.639439
2852,158,268080,2044680,1776600,1634392.25,1830151.2,2744769.03906,2671000.72881
715,118,53820,459900,406080,1070558.375,1032030.0,4512499.37109,4031361.66177
6967,157,1654500,1993260,338760,329512.90625,453012.0,309020.740234,208908.433296
3510,184,180000,1800900,1620900,1496729.75,1554828.0,1058219.21875,909400.213212
5296,134,3198420,3656580,458160,540225.625,388760.4,583784.957031,218023.542493
5806,76,4930020,7556100,2626080,2625101.5,2617963.2,1.01734363636e+11,2716358.83794
5375,49,3938400,3991980,53580,0.0,57272.4,1330523.09961,41008.6995428
58,150,59400,626340,566940,597455.9375,2342650.8,2288801.12891,1555418.90695
5726,103,4636200,4719960,83760,78420.1015625,84771.6,0.0,115058.017151
1600,82,927000,2195880,1268880,1265358.0,1084228.8,1724824.97852,1340903.21907
6583,188,2485560,4331160,1845600,1816615.5,1815278.4,1509426.57812,1493232.02598
1130,76,1083000,7556100,6473100,6461675.5,6471526.8,0.0,6039425.82251
3452,23,1083900,1894920,811020,886545.5,814418.4,846520.927734,1066296.12258
6417,210,1053720,1118160,64440,56131.3085938,66991.2,208543.162109,-41746.8771093
6053,76,5097600,7556100,2458500,2457416.25,2456149.2,173743666.053,2344513.30464
5237,125,3957960,3969060,11100,27911.6503906,61881.6,105005.722656,-154671.391941
6866,188,2802660,4331160,1528500,1522109.875,1518087.6,2416393.22266,1388975.85291
6804,213,2405700,3206820,801120,818644.6875,732985.2,2989053802.27,815339.798307
8952,219,3749940,3801540,51600,249336.203125,53112.0,0.0,426349.951536
5625,159,26160,2484180,2458020,1205890.25,1537479.6,2002090.14453,1662854.7469
5183,135,3877200,5649480,1772280,1695351.0,1798124.4,1659712.72852,1537189.54173
1158,104,273180,935100,661920,802851.6875,719608.8,5786740.03516,3812931.07761
7647,183,23040,445560,422520,557436.625,476152.8,261494.273438,354666.453641
533,141,391320,7409700,7018380,7116852.5,6991779.6,7275134.25781,6177941.39698
6125,196,1043700,3285300,2241600,2219558.75,2282754.0,2521239.27344,2274857.38111
535,103,244620,4719960,4475340,3973671.25,2570764.8,1962927.18164,2050310.77962
1818,63,389100,6236460,5847360,5850625.0,5846734.8,4904095.57422,5660750.04778
2698,98,2244780,7323480,5078700,5072816.0,5084395.2,4228874.76953,4953551.32162
7950,220,1940940,2717640,776700,781445.5,785088.0,1059296.93359,683175.810385
7171,162,3561300,4839720,1278420,1258704.5,1282014.0,51213523289.3,1220906.12055
4646,156,2251860,2639280,387420,422972.03125,386720.4,687778.832031,577216.828775
4109,143,1732320,1898460,166140,173318.328125,160311.6,1706313.60547,903833.606794
5018,86,3515580,3519180,3600,263646.84375,253742.4,9907046123.95,29996.5379385
1746,63,355260,6236460,5881200,5824873.5,5879232.0,6419123.28125,6257613.4497
3900,141,3416880,7409700,3992820,3995229.5,3992551.2,4050767.49805,3935123.71133
7380,213,2750700,3206820,456120,491366.34375,425820.0,0.0,-65533.0368336
8912,152,3770100,3770100,0,34606.296875,30553.2,65216.9511719,145654.845245
6357,25,33420,1954980,1921560,1902961.75,1899949.2,3506847.16797,2714915.89601
7631,222,790200,1113000,322800,275416.71875,272690.4,0.0,-746155.072544
7569,205,460800,460800,0,58952.453125,261274.8,0.0,-554382.590506
1897,101,81660,655020,573360,704969.625,816793.2,1315786.82617,1348580.38718
3571,203,715440,1897500,1182060,1178475.125,1182094.8,1140938.19531,974017.738542
2206,117,825360,1144740,319380,299665.0,323311.2,0.0,771125.564605
6457,110,5528100,5579400,51300,106647.859375,205432.8,59693442736.6,339870.049973
212,128,191460,346200,154740,153273.796875,346394.4,247079.775391,737256.597118
3068,201,78240,1645440,1567200,1554301.5,1584312.0,2573265.10742,2002019.40682
7699,15,954780,1826460,871680,930015.75,884642.4,1697525.47461,955725.831986
2447,101,597420,655020,57600,117157.617188,269361.6,0.0,-545503.134994
4713,213,651600,3206820,2555220,2552481.5,2547933.6,2850203.50195,2576992.11091
170,146,126900,6670800,6543900,7416679.0,6092611.2,6205379.28516,5425145.02955
3671,79,3155700,4151700,996000,955670.9375,955731.6,3058482.01758,1240837.44038
9040,13,2518320,2529540,11220,19589.8652344,12170.4,0.0,73475.1613894
2877,96,791400,2123400,1332000,1316388.125,1255288.8,2026168.30078,1510675.40848
2516,153,38100,1618560,1580460,2394621.5,2329476.0,3479623.36133,2793975.44505
5256,113,3169560,3646740,477180,533373.5625,302246.4,1326353.17969,1045557.3511
7920,170,20700,668760,648060,489188.78125,575125.2,0.0,86190.0095626
675,93,546600,1242300,695700,694065.25,823244.4,1093001.11914,647650.277927
5506,57,27660,2760240,2732580,2744451.0,2728292.4,3541757.73047,2668774.98812
8054,178,621600,904200,282600,247355.15625,281523.6,543079.857422,95761.1176914
2227,63,664260,6236460,5572200,5566471.0,5575420.8,26330813591.1,5493726.4423
6232,220,581520,2717640,2136120,2257270.5,1923202.8,0.0,2015599.21261
532,88,16200,555360,539160,1363642.625,1100050.8,2231227.33789,2344729.5473
7425,178,78000,904200,826200,895700.3125,838280.4,288668.962891,212550.957163
4424,141,3736740,7409700,3672960,3659113.25,3677521.2,3278124.69922,3450188.28931
240,111,242280,3974400,3732120,3730190.75,3729984.0,4507822.45312,4235923.1263
7814,219,2937420,3801540,864120,868248.875,858531.6,1547891.57227,1527279.73132
7913,179,203880,345960,142080,137032.328125,140224.8,57120566679.8,282871.112033
5938,218,1437420,1974480,537060,461420.59375,529503.6,0.0,115155.399911
4804,90,31200,1532940,1501740,1534078.375,1570244.4,1380691.05469,1470664.77068
3508,199,0,975720,975720,1948137.625,3043743.6,3013864.75,1941710.5969
5003,69,1933860,2073180,139320,94641.6171875,143485.2,0.0,-458700.750576
3011,67,2682960,3120480,437520,442040.1875,438194.4,941446.521484,743425.649593
8794,196,3143340,3285300,141960,131138.21875,185565.6,79720804009.5,237245.200243
7426,174,1226340,1300440,74100,182362.484375,306932.4,0.0,-387838.675352
5942,76,4998960,7556100,2557140,2559680.0,2553150.0,20323523315.3,2957418.4156
4715,69,1774860,2073180,298320,247330.8125,288888.0,0.0,10043.7045462
6198,210,911760,1118160,206400,31142.703125,212840.4,0.0,-275025.553479
2296,126,197460,496560,299100,664931.4375,863638.8,1169337.41406,1232092.37058
4470,133,2614980,6184800,3569820,3612383.25,3551155.2,4107820.13672,3742316.58453
229,146,161940,6670800,6508860,7501256.5,6520603.2,8627496.93164,7446125.71419
8047,178,618900,904200,285300,258447.40625,267972.0,1178092.33008,245603.222897
2845,215,160800,1851720,1690920,1279531.5,1785831.6,11378.4609375,772558.694894
2084,61,1958760,6225300,4266540,4505581.0,4265565.6,0.0,4020098.79757
8615,63,6004740,6236460,231720,244339.953125,230416.8,16220691828.0,292797.859014
2960,108,1442940,3191940,1749000,1867068.25,1758559.2,1889021.45117,1804887.01618
4916,125,3778560,3969060,190500,261096.609375,172042.8,409199.523438,559809.940749
1878,115,630000,954000,324000,536356.3125,454075.2,1234910.38477,1536919.06187
6201,76,5360400,7556100,2195700,2396663.25,2223663.6,75007153747.5,2211912.43189
1461,1,87780,1447140,1359360,1268742.75,1342108.8,655746.123047,883737.779982
6379,151,2895660,3643800,748140,734749.4375,734842.8,296778.396484,696022.2156
2815,123,1119180,3545820,2426640,2473958.0,2311129.2,3125277.54297,2203781.71097
5046,71,3624300,3996240,371940,362232.625,372322.8,32009884645.0,279787.095033
2298,83,1519200,1818000,298800,295043.4375,285841.2,17651.1601562,319207.341006
1073,118,456300,459900,3600,0.0,166618.8,149172.267578,-36890.4918228
4914,142,4047060,7303560,3256500,3299015.75,3245294.4,3400423.88867,3421508.39933
8163,13,1849260,2529540,680280,704465.9375,677208.0,1742074.48242,1029330.61112
6579,131,4895460,6829500,1934040,1919960.75,1859458.8,1156832.87891,2201419.89321
1670,1,220020,1447140,1227120,1233481.5,1221208.8,2424643.88477,2238392.28305
5700,4,74760,1326000,1251240,1158426.0,1161524.4,210877.703125,624873.119786
5916,57,256680,2760240,2503560,2490306.75,2500993.2,0.0,2102564.90161
6718,10,945720,979740,34020,44152.9609375,78111.6,438638.568359,-229958.761357
4758,86,3373140,3519180,146040,144909.53125,151904.4,385589.019531,368289.597233
6685,61,5759700,6225300,465600,1017804.3125,822446.4,167152.414062,672189.819573
2599,103,2106060,4719960,2613900,2567600.75,2521953.6,2334907.59766,2030008.53927
6754,32,260760,1205580,944820,906417.0625,895962.0,475164.003906,548741.100221
4743,142,3955680,7303560,3347880,3345321.5,3335380.8,3083267.96094,3365766.87789
5500,142,4535160,7303560,2768400,2699439.0,2737504.8,11993940159.4,2809839.87621
6408,31,187680,1374660,1186980,1163632.125,1146458.4,961069.054688,938366.279783
5752,220,99660,2717640,2617980,2520653.25,2560518.0,1876509.82422,2100784.20786
7488,15,693240,1826460,1133220,1134545.25,1135155.6,1040336.42578,921862.065757
1241,131,450900,6829500,6378600,6246447.5,6360304.8,5641369.19727,4906998.34214
5535,10,20460,979740,959280,1621391.0,1518115.2,1789145.78516,1892410.57727
8215,11,1616040,1777560,161520,170742.90625,165943.2,0.0,270488.061005
7888,22,31500,813960,782460,499370.8125,582950.4,1498049.9043,1235114.52075
993,66,895860,4817700,3921840,3913024.75,3844084.8,2917681.28516,3796862.21125
6790,191,1777320,1811280,33960,52503.8554688,105846.0,0.0,160149.438459
2656,63,1084020,6236460,5152440,5165597.5,5188501.2,0.0,5279621.45157
8842,76,7434000,7556100,122100,85512.1640625,135114.0,0.0,150184.910505
388,128,346200,346200,0,463550.8125,415552.8,0.0,-604531.478953
5981,13,9960,2529540,2519580,2510113.75,2248761.6,1706712.91797,1399224.83868
6924,18,595140,1783140,1188000,1167052.625,1177897.2,1107065.70898,1287889.71741
6900,167,11040,534900,523860,495244.9375,488478.0,1526288.83984,1224312.16223
6494,155,2506200,3225180,718980,728995.625,692000.4,1093409.01953,789827.004812
3778,98,3128580,7323480,4194900,4198097.5,4097265.6,4862434.17578,4352762.81126
292,91,0,1030200,1030200,2429794.0,3139790.4,2723638.17578,2889188.68339
6306,31,134820,1374660,1239840,1191977.875,1233992.4,1169818.38477,636992.055536
1386,77,200040,3257040,3057000,3499435.25,3203649.6,4868233.4209,3936689.16552
8086,76,6829200,7556100,726900,722588.0625,707029.2,0.0,591760.467754
3344,67,3069900,3120480,50580,70479.1328125,64874.4,0.0,-495014.106737
8403,28,496860,496860,0,0.0,8271.6,625169.78125,855490.297443
1784,98,1481040,7323480,5842440,5838618.0,5838813.6,5903468.50195,5551695.57592
3918,114,1024680,1201080,176400,170471.90625,224190.0,615036.148438,523120.057537
5100,157,24240,1993260,1969020,2043518.25,1950680.4,1807553.32812,1307902.37672
924,105,729720,1314480,584760,640722.4375,510048.0,2572127.15039,1258249.71476
3563,147,1326660,1479360,152700,151484.59375,168199.2,0.0,81389.4999755
4472,156,2008320,2639280,630960,633976.9375,608337.6,1001208.86133,574397.182358
5740,57,171780,2760240,2588460,2709598.0,2525844.0,2756365.36328,2477405.32135
3732,203,833100,1897500,1064400,1009844.5625,1022102.4,0.0,1255323.88549
6974,222,258540,1113000,854460,886805.125,826966.8,0.0,-36384.9222016
205,68,219000,262800,43800,203839.609375,356379.6,2475053.20703,2902155.08662
760,124,625800,754200,128400,111834.429688,137919.6,93769.46875,298936.67321
997,76,835620,7556100,6720480,6730269.0,6673449.6,6924206.14258,6688045.62855
6035,220,266400,2717640,2451240,2520667.25,2455042.8,2595445.07617,2573056.87816
2119,66,1965600,4817700,2852100,2838211.5,2812996.8,3320613.50391,2859160.57848
5988,220,233520,2717640,2484120,2516366.0,2574458.4,3162613.05273,2602211.11269
2836,215,155760,1851720,1695960,1512786.875,1669215.6,763637.416016,1071747.00252
2574,156,500880,2639280,2138400,2189893.0,2097217.2,1000593.45117,1496963.92519
2416,66,2312100,4817700,2505600,2498641.5,2624094.0,2392845.39648,2350168.64363
8880,196,3201360,3285300,83940,75350.7265625,140118.0,0.0,253426.913528
1226,12,57000,850020,793020,618534.375,948154.8,691535.464844,747879.358907
6680,18,281460,1783140,1501680,1841158.625,1601078.4,408173.820312,1117623.73304
569,135,9000,5649480,5640480,1931943.625,2522103.6,2710870.07617,2482330.05987
6456,31,223620,1374660,1151040,1172309.25,1160382.0,1195766.13867,1295585.26275
2975,108,1450140,3191940,1741800,1741390.125,1743057.6,1612716.36133,1601317.71437
5086,156,2501580,2639280,137700,149283.546875,138492.0,17487118792.4,27714.8849051
5076,180,1104000,3322080,2218080,2068601.75,2233152.0,2468087.27344,1964037.99476
247,65,172800,7548000,7375200,6512214.5,6805056.0,5317778.28125,5677587.6
7451,188,3148980,4331160,1182180,1151098.625,1193521.2,1154096.08398,1054523.85404
5072,98,4152480,7323480,3171000,3113157.0,3170509.2,3411245.14844,3056046.53229
2644,135,1856940,5649480,3792540,3843709.5,3779413.2,5768257.08594,3928955.02945
7202,213,2639580,3206820,567240,562324.4375,568141.2,0.0,491336.386043
4917,130,3083940,3083940,0,31997.8320312,121186.8,0.0,283821.969458
5788,63,3618540,6236460,2617920,2564310.75,2621131.2,27261024506.8,2689152.65588
7033,167,82680,534900,452220,478290.3125,470895.6,0.0,355337.364855
406,53,24120,582540,558420,767941.0,890068.8,3358449.38086,2468914.60386
6193,63,4046940,6236460,2189520,2188468.75,2197371.6,0.0,2072150.75516
4864,215,1848120,1851720,3600,0.0,52509.6,0.0,-650788.551006
7997,7,40380,40380,0,567232.4375,420034.8,1534499.05469,1658632.64175
4972,90,118500,1532940,1414440,1392019.0,1442398.8,13499.9414062,221407.712351
1983,72,1172760,2385960,1213200,1254042.25,1379409.6,1801293.82812,1504784.7085
2753,98,2278740,7323480,5044740,5035622.5,5046625.2,42480200436.4,4783582.00298
5810,89,670920,1736340,1065420,976911.0625,694665.6,1489279.98242,1152567.91707
3390,114,542220,1201080,658860,736970.8125,628104.0,0.0,313369.572978
5470,196,471300,3285300,2814000,2691423.75,2615973.6,2587036.64062,2157366.49447
3948,116,433800,786600,352800,289821.4375,375590.4,0.0,199118.021595
2660,133,1146540,6184800,5038260,5035746.5,5075601.6,6480025.86914,5057678.06351
3075,151,124380,3643800,3519420,3028686.0,2433536.4,2335763.64258,1831307.30845
929,144,192240,1807260,1615020,1414735.0,1457271.6,2878439.09961,2240901.66161
5332,146,4532220,6670800,2138580,2198573.5,2142027.6,2324699.50977,2331012.26458
96,149,88140,223140,135000,66416.59375,138046.8,2170960.02734,1870973.81308
8976,160,1524660,1567860,43200,111884.257812,44787.6,0.0,139135.629463
194,100,4560,919500,914940,2482465.25,1976828.4,2888519.01367,2745859.16885
8636,64,6763980,6848760,84780,145571.03125,117298.8,338712.853516,377374.073527
4502,153,1618560,1618560,0,0.0,66636.0,817237.613281,855075.754006
1055,131,278700,6829500,6550800,6556720.0,6566205.6,4321049.24609,4125294.47564
8359,30,402060,608400,206340,542468.5625,458095.2,761628.441406,86244.7741939
2825,69,163680,2073180,1909500,1793570.0,1763710.8,817000.212891,1276470.14157
3313,114,477660,1201080,723420,722512.4375,723288.0,530011.25,830044.60603
7869,15,1063020,1826460,763440,848568.75,780948.0,476576.0625,745231.468287
7636,219,2794680,3801540,1006860,977478.1875,991874.4,978501.220703,959149.670001
1373,146,1275360,6670800,5395440,5438943.0,5387166.0,4621204.53906,5424069.11291
6554,208,28440,1624080,1595640,1723197.375,1775352.0,983936.697266,1403019.64617
8151,224,0,651660,651660,310353.28125,458746.8,643718.224609,625631.92551
4102,131,2940720,6829500,3888780,3830381.25,3882598.8,3145868.46484,3537861.29603
981,105,798720,1314480,515760,497198.15625,520842.0,795926.951172,601083.325064
5208,146,4445820,6670800,2224980,2347399.25,2305230.0,1208792.26172,2425778.27299
4589,182,849660,915060,65400,40556.46875,185758.8,0.0,-69304.2322966
3955,123,2160420,3545820,1385400,1348154.625,1274667.6,254979.724609,1346440.97251
8873,29,21360,57540,36180,0.0,44900.4,0.0,31560.2382776
1065,112,0,1303440,1303440,2011882.75,1625974.8,3599727.19727,2899852.0359
3427,137,69180,243720,174540,94755.1640625,172704.0,126314.113281,220744.258582
8072,222,1081800,1113000,31200,37293.0429688,37803.6,0.0,-595590.685367
5524,76,4776000,7556100,2780100,2784798.5,2777449.2,2798873.35156,2796298.27657
3704,148,1938900,1938900,0,12461.921875,85060.8,0.0,-393443.003382
5476,213,1243500,3206820,1963320,2023556.125,1918916.4,2933213.91016,2446552.44765
4762,215,1794600,1851720,57120,56673.7070312,88978.8,0.0,-630521.467129
4906,142,4042980,7303560,3260580,3258669.0,3252565.2,0.0,3341469.98696
4832,156,2357460,2639280,281820,302167.84375,290199.6,1167422.73047,239669.998135
5956,204,18780,2571300,2552520,2589824.0,2450178.0,3232383.63672,2902306.30285
8783,37,578880,739620,160740,162691.78125,345766.8,0.0,39034.6108039
7770,58,80100,995700,915600,853894.1875,857115.6,0.0,-221634.239111
7646,63,5228340,6236460,1008120,701879.1875,903070.8,0.0,922309.99162
177,141,6000,7409700,7403700,3989869.5,3356048.4,3172956.15039,3118678.00808
2125,63,614160,6236460,5622300,5528349.5,5500574.4,5626424.69531,5548005.61621
1966,111,1882560,3974400,2091840,2117404.75,2123545.2,2656484.2168,1873491.74082
6247,11,80820,1777560,1696740,1970370.75,1704879.6,1864043.42383,2603719.45478
7037,195,115200,393120,277920,304722.21875,335572.8,0.0,142332.30394
1349,67,1292820,3120480,1827660,1792172.5,959304.0,4223534.01172,3177390.22788
1583,135,875220,5649480,4774260,2587070.75,3481171.2,1350801.10938,1889772.07498
4845,156,2368920,2639280,270360,277294.25,282357.6,1648245.78125,191762.937635
178,120,171600,576000,404400,416478.625,608262.0,1862424.15039,1884200.7563
4017,184,646800,1800900,1154100,1131669.875,1003597.2,1199940.70117,1041334.00921
1942,96,18060,2123400,2105340,1942466.375,1637976.0,1553728.56445,1536162.23017
2966,173,169020,3215700,3046680,3059097.25,2959316.4,2527338.64258,2435899.57058
4829,169,91860,2190660,2098800,2192710.75,3263695.2,1994367.14453,2362849.42099
5567,214,337260,341760,4500,142150.21875,27136.8,85143.1816406,466488.19058
392,53,17100,582540,565440,496193.9375,927000.0,875441.615234,1824672.0077
7493,220,1529640,2717640,1188000,1049698.5,1141342.8,472214.34375,381257.493903
762,76,652800,7556100,6903300,6954690.0,6906063.6,6866143.25,6749099.70244
4133,198,708660,708660,0,17339.8535156,36946.8,0.0,-773519.049692
2150,96,163800,2123400,1959600,1789492.875,1512596.4,597406.441406,1065888.25852
2452,94,534480,534480,0,0.0,279386.4,495550.470703,284002.345411
7203,61,6220800,6225300,4500,0.0,34678.8,2.01765674409e+11,99203.828557
2748,73,11100,1303500,1292400,2312292.5,1394523.6,2093877.18555,2143177.08107
3111,130,1671660,3083940,1412280,1468337.125,1437328.8,0.0,1612233.2863
2724,200,29040,59160,30120,167631.328125,560209.2,895471.822266,1848737.32233
7754,31,1319580,1374660,55080,55782.953125,54289.2,0.0,-306572.053876
4091,151,1074960,3643800,2568840,2495976.5,2544069.6,2487110.23633,2250963.76496
5429,49,3987540,3991980,4440,0.0,320362.8,30085062548.7,395542.469556
2995,67,2672700,3120480,447780,437842.71875,436252.8,269539.521484,544696.390924
6463,188,2399160,4331160,1932000,1857064.5,1828671.6,1944231.10742,1873494.72942
9016,131,6802800,6829500,26700,0.0,11612.4,0.0,-36759.6207198
5221,156,2579700,2639280,59580,66766.8125,92730.0,423775.109375,45749.15887
6492,63,4244820,6236460,1991640,2042270.75,2017630.8,92612752585.8,2112554.2052
1071,78,518400,1818900,1300500,1278793.625,1242866.4,16026.0371094,642323.330727
4939,146,4290300,6670800,2380500,2221638.5,2443792.8,3446586.82031,2944772.17047
7939,63,5429340,6236460,807120,793608.3125,790740.0,80659185112.6,712574.563035
2668,69,31860,2073180,2041320,2593600.0,2229789.6,1673571.50977,1757526.10511
7357,5,744600,748200,3600,9343.38574219,149314.8,0.0,-361749.022517
7499,27,198720,402780,204060,176004.96875,194426.4,0.0,217394.780977
7971,196,2506260,3285300,779040,766792.0625,777489.6,239373.208984,650546.532901
43,51,3000,280800,277800,94011.71875,552507.6,692036.759766,1539756.33456
953,66,863940,4817700,3953760,3959886.25,4011820.8,4068975.91406,3905138.82267
2868,173,108360,3215700,3107340,3013512.25,3136298.4,3672712.87109,2942079.00965
5355,142,4322340,7303560,2981220,3115427.0,2896550.4,3400022.34375,2676816.80369
2902,173,117600,3215700,3098100,3150522.0,3102475.2,3946098.0,3049456.60086
808,83,158400,1818000,1659600,1639459.25,1649284.8,2398246.70508,2663081.46374
960,131,84780,6829500,6744720,6835618.5,6706052.4,4811769.14844,4552445.32262
3930,218,0,1974480,1974480,1698895.25,1494800.4,1984511.67383,1572938.01479
6210,176,225180,1462860,1237680,1235915.25,1238884.8,928174.246094,638795.304984
3986,130,2403540,3083940,680400,696828.75,666367.2,0.0,816289.39523
2875,171,312600,435600,123000,279179.03125,170565.6,539038.177734,1012371.25136
6595,75,5053560,6135000,1081440,1072219.0,1032590.4,1052471.51562,1037891.97275
1029,83,376200,1818000,1441800,1446300.625,1441758.0,1652390.5293,1746083.13227
6042,210,633600,1118160,484560,487511.75,469598.4,990905.425781,695374.316981
1234,117,30120,1144740,1114620,1490026.375,1226342.4,3064593.95898,1989543.92094
7751,219,2882340,3801540,919200,913595.0625,903088.8,378610.257812,714942.296473
1243,138,1225200,1785600,560400,561961.6875,366614.4,18549798352.5,476279.357743
2285,134,757920,3656580,2898660,2901388.25,2755946.4,1921133.58789,1810623.0188
1964,113,511860,3646740,3134880,2510050.5,2840415.6,0.0,2754871.90822
7930,15,1100820,1826460,725640,719105.3125,735459.6,14006.6816406,649057.324704
895,106,699840,1023180,323340,608129.5625,314472.0,282990.583984,598710.036671
8586,159,2484180,2484180,0,0.0,72040.8,0.0,-1416491.1751
2360,135,1568220,5649480,4081260,4176215.75,4021005.6,4177359.33398,3540120.48225
6092,220,453060,2717640,2264580,2290176.5,2259532.8,2870028.58789,2584723.49325
6575,26,303720,2040360,1736640,1604888.375,1639179.6,1261067.94922,1684986.68201
1377,133,14400,6184800,6170400,5715812.0,4475943.6,2338401.93164,2553576.06876
5084,71,3636600,3996240,359640,340200.90625,351771.6,0.0,262998.523302
4828,2,2880,2555640,2552760,2264989.75,2062052.4,1578259.85352,1468419.47185
2008,126,0,496560,496560,910841.5625,774328.8,1120764.72656,1578757.2133
6049,63,3776400,6236460,2460060,2452401.75,2449798.8,0.0,2588089.81292
6268,172,24480,1443960,1419480,1355041.875,1419350.4,994171.359375,577027.76604
1429,121,825900,856140,30240,156701.4375,38102.4,0.0,-472705.718061
6034,57,342720,2760240,2417520,2400264.25,2392632.0,29497462125.4,2339412.30712
651,84,459780,3714840,3255060,3169731.0,3303488.4,2742475.78516,2933267.95727
3402,137,61080,243720,182640,157395.609375,182086.8,335098.736328,486201.71146
8419,37,377580,739620,362040,323975.8125,361012.8,943247.675781,1047762.44875
916,142,532380,7303560,6771180,6768300.0,6635672.4,6785790.30469,6716876.87377
2818,63,1222740,6236460,5013720,5004937.5,5016909.6,36058412124.6,5195858.38767
6530,10,823920,979740,155820,155705.796875,194760.0,150524.271484,167007.280866
2821,0,204840,1560960,1356120,2360882.0,2574301.2,2926733.48828,2319072.13222
3267,162,420660,4839720,4419060,4328695.5,4270260.0,3814615.7207,4141812.77754
5610,193,23400,187200,163800,306396.0625,978592.8,182269.427734,525408.327924
5564,113,3509460,3646740,137280,165853.90625,282854.4,618874.636719,474357.530588
290,120,264900,576000,311100,410012.25,478862.4,737525.964844,1127697.22659
5170,125,3920160,3969060,48900,45637.7617188,77460.0,339512.003906,117984.396883
2494,156,445980,2639280,2193300,2359136.75,2192526.0,2386635.45508,3406247.96208
5117,156,2518320,2639280,120960,121003.125,123354.0,0.0,74486.82804
8449,224,339180,651660,312480,309861.5625,272703.6,0.0,-170182.895714
2736,110,2461080,5579400,3118320,3123680.5,3137630.4,3030010.98633,2877912.45649
6860,61,6018060,6225300,207240,287009.375,254706.0,707119.400391,409395.878203
999,86,37680,3519180,3481500,2875122.5,3477967.2,2952971.79102,3066067.71659
574,127,16440,599940,583500,535386.1875,1217392.8,1991248.07031,2035783.65586
105,76,46200,7556100,7509900,7212905.5,6665817.6,5577801.44141,4608775.85029
467,103,217500,4719960,4502460,3539854.25,2780061.6,2229328.47656,2814306.68572
377,79,201660,4151700,3950040,3956583.75,4000858.8,5101255.36328,4235947.49296
859,84,606420,3714840,3108420,2720409.5,2892079.2,3066727.13672,2652138.99506
5979,63,3716160,6236460,2520300,2514910.75,2517642.0,0.0,2632438.44445
2223,112,932760,1303440,370680,660278.5625,272215.2,227549.722656,215185.654994
492,141,374400,7409700,7035300,7035609.5,7033123.2,6518676.01758,6152805.04307
5483,102,2989980,3198240,208260,210195.5,240606.0,791400.744141,727529.303073
1273,117,50460,1144740,1094280,1874726.75,1329976.8,2045124.75,1867905.36859
8722,221,855000,938400,83400,82341.9453125,81044.4,173831.830078,-159968.686101
1548,132,172440,1658640,1486200,1474747.75,1341123.6,3266392.5918,3413382.66482
7521,185,41400,441420,400020,460583.28125,362924.4,2640005.47266,980774.983409
2809,63,1220940,6236460,5015520,4944084.5,4996700.4,1.39741395767e+11,4815798.49584
4213,73,1256400,1303500,47100,327926.6875,75048.0,0.0,-183995.517073
8392,220,2367540,2717640,350100,348608.3125,355808.4,292354.509766,389592.247307
5004,69,1933860,2073180,139320,150020.140625,145762.8,0.0,-458700.750576
4050,116,493200,786600,293400,171090.3125,214011.6,174521.191406,285332.078698
8462,133,5966520,6184800,218280,215088.890625,217502.4,264369.070312,346512.781648
273,87,164100,1090800,926700,856366.9375,774351.6,1005455.76172,1662670.54232
9001,42,927960,956940,28980,60315.765625,28549.2,229035.78125,261863.995961
4548,213,434040,3206820,2772780,2800164.5,2756769.6,2729758.30859,3133858.91237
2612,92,0,613860,613860,892303.4375,1520056.8,27277628130.0,330994.71001
1982,63,504540,6236460,5731920,5730702.0,5733096.0,6636795.61133,5689505.80142
8588,14,1259160,1331160,72000,68803.34375,74994.0,119866.853516,215313.131736
200,149,173040,223140,50100,34751.7109375,68248.8,0.0,225901.239764
4550,156,2072820,2639280,566460,575718.0,561541.2,1903627.25977,778719.880932
7876,170,0,668760,668760,358490.25,564553.2,295608.933594,320008.211702
8485,212,129420,204240,74820,109396.625,143672.4,0.0,100461.544171
1947,98,1588980,7323480,5734500,5705533.0,5470993.2,5565792.45117,5585767.43487
7379,16,13200,117000,103800,45713.8476562,125038.8,0.0,-1492844.85885
1456,63,11400,6236460,6225060,5993980.5,5945712.0,4047139.82227,3962854.38314
1599,122,606480,861720,255240,211161.984375,252763.2,0.0,233427.378489
1808,104,872100,935100,63000,62811.5117188,91016.4,0.0,-14889.8923971
5285,103,4204620,4719960,515340,556324.5625,450483.6,2459695735.93,519471.387941
3275,23,976500,1894920,918420,925655.25,920580.0,111118.919922,594475.372772
8476,139,24600,273900,249300,243336.265625,230320.8,329558.640625,284681.18482
3698,199,119340,975720,856380,900437.5625,1054442.4,1677255.55078,2551774.90532
7292,3,67560,1059180,991620,1013255.5,977968.8,499966.191406,1069227.78532
3351,23,1031820,1894920,863100,863499.875,868894.8,0.0,523677.780679
2765,165,70500,1262880,1192380,1242552.125,1196756.4,242000.992188,907990.943953
1834,133,456420,6184800,5728380,5459419.0,5538728.4,5255057.34375,5239223.87317
8140,190,14880,709200,694320,774591.6875,629953.2,0.0,-409831.717466
7383,178,61800,904200,842400,803603.75,806708.4,0.0,-516417.235057
5137,98,4180380,7323480,3143100,3144561.75,3148722.0,4428684.23633,3426801.46276
1734,63,336240,6236460,5900220,5914169.0,5888978.4,6112254.39453,6351526.11972
1634,135,904440,5649480,4745040,4634452.5,4415280.0,2428456.70312,2262717.2945
6087,13,118680,2529540,2410860,2446036.0,2391577.2,2155004.55469,1706005.69296
2152,133,684360,6184800,5500440,5712128.0,5312062.8,5165987.79102,4549120.87191
4127,165,1262880,1262880,0,20137.1621094,63213.6,134850.970703,-462830.003785
3667,148,1917240,1938900,21660,50253.40625,45819.6,0.0,-1156289.53667
1033,62,136860,3674460,3537600,3453680.25,3962745.6,3456513.23633,4850458.79941
3281,166,1048260,1666080,617820,648032.25,705258.0,510552.984375,628838.085895
1765,122,861720,861720,0,90283.59375,466732.8,0.0,185481.437148
4915,142,4047060,7303560,3256500,3299015.75,3246206.4,2773671.58984,3421508.39933
8274,14,1010460,1331160,320700,329022.1875,335851.2,298967.896484,58216.1793169
2199,82,1468680,2195880,727200,778542.8125,675068.4,0.0,580851.212566
3010,67,2682900,3120480,437580,431924.15625,422304.0,660352.1875,652101.782355
234,124,124200,754200,630000,815804.25,1355516.4,2003933.54297,978756.817593
5920,76,4984140,7556100,2571960,2565697.25,2567792.4,2539939.36523,2524065.11529
3709,203,808800,1897500,1088700,1082525.875,1086614.4,1.56894719279e+11,1274230.10341
6572,32,128880,1205580,1076700,1001447.375,966776.4,327218.519531,729263.318247
7427,164,123540,123600,60,9272.91796875,21684.0,0.0,49745.3748247
349,51,277200,280800,3600,0.0,41943.6,0.0,164965.415546
4876,168,438000,438000,0,5871.95947266,16723.2,105663.685547,143391.901064
8440,30,465240,608400,143160,199011.484375,125001.6,1521425.62109,394386.852671
6777,46,1873860,2027040,153180,65260.3125,118520.4,107849.025391,-61580.3304407
2005,63,529740,6236460,5706720,5707529.5,5698858.8,5112217.70117,5006872.1578
8583,30,555840,608400,52560,32716.9472656,70882.8,110477.638672,-108231.470297
4750,151,1594680,3643800,2049120,2084865.375,2056273.2,1792845.67383,1924100.6135
957,80,338580,338580,0,18038.1445312,143424.0,764362.634766,270540.075218
1891,133,507240,6184800,5677560,4974095.5,5255036.4,5676040.65625,5124429.8771
7947,63,5432940,6236460,803520,792891.3125,796252.8,0.0,648743.317921
6097,174,232860,1300440,1067580,1193994.25,1116073.2,1656158.20703,1192399.34238
8438,30,464700,608400,143700,165226.453125,125408.4,883574.796875,150959.578853
7041,195,117360,393120,275760,308029.53125,324876.0,0.0,348266.631
2176,101,263400,655020,391620,377527.34375,422707.2,0.0,94068.1308148
2813,165,123480,1262880,1139400,1659793.0,1363285.2,1834490.31055,1001670.52623
2835,158,262320,2044680,1782360,1977981.875,1924999.2,2720363.51367,2434070.209
6616,204,649740,2571300,1921560,1871994.125,1893066.0,1479849.55078,2101254.93103
4067,184,676800,1800900,1124100,1104430.5,1015899.6,736718.402344,747867.339855
8808,76,7416720,7556100,139380,133961.875,124269.6,2.37193871242e+11,3049.04275547
7810,22,0,813960,813960,403424.09375,421921.2,342485.824219,988582.591371
5739,216,465780,496500,30720,0.0,28706.4,0.0,-319521.445686
5902,57,255060,2760240,2505180,2600909.25,2505610.8,0.0,2373748.73527
7755,58,65940,995700,929760,603352.3125,857094.0,0.0,-250787.166284
3332,130,1828800,3083940,1255140,1274551.5,1046060.4,535822.896484,859594.87536
8307,208,1549860,1624080,74220,124236.960938,94932.0,0.0,-21259.367218
2600,123,952320,3545820,2593500,2593646.5,2594269.2,2335812.05273,2604614.15246
2864,141,2443920,7409700,4965780,4991453.0,4912868.4,4208985.87305,4555088.18851
1796,63,377940,6236460,5858520,5862018.0,5859404.4,4635798.80469,5303501.05602
2258,75,1452660,6135000,4682340,3722644.5,3756960.0,79879481002.6,3506181.98809
6990,146,6022800,6670800,648000,624854.75,652886.4,701616.537109,748053.740395
7184,14,81120,1331160,1250040,1248331.625,1252678.8,6773139527.61,1150964.65173
1610,132,220740,1658640,1437900,1655525.375,1216396.8,2643849.1543,2305593.9874
2899,114,48120,1201080,1152960,1905491.625,1539991.2,2064998.68555,2045291.43843
2217,84,1845360,3714840,1869480,1873668.75,1958360.4,1813220.57422,1747996.73241
4484,186,34080,3639840,3605760,3375935.25,2805536.4,1294806.0918,966456.967032
4406,152,137760,3770100,3632340,2779552.25,1844406.0,1196200.94336,1377146.74185
7725,178,423060,904200,481140,260520.296875,232998.0,303571.917969,417625.740543
3518,71,2416620,3996240,1579620,1553386.375,1503736.8,1746898.94727,1048350.83316
6256,204,409080,2571300,2162220,1924619.125,2096946.0,2623670.67969,2448452.97517
8903,190,619080,709200,90120,96556.3125,68780.4,0.0,-731818.876261
1491,110,1331400,5579400,4248000,4202341.5,4254642.0,3553248.39258,3159068.99808
8062,159,2006880,2484180,477300,491402.125,455167.2,0.0,-228418.920776
1011,66,937080,4817700,3880620,3859214.0,3816721.2,3880379.4668,3663585.76283
125,106,18000,1023180,1005180,1069926.625,1009286.4,0.0,913049.766053
6227,162,2835720,4839720,2004000,1978562.375,1938936.0,2478213.60938,2173941.53004
7485,27,185460,402780,217320,226374.421875,215330.4,2748719.77344,2267839.98513
3968,71,2857200,3996240,1139040,1143200.25,1102435.2,1313297.67188,1046296.14397
4152,114,1164180,1201080,36900,25777.671875,177684.0,0.0,-76521.3200098
4732,187,62100,2496960,2434860,2000028.25,1737133.2,521660.714844,735889.358156
2332,23,64380,1894920,1830540,1846513.5,1696467.6,5488801987.92,2219660.32027
6403,151,2909040,3643800,734760,726103.875,728774.4,1092740.07227,873056.032861
5083,146,4369680,6670800,2301120,2254805.25,2287587.6,83727603576.0,2337960.34387
5865,196,706860,3285300,2578440,2401043.25,2546020.8,2656059.51953,2340622.64662
6521,10,813600,979740,166140,166030.25,301588.8,806955.007812,-19710.5123545
6895,195,34920,393120,358200,388621.375,434762.4,1116040.53516,1049105.24734
1134,76,1087200,7556100,6468900,6503651.0,6472660.8,6339586.43164,6228263.04704
6606,5,155340,748200,592860,576475.1875,566546.4,0.0,213044.735008
1409,1,44580,1447140,1402560,1631298.75,1271779.2,128505.757812,452715.271172
6150,131,4603320,6829500,2226180,2215371.75,2274862.8,2303580.61523,2095706.28501
748,80,181920,338580,156660,310620.40625,517939.2,978561.335938,1638063.14874
9041,131,6825900,6829500,3600,3978.03735352,5317.2,0.0,137363.21789
1502,12,235500,850020,614520,679301.1875,702871.2,0.0,728086.645099
6916,222,222300,1113000,890700,876516.375,849152.4,110465.935547,228332.689279
3251,77,1896660,3257040,1360380,1342941.625,1430007.6,1170178.30859,1566711.28298
1729,79,1555200,4151700,2596500,2606238.0,2577802.8,1744510.44336,2526358.96838
3892,213,25680,3206820,3181140,2138521.0,2630517.6,2838859.39258,1983355.14594
2957,135,2083920,5649480,3565560,3232508.0,3122806.8,3659501.91406,3548145.95677
8237,63,5633340,6236460,603120,601308.375,601603.2,0.0,428783.010745
6166,98,5131800,7323480,2191680,2191465.25,2135612.4,0.0,2275907.62724
2986,132,1430400,1658640,228240,209626.984375,226682.4,1026147.08984,327902.771201
5192,157,64680,1993260,1928580,1666679.25,1473146.4,1009244.85742,1113768.50294
7068,209,4500,1095000,1090500,1277432.375,1388353.2,681226.730469,969027.284327
4882,161,1870080,1955580,85500,43378.9335938,80548.8,0.0,249366.468557
4136,153,1401480,1618560,217080,230628.046875,262081.2,1689834.53516,1356080.75255
2195,63,644340,6236460,5592120,5572160.0,5592927.6,4709041.61133,5297996.35601
5350,177,1315440,1713060,397620,404477.96875,563178.0,440365.472656,537514.779689
9067,76,7556100,7556100,0,9064.65917969,64390.8,26170.4609375,117382.228041
2186,1,716880,1447140,730260,731601.1875,744124.8,1249008.17773,555911.510756
6731,75,5159760,6135000,975240,979122.875,975238.8,1249781.26172,1042261.2801
17,149,0,223140,223140,2658466.25,1800238.8,1506290.85547,2054667.61207
7739,219,2875140,3801540,926400,924191.1875,927222.0,1874841.25586,1213128.085
1481,146,1341840,6670800,5328960,5414732.5,5316373.2,5814017.06836,5164663.22419
6555,208,28440,1624080,1595640,1718364.25,1758562.8,2159321.29102,2177161.01679
6759,75,5178000,6135000,957000,989194.4375,920700.0,908110.484375,983793.928068
1128,121,611700,856140,244440,212338.703125,244794.0,0.0,-535540.76065
7224,61,6225300,6225300,0,4668.07910156,52576.8,1917156.71289,187824.696929
2970,162,74400,4839720,4765320,4834951.5,4739401.2,3093731.94531,3516201.77658
7382,195,328200,393120,64920,152724.921875,88753.2,0.0,-558956.97291
5057,156,2488260,2639280,151020,152999.328125,149452.8,44068281689.8,-67355.8559899
7299,219,2444940,3801540,1356600,1310423.25,1170668.4,1893697.01172,1669444.98212
5516,213,1261740,3206820,1945080,1963803.125,1876240.8,26328608649.6,2182982.68662
8728,188,4249560,4331160,81600,77708.5859375,143542.8,0.0,-95345.6117764
4332,84,3684300,3714840,30540,0.0,53077.2,138976.216797,113951.598418
948,76,794460,7556100,6761640,6536963.0,6747362.4,6653460.08594,6886994.34796
6670,4,856860,1326000,469140,438047.15625,322866.0,377148.068359,279159.444045
5786,177,1709460,1713060,3600,49910.1796875,469083.6,75484.0957031,-427646.183514
3032,130,1473480,3083940,1610460,1620513.875,1584933.6,1665506.0625,1979988.60859
5061,157,0,1993260,1993260,1375934.125,1140388.8,1263317.92383,1233263.17726
1686,133,244080,6184800,5940720,5958203.0,5888902.8,4275090.99219,4352441.88793
4645,133,2859600,6184800,3325200,3363164.25,3318684.0,3577173.44336,3473260.73855
1466,33,64680,78900,14220,0.0,128011.2,446543.171875,605769.566154
3222,77,1872060,3257040,1384980,1396246.375,1390743.6,2203043.66602,1693968.24892
3711,203,813900,1897500,1083600,1108487.0,1079086.8,579468.410156,1198938.37074
2740,73,0,1303500,1303500,2335933.25,894603.6,2384123.83594,2352556.90945
529,91,283440,1030200,746760,752470.5625,724149.6,1711695.23633,1234127.1656
3309,192,331980,4652340,4320360,4364255.0,4317800.4,4202351.01367,3612288.57583
6089,204,239340,2571300,2331960,2257240.75,2343954.0,2794413.99609,3110095.704
4117,218,108840,1974480,1865640,1638228.25,1088514.0,1782972.6875,1031306.17847
9073,37,739620,739620,0,1137.21728516,22434.0,73341056644.3,422809.919022
1256,61,1266180,6225300,4959120,5012773.0,4960972.8,0.0,5214161.09296
3007,130,1458360,3083940,1625580,1708785.875,1602127.2,1765205.00391,1908575.37804
4417,0,1514820,1560960,46140,225707.1875,49486.8,33497.6386719,429944.870025
793,84,545100,3714840,3169740,2509405.25,2491657.2,2897503.91406,2701642.32796
968,118,229500,459900,230400,249409.84375,368919.6,1586300.56641,778807.411754
407,76,367200,7556100,7188900,7372555.0,7197729.6,8606512.34766,9352797.52779
2156,94,188280,534480,346200,360661.875,343266.0,850901.908203,1352915.98395
7211,213,2640480,3206820,566340,543726.25,566250.0,1328385.88086,604070.838043
5577,213,1304760,3206820,1902060,1910221.875,1896922.8,1674362.96094,1953196.46852
5654,220,60480,2717640,2657160,2278414.75,2139786.0,2408457.48438,2212031.47187
6239,11,76020,1777560,1701540,1743472.125,1701620.4,2281089.61523,2076694.0048
1448,133,70620,6184800,6114180,6166999.5,6104976.0,4390068.10742,4394205.25448
2075,108,695340,3191940,2496600,2321647.75,2350425.6,3085847.33398,2812087.52573
6274,63,4104120,6236460,2132340,2120090.75,2134002.0,0.0,2218719.64322
7209,162,3587460,4839720,1252260,1219780.125,1249732.8,1614491.0918,1149518.97059
8885,219,3721140,3801540,80400,170962.125,79482.0,182879.441406,211629.41921
944,80,313200,338580,25380,16593.53125,158241.6,256950.314453,402559.32725
7531,16,117000,117000,0,0.0,33856.8,233529.091797,-134167.543682
221,84,26520,3714840,3688320,6011068.0,3760526.4,4550237.55469,4319583.28605
7103,213,2585880,3206820,620940,629052.0,639397.2,971816.814453,567859.058863
6631,75,5079180,6135000,1055820,1048883.25,1046581.2,1424164.52539,793211.824398
8970,42,918300,956940,38640,67754.8984375,45237.6,0.0,118442.860177
4403,215,1457460,1851720,394260,415383.0,427464.0,311314.183594,-85075.5409048
87,149,77940,223140,145200,441737.8125,298910.4,1972913.42773,1780954.76042
2632,161,16320,1955580,1939260,1717878.25,1973881.2,307720.851562,1691450.83114
1733,98,1448280,7323480,5875200,5938630.0,5863087.2,6521241.36133,5826519.69469
7847,209,644880,1095000,450120,495336.15625,208933.2,671148.837891,956724.410649
2797,171,271260,435600,164340,253983.765625,529117.2,1093074.43555,1324274.25406
4849,103,3973320,4719960,746640,767009.25,691348.8,481471.498047,653056.684001
7861,13,1673760,2529540,855780,829561.4375,853540.8,1431922.9043,847517.740492
6672,31,364500,1374660,1010160,885458.4375,910863.6,723137.306641,788846.078621
93,149,83520,223140,139620,0.0,289611.6,1653105.875,1801186.90166
1173,122,310320,861720,551400,597549.5,614596.8,756667.058594,1144966.58983
3006,130,1458360,3083940,1625580,1708785.875,1600159.2,1489412.79102,1908575.37804
6817,204,913920,2571300,1657380,1614174.75,1623678.0,1381419.27734,1536433.78147
6254,63,4088880,6236460,2147580,2161890.0,2143663.2,4361109929.15,2229103.76403
811,106,637560,1023180,385620,391716.71875,390360.0,651988.998047,615146.510658
2378,166,183600,1666080,1482480,1181090.5,1282142.4,1908861.49023,2305335.65508
3957,79,3487500,4151700,664200,792044.5,866632.8,1871390.08398,1123045.38943
7969,2,2555640,2555640,0,90210.5234375,208768.8,0.0,-542921.026221
8253,220,2153340,2717640,564300,558162.5,555586.8,604897.228516,398403.780138
6279,18,22800,1783140,1760340,1871026.25,1699345.2,1445980.70117,1525024.05636
7248,213,2668680,3206820,538140,601377.75,539029.2,68188440245.0,476313.247758
4092,107,1270620,4995360,3724740,3687403.5,3692272.8,3706926.86133,3568419.54636
2908,142,2353500,7303560,4950060,4950715.5,4952455.2,5327299.79883,5298802.21434
6115,220,493800,2717640,2223840,2165306.5,2153462.4,2546054.4043,2417742.00991
8277,14,1017720,1331160,313440,328748.96875,330512.4,856543.734375,380963.202275
1095,127,534540,599940,65400,83325.9921875,151556.4,124583.849609,186117.622802
1506,105,1314420,1314480,60,0.0,143245.2,344214.755859,155298.123402
6661,46,1783380,2027040,243660,167680.671875,107367.6,786306.666016,-34410.6478247
4878,156,2380080,2639280,259200,174649.921875,201355.2,750388.949219,-47461.4845758
7311,24,1485300,1547520,62220,36797.796875,127591.2,46506.3085938,135248.719372
6195,63,4046940,6236460,2189520,2189670.5,2190493.2,0.0,2085069.8726
2853,158,268740,2044680,1775940,1643074.375,1838512.8,2264108.43359,2453602.13358
1928,63,473940,6236460,5762520,5821502.0,5771666.4,5251009.31836,5712111.43758
933,66,824340,4817700,3993360,3785071.5,3926518.8,4809615.41211,4426516.48456
2174,94,198600,534480,335880,501687.78125,371240.4,1122152.81055,1553179.18768
7925,7,0,40380,40380,495266.6875,553156.8,1482099.32227,693714.176493
7966,209,716220,1095000,378780,378525.65625,375573.6,2179207.43945,1872948.64918
7289,15,544080,1826460,1282380,1290689.875,1116127.2,1050785.5332,714047.392691
4113,163,95640,548880,453240,679125.5625,787802.4,1093166.97266,1003284.27332
1089,72,406980,2385960,1978980,2140809.0,2296694.4,3259174.38672,3062422.65382
1880,111,1836060,3974400,2138340,2057842.375,2206881.6,1915793.42383,2157724.36644
395,53,19620,582540,562920,592204.25,794349.6,1395906.34766,2006453.13815
2042,144,1292040,1807260,515220,509800.90625,512426.4,378230.615234,668790.96746
4973,135,3759180,5649480,1890300,1888384.5,1859930.4,1248196.54688,1676191.2982
1263,122,374700,861720,487020,519370.90625,605452.8,1283852.75195,827855.687188
6221,146,5396340,6670800,1274460,1288994.75,1299956.4,1465042.44141,1292400.09305
6084,204,151980,2571300,2419320,2394653.0,2405446.8,3285229.70703,3150953.32328
3594,199,48000,975720,927720,1424072.375,2130918.0,1763137.25195,2137488.57653
361,142,66300,7303560,7237260,7176516.5,7024290.0,4570559.83789,4195052.44212
6380,141,5365380,7409700,2044320,1895855.375,1805538.0,0.0,2010260.1372
8153,13,1844760,2529540,684780,675683.8125,678612.0,0.0,582254.20425
5449,214,267900,341760,73860,173084.5625,145106.4,1233161.375,704630.964106
5944,76,4999500,7556100,2556600,2558852.0,2552610.0,1.11040277441e+11,2954519.76745
6562,32,117660,1205580,1087920,1052501.875,925162.8,35297.9726562,619679.033279
3261,130,1784820,3083940,1299120,1297851.625,1300626.0,0.0,1603559.92219
1602,123,0,3545820,3545820,3993040.5,3992600.4,3079766.9082,2883487.20503
1944,94,40380,534480,494100,458655.8125,619862.4,1577941.50195,1473563.95573
2134,134,654600,3656580,3001980,2987393.75,3016090.8,2118199.85352,1828632.36931
8805,13,2391600,2529540,137940,131097.234375,139005.6,0.0,94467.5507058
673,87,567660,1090800,523140,519856.28125,624428.4,1611037.12109,778756.222459
5335,63,3208080,6236460,3028380,3022999.0,2942443.2,78816411878.3,2880763.50453
4533,107,1534200,4995360,3461160,3341634.25,3411889.2,2638171.28906,3239576.87364
2781,171,254460,435600,181140,138803.296875,301348.8,1330379.92578,1453014.73175
6730,5,242700,748200,505500,536013.6875,544701.6,582686.798828,512481.560588
1463,146,1338000,6670800,5332800,5389021.0,5350249.2,4748168.69531,5159840.7634
821,127,164340,599940,435600,407151.4375,424035.6,303390.814453,724949.715739
8676,37,530160,739620,209460,247372.203125,208555.2,17507.421875,305306.176558
5000,71,3585720,3996240,410520,369908.90625,399796.8,0.0,264058.952384
6936,204,998580,2571300,1572720,1574346.5,1579712.4,1303287.98438,1469161.24228
8495,40,0,163800,163800,207101.25,192420.0,962928.636719,539527.246455
1920,96,11460,2123400,2111940,2167040.5,2137636.8,1613847.42773,1721282.26715
8866,196,3196500,3285300,88800,99449.9609375,90498.0,9988620706.35,101378.267579
1496,140,1207680,1300140,92460,59738.0,85608.0,604732.857422,885629.575793
6874,151,3353580,3643800,290220,294087.28125,294392.4,33971.9296875,202355.089545
763,142,436140,7303560,6867420,6995423.0,6867976.8,6308640.01953,6191981.23491
5552,169,664260,2190660,1526400,1306331.375,1545628.8,835596.486328,1349238.66487
5105,103,4113300,4719960,606660,607549.0,606841.2,48785169029.2,744372.79908
6674,204,678780,2571300,1892520,2547260.0,1957810.8,2120208.73828,2506916.81084
5067,213,852900,3206820,2353920,2360326.75,2341563.6,1333558.39258,2333021.9181
5973,10,263820,979740,715920,785222.875,868086.0,764014.492188,415460.391568
1681,76,1468800,7556100,6087300,6062578.0,5959172.4,6227385.42578,6343921.60395
8746,162,4838280,4839720,1440,11148.53125,135945.6,0.0,-490867.345559
4729,213,674940,3206820,2531880,2552213.0,2529148.8,2912012.94531,2552549.7395
862,76,724860,7556100,6831240,6871212.0,6703732.8,6359188.29688,6444616.88128
2688,96,651000,2123400,1472400,1478252.875,1209267.6,617264.500977,1003381.60135
6353,196,1209300,3285300,2076000,2097241.25,2073405.6,2181312.81738,2245611.07896
